ag1501	20150105	3455	3465	3436	3455	3398	3448	3441	-17	-24	1352	6,978.81	5020
	20150106	3448	3441	3430	3490	3412	3485	3455	44	14	3284	17,023.94	4752
	20150107	3485	3455	3491	3530	3472	3493	3489	38	34	564	2,952.48	4820
	20150108	3493	3489	3489	3510	3484	3487	3496	-2	7	804	4,216.58	4956
	20150109	3487	3496	3502	3511	3490	3490	3495	-6	-1	308	1,614.98	4840
	20150112	3490	3495	3490	3542	3490	3535	3522	40	27	644	3,403.12	4404
	20150113	3535	3522	3522	3624	3520	3568	3571	46	49	712	3,813.94	4484
	20150114	3568	3571	3530	3535	3520	3535	3526	-36	-45	160	846.30	4364
	20150115	3535	3526	3470	3580	3430	3580	3512	54	-14	212	1,116.93	4320
ag1502	20150105	3467	3467	3454	3471	3448	3466	3456	-1	-11	54	279.99	886
	20150106	3466	3456	3442	3520	3418	3520	3480	64	24	168	877.07	864
	20150107	3520	3480	3498	3536	3492	3507	3507	27	27	94	494.61	876
	20150108	3507	3507	3504	3532	3494	3518	3518	11	11	118	622.76	854
	20150109	3518	3518	3513	3547	3497	3497	3526	-21	8	22	116.38	860
	20150112	3497	3526	3515	3566	3501	3557	3540	31	14	38	201.81	850
	20150113	3557	3540	3540	3577	3535	3554	3557	14	17	228	1,216.76	938
	20150114	3554	3557	3579	3599	3518	3552	3554	-5	-3	496	2,644.55	918
	20150115	3552	3554	3544	3588	3530	3530	3556	-24	2	112	597.47	952
	20150116	3530	3556	3637	3637	3555	3570	3577	14	21	280	1,502.46	982
	20150119	3570	3577	3593	3712	3593	3699	3685	122	108	764	4,223.87	1122
	20150120	3699	3685	3718	3735	3712	3715	3721	30	36	118	658.67	1084
	20150121	3715	3721	3765	3855	3745	3838	3762	117	41	250	1,410.88	1010
	20150122	3838	3762	3855	3870	3760	3760	3806	-2	44	246	1,404.64	1140
	20150123	3760	3806	3821	3828	3795	3809	3811	3	5	408	2,332.59	1358
	20150126	3809	3811	3816	3831	3767	3784	3814	-27	3	294	1,682.27	1376
	20150127	3784	3814	3762	3780	3715	3763	3737	-51	-77	158	885.70	1454
	20150128	3763	3737	3757	3770	3734	3762	3753	25	16	54	304.06	1432
	20150129	3762	3753	3763	3777	3702	3704	3715	-49	-38	246	1,371.13	1360
	20150130	3704	3715	3652	3661	3526	3526	3599	-189	-116	418	2,256.92	1388
	20150202	3526	3599	3530	3639	3530	3612	3604	13	5	568	3,070.66	1428
	20150203	3612	3604	3617	3617	3617	3617	3617	13	13	40	217.02	1428
	20150204	3617	3617	3630	3655	3568	3590	3616	-27	-1	68	368.84	1384
	20150205	3590	3616	3666	3667	3572	3645	3644	29	28	568	3,105.41	1548
	20150206	3645	3644	3578	3578	3578	3578	3578	-66	-66	4	21.47	1552
	20150209	3578	3578	3577	3577	3550	3550	3554	-28	-24	180	959.79	1440
	20150210	3550	3554	3600	3600	3580	3580	3585	26	31	80	430.20	1432
ag1503	20150105	3479	3462	3474	3478	3459	3469	3470	7	8	10	52.06	866
	20150106	3469	3470	3452	3526	3452	3526	3484	56	14	34	177.72	850
	20150107	3526	3484	3508	3540	3508	3515	3534	31	50	256	1,357.19	850
	20150108	3515	3534	3519	3541	3519	3522	3532	-12	-2	136	720.56	824
	20150109	3522	3532	3530	3556	3520	3532	3536	0	4	94	498.70	866
	20150112	3532	3536	3524	3570	3524	3570	3559	34	23	34	181.51	866
	20150113	3570	3559	3547	3601	3547	3573	3573	14	14	50	267.98	860
	20150114	3573	3573	3629	3629	3550	3566	3579	-7	6	286	1,535.74	842
	20150115	3566	3579	3580	3599	3572	3572	3583	-7	4	6	32.25	842
	20150116	3572	3583	3608	3608	3583	3596	3600	13	17	30	162.04	830
	20150119	3596	3600	3617	3720	3599	3695	3674	95	74	14	77.16	830
	20150120	3695	3674	3730	3736	3730	3731	3732	57	58	6	33.59	828
	20150121	3731	3732	3766	3872	3758	3861	3813	129	81	86	491.93	798
	20150122	3861	3813	3805	3805	3790	3793	3794	-20	-19	62	352.86	796
	20150123	3793	3794	3817	3850	3805	3828	3825	34	31	28	160.68	802
	20150126	3828	3825	3823	3836	3793	3832	3825	7	0	22	126.23	786
	20150127	3832	3825	3796	3801	3745	3750	3765	-75	-60	20	112.97	778
	20150128	3750	3765	3750	3806	3750	3783	3765	18	0	166	937.73	750
	20150129	3783	3765	3772	3772	3730	3739	3738	-26	-27	28	157.02	762
	20150130	3739	3738	3675	3675	3551	3565	3583	-173	-155	66	354.76	748
	20150202	3565	3583	3550	3649	3550	3610	3601	27	18	38	205.26	756
	20150203	3610	3601	3614	3653	3610	3653	3630	52	29	32	174.26	744
	20150204	3653	3630	3632	3632	3608	3619	3616	-11	-14	58	314.61	744
	20150205	3619	3616	3638	3672	3633	3657	3655	41	39	170	932.04	742
	20150206	3657	3655	3642	3648	3623	3648	3643	-7	-12	68	371.68	746
	20150209	3648	3643	3578	3593	3553	3559	3576	-84	-67	336	1,802.63	966
	20150210	3559	3576	3579	3599	3568	3598	3590	22	14	20	107.72	962
	20150211	3598	3590	3575	3594	3575	3594	3588	4	-2	64	344.46	978
	20150212	3594	3588	3577	3580	3532	3532	3566	-56	-22	28	149.81	980
	20150213	3532	3566	3558	3598	3558	3598	3580	32	14	6	32.22	980
	20150216	3598	3580	3640	3646	3615	3645	3634	65	54	356	1,940.60	910
	20150217	3645	3634	3675	3675	3622	3630	3635	-4	1	146	796.14	878
	20150225	3630	3635	3553	3553	3535	3535	3545	-100	-90	170	904.08	766
	20150226	3535	3545	3545	3606	3545	3570	3587	25	42	88	473.51	710
	20150227	3570	3587	3618	3618	3521	3588	3558	1	-29	76	405.67	708
	20150302	3588	3558	3578	3599	3578	3590	3591	32	33	740	3,986.50	1204
	20150303	3590	3591	3487	3555	3486	3552	3496	-39	-95	340	1,783.09	1204
	20150304	3552	3496	3521	3537	3521	3522	3529	26	33	100	529.36	1204
	20150305	3522	3529	3490	3499	3490	3498	3497	-31	-32	88	461.69	1204
	20150306	3498	3497	3498	3499	3484	3485	3493	-12	-4	28	146.71	1200
	20150309	3485	3493	3417	3447	3391	3408	3404	-85	-89	448	2,287.51	1332
	20150310	3408	3404	3411	3411	3371	3376	3383	-28	-21	76	385.66	1272
	20150311	3376	3383	3439	3439	3386	3415	3404	32	21	180	919.09	1236
	20150312	3415	3404	3355	3400	3355	3400	3359	-4	-45	240	1,209.41	1224
	20150313	3400	3359	3400	3440	3400	3440	3426	81	67	12	61.68	1224
	20150316	3440	3426	3340	3445	3340	3445	3429	19	3	140	720.20	1348
ag1504	20150105	3503	3527	3473	3493	3473	3485	3484	-42	-43	8	41.81	272
	20150106	3485	3484	3488	3488	3488	3488	3488	4	4	2	10.46	272
	20150107	3488	3488	3518	3550	3518	3550	3539	62	51	22	116.81	270
	20150108	3550	3539	3544	3547	3511	3547	3540	8	1	44	233.66	252
	20150109	3547	3540	3540	3540	3540	3540	3540	0	0	4	21.24	252
	20150112	3540	3540				3573	3573	33	33	0	0.00	252
	20150113	3573	3573	3573	3604	3558	3604	3591	31	18	32	172.39	242
	20150114	3604	3591	3572	3575	3563	3575	3571	-16	-20	12	64.28	236
	20150115	3575	3571	3560	3560	3546	3546	3553	-25	-18	4	21.32	234
	20150116	3546	3553	3630	3630	3610	3610	3620	57	67	8	43.44	230
	20150119	3610	3620	3634	3757	3618	3715	3649	95	29	54	295.59	230
	20150120	3715	3649	3760	3760	3727	3749	3738	100	89	206	1,155.14	290
	20150121	3749	3738	3792	3882	3776	3876	3834	138	96	36	207.05	274
	20150122	3876	3834				3815	3815	-19	-19	0	0.00	274
	20150123	3815	3815	3808	3862	3808	3831	3835	16	20	78	448.79	246
	20150126	3831	3835	3806	3855	3792	3813	3813	-22	-22	50	286.01	244
	20150127	3813	3813	3799	3799	3726	3748	3771	-65	-42	578	3,270.20	184
	20150128	3748	3771	3796	3796	3777	3777	3779	6	8	14	79.37	184
	20150129	3777	3779	3767	3790	3767	3790	3775	11	-4	42	237.86	180
	20150130	3790	3775	3686	3696	3563	3563	3611	-212	-164	44	238.35	150
	20150202	3563	3611	3533	3629	3533	3615	3591	4	-20	34	183.15	156
	20150203	3615	3591	3605	3640	3603	3634	3623	43	32	36	195.65	144
	20150204	3634	3623	3637	3637	3637	3637	3637	14	14	2	10.91	142
	20150205	3637	3637	3640	3679	3640	3679	3665	42	28	24	131.97	130
	20150206	3679	3665	3632	3660	3616	3660	3644	-5	-21	38	207.71	124
	20150209	3660	3644	3645	3645	3573	3580	3599	-64	-45	62	334.74	136
	20150210	3580	3599	3598	3604	3598	3604	3598	5	-1	36	194.33	132
	20150211	3604	3598	3584	3624	3583	3603	3603	5	5	120	648.69	154
	20150212	3603	3603	3595	3595	3559	3567	3576	-36	-27	226	1,212.46	164
	20150213	3567	3576	3586	3620	3583	3612	3615	36	39	44	238.59	162
	20150216	3612	3615	3649	3666	3635	3642	3650	27	35	96	525.64	160
	20150217	3642	3650	3648	3651	3619	3638	3646	-12	-4	58	317.22	148
	20150225	3638	3646	3565	3604	3560	3560	3566	-86	-80	42	224.66	146
	20150226	3560	3566	3605	3605	3559	3571	3567	5	1	40	214.04	142
	20150227	3571	3567	3551	3590	3551	3590	3579	23	12	10	53.70	142
	20150302	3590	3579	3622	3622	3542	3608	3594	29	15	36	194.09	132
	20150303	3608	3594	3521	3581	3490	3581	3519	-13	-75	60	316.76	156
	20150304	3581	3519	3568	3568	3516	3545	3553	26	34	52	277.19	164
	20150305	3545	3553	3521	3521	3485	3508	3507	-45	-46	112	589.28	180
	20150306	3508	3507	3515	3523	3515	3517	3517	10	10	8	42.21	176
	20150309	3517	3517	3500	3500	3446	3446	3461	-71	-56	8	41.54	178
	20150310	3446	3461	3441	3441	3415	3415	3418	-46	-43	34	174.35	196
	20150311	3415	3418	3424	3430	3407	3428	3419	10	1	26	133.37	196
	20150312	3428	3419	3398	3440	3365	3408	3415	-11	-4	172	881.32	318
	20150313	3408	3415	3425	3428	3419	3428	3427	13	12	56	287.89	322
	20150316	3428	3427	3435	3437	3435	3437	3435	10	8	194	999.83	306
	20150317	3437	3435	3450	3451	3413	3425	3439	-10	4	60	309.53	278
	20150318	3425	3439	3437	3439	3395	3395	3404	-44	-35	116	592.33	374
	20150319	3395	3404	3398	3496	3387	3475	3451	71	47	100	517.71	396
	20150320	3475	3451	3477	3498	3468	3495	3485	44	34	50	261.40	400
	20150323	3495	3485	3575	3691	3566	3590	3585	105	100	810	4,356.80	1068
	20150324	3590	3585	3650	3650	3585	3642	3618	57	33	254	1,378.46	1126
	20150325	3642	3618	3623	3623	3603	3616	3616	-2	-2	22	119.33	1136
	20150326	3616	3616	3668	3668	3604	3637	3636	21	20	250	1,363.83	1194
	20150327	3637	3636	3622	3639	3602	3613	3625	-23	-11	34	184.88	1194
	20150330	3613	3625	3658	3685	3569	3574	3616	-51	-9	156	846.38	1150
	20150331	3574	3616	3525	3555	3472	3519	3509	-97	-107	262	1,379.40	1132
	20150401	3519	3509	3511	3544	3498	3525	3529	16	20	148	783.61	1240
	20150402	3525	3529	3570	3585	3570	3585	3579	56	50	168	902.00	1336
	20150403	3585	3579				3575	3575	-4	-4	0	0.00	1336
	20150407	3575	3575	3669	3669	3567	3573	3589	-2	14	28	150.76	1324
	20150408	3573	3589	3575	3577	3568	3568	3573	-21	-16	84	450.25	1304
	20150409	3568	3573	3575	3575	3468	3475	3521	-98	-52	348	1,838.24	1328
	20150410	3475	3521	3462	3462	3462	3462	3462	-59	-59	4	20.77	1328
	20150413	3462	3462	3485	3500	3466	3466	3483	4	21	20	104.50	1328
	20150414	3466	3483	3519	3519	3425	3425	3456	-58	-27	60	311.07	1380
	20150415	3425	3456	3500	3500	3452	3500	3465	44	9	56	291.11	1424
ag1505	20150105	3508	3507	3483	3507	3474	3498	3492	-9	-15	1632	8,549.60	2086
	20150106	3498	3492	3472	3550	3458	3544	3504	52	12	5090	26,757.50	2014
	20150107	3544	3504	3539	3580	3520	3545	3545	41	41	3126	16,625.84	1898
	20150108	3545	3545	3355	3649	3355	3538	3546	-7	1	3506	18,648.99	1936
	20150109	3538	3546	3555	3576	3539	3549	3555	3	9	1862	9,929.58	1724
	20150112	3549	3555	3551	3598	3516	3588	3565	33	10	4010	21,445.17	1634
	20150113	3588	3565	3566	3631	3564	3608	3598	43	33	2716	14,659.83	1640
	20150114	3608	3598	3630	3653	3564	3601	3624	3	26	4396	23,899.11	1674
	20150115	3601	3624	3588	3631	3552	3562	3596	-62	-28	4808	25,934.66	1612
	20150116	3562	3596	3605	3648	3605	3632	3627	36	31	3048	16,585.94	1608
	20150119	3632	3627	3590	3769	3590	3754	3713	127	86	7744	43,139.43	1674
	20150120	3754	3713	3753	3785	3740	3762	3760	49	47	3828	21,590.27	1732
	20150121	3762	3760	3810	3907	3781	3879	3828	119	68	4504	25,863.86	1424
	20150122	3879	3828	3841	3924	3793	3810	3861	-18	33	5448	31,552.69	1456
	20150123	3810	3861	3816	3878	3816	3848	3852	-13	-9	5136	29,679.14	1458
	20150126	3848	3852	3859	3877	3808	3839	3844	-13	-8	2316	13,356.00	1456
	20150127	3839	3844	3819	3830	3757	3806	3797	-38	-47	2570	14,640.55	1440
	20150128	3806	3797	3807	3829	3787	3803	3806	6	9	1804	10,299.38	1474
	20150129	3803	3806	3809	3813	3746	3760	3780	-46	-26	1964	11,136.36	1392
	20150130	3760	3780	3715	3715	3561	3566	3623	-214	-157	5198	28,255.89	1592
	20150202	3566	3623	3585	3663	3547	3627	3598	4	-25	2728	14,726.28	1542
	20150203	3627	3598	3606	3670	3600	3663	3646	65	48	6134	33,552.58	1328
	20150204	3663	3646	3657	3668	3609	3641	3640	-5	-6	3622	19,778.27	1344
	20150205	3641	3640	3654	3704	3645	3669	3672	29	32	2408	13,265.87	1316
	20150206	3669	3672	3638	3668	3623	3664	3648	-8	-24	1920	10,508.95	1340
	20150209	3664	3648	3667	3680	3572	3590	3612	-58	-36	7504	40,664.99	1722
	20150210	3590	3612	3604	3624	3591	3615	3606	3	-6	2414	13,058.43	1516
	20150211	3615	3606	3599	3630	3588	3613	3609	7	3	1200	6,496.37	1556
	20150212	3613	3609	3606	3613	3557	3579	3587	-30	-22	944	5,079.87	1574
	20150213	3579	3587	3591	3636	3577	3622	3604	35	17	1746	9,439.45	1742
	20150216	3622	3604	3611	3684	3611	3675	3663	71	59	2660	14,617.75	1652
	20150217	3675	3663	3667	3681	3645	3654	3659	-9	-4	712	3,908.29	1672
	20150225	3654	3659	3562	3586	3557	3580	3575	-79	-84	652	3,496.89	1298
	20150226	3580	3575	3580	3599	3570	3593	3582	18	7	660	3,546.50	1248
	20150227	3593	3582	3606	3615	3582	3596	3595	14	13	742	4,002.21	1190
	20150302	3596	3595	3586	3630	3575	3618	3609	23	14	848	4,591.20	1124
	20150303	3618	3609	3606	3619	3480	3578	3565	-31	-44	1060	5,669.93	1080
	20150304	3578	3565	3586	3594	3543	3549	3563	-16	-2	1204	6,435.27	1056
	20150305	3549	3563	3522	3554	3510	3527	3532	-36	-31	746	3,952.67	1158
	20150306	3527	3532	3542	3546	3506	3521	3525	-11	-7	398	2,104.91	1028
	20150309	3521	3525	3520	3520	3427	3460	3464	-65	-61	1568	8,149.38	956
	20150310	3460	3464	3455	3455	3414	3414	3441	-50	-23	740	3,819.57	896
	20150311	3414	3441	3431	3444	3427	3441	3436	0	-5	326	1,680.64	818
	20150312	3441	3436	3410	3449	3373	3444	3402	8	-34	652	3,327.72	768
	20150313	3444	3402	3448	3455	3418	3432	3438	30	36	350	1,805.29	712
	20150316	3432	3438	3436	3462	3415	3458	3436	20	-2	370	1,907.46	680
	20150317	3458	3436	3454	3460	3423	3435	3444	-1	8	372	1,921.76	734
	20150318	3435	3444	3413	3450	3392	3412	3428	-32	-16	796	4,093.70	706
	20150319	3412	3428	3420	3525	3405	3494	3470	66	42	660	3,435.73	658
	20150320	3494	3470	3489	3519	3484	3500	3504	30	34	184	967.12	654
	20150323	3500	3504	3516	3640	3516	3614	3591	110	87	2362	12,723.12	806
	20150324	3614	3591	3646	3685	3638	3656	3661	65	70	554	3,042.46	756
	20150325	3656	3661	3666	3677	3622	3638	3643	-23	-18	632	3,453.63	822
	20150326	3638	3643	3679	3690	3643	3670	3667	27	24	636	3,498.86	1014
	20150327	3670	3667	3669	3669	3629	3645	3644	-22	-23	290	1,585.39	1028
	20150330	3645	3644	3655	3655	3598	3606	3609	-38	-35	1040	5,630.91	948
	20150331	3606	3609	3585	3592	3537	3537	3563	-72	-46	202	1,079.88	930
	20150401	3537	3563	3563	3571	3532	3546	3552	-17	-11	102	543.47	918
	20150402	3546	3552	3581	3601	3557	3598	3583	46	31	200	1,074.93	936
	20150403	3598	3583	3579	3579	3550	3575	3563	-8	-20	80	427.64	930
	20150407	3575	3563	3595	3606	3592	3595	3594	32	31	116	625.49	908
	20150408	3595	3594	3682	3682	3579	3595	3594	1	0	686	3,698.55	916
	20150409	3595	3594	3586	3588	3477	3489	3504	-105	-90	266	1,398.31	934
	20150410	3489	3504	3689	3689	3410	3482	3482	-22	-22	216	1,128.45	872
	20150413	3482	3482	3530	3544	3503	3514	3517	32	35	378	1,994.15	900
	20150414	3514	3517	3518	3518	3457	3471	3484	-46	-33	82	428.57	910
	20150415	3471	3484	3467	3511	3467	3482	3494	-2	10	238	1,247.41	968
	20150416	3482	3494	3482	3542	3482	3527	3522	33	28	220	1,162.30	1014
	20150417	3527	3522	3534	3546	3491	3507	3506	-15	-16	244	1,283.21	1072
	20150420	3507	3506	3509	3528	3504	3528	3513	22	7	312	1,644.22	1190
	20150421	3528	3513	3528	3528	3450	3468	3470	-45	-43	484	2,519.38	1086
	20150422	3468	3470	3470	3500	3468	3480	3476	10	6	444	2,315.62	1020
	20150423	3480	3476	3479	3484	3432	3443	3450	-33	-26	746	3,860.63	922
	20150424	3443	3450	3450	3469	3444	3458	3451	8	1	292	1,511.74	890
	20150427	3458	3451	3436	3471	3421	3457	3436	6	-15	334	1,721.75	870
	20150428	3457	3436	3457	3579	3457	3574	3539	138	103	1430	7,592.32	1464
	20150429	3574	3539	3597	3626	3510	3570	3591	31	52	648	3,491.15	1634
	20150430	3570	3591	3597	3796	3500	3578	3601	-13	10	756	4,083.99	1612
ag1506	20150105	3522	3524	3498	3516	3478	3507	3500	-17	-24	513798	2,698,085.51	410420
	20150106	3507	3500	3490	3566	3462	3554	3517	54	17	2199972	11,607,731.85	450158
	20150107	3554	3517	3544	3596	3530	3554	3556	37	39	1865876	9,953,040.33	401974
	20150108	3554	3556	3540	3578	3537	3548	3558	-8	2	1434122	7,655,502.14	412464
	20150109	3548	3558	3568	3586	3544	3555	3562	-3	4	1415890	7,565,838.44	400170
	20150112	3555	3562	3545	3609	3520	3601	3577	39	15	2522336	13,536,981.21	407230
	20150113	3601	3577	3577	3645	3571	3616	3608	39	31	1816952	9,834,693.60	396296
	20150114	3616	3608	3635	3664	3570	3608	3627	0	19	2630104	14,310,001.46	381950
	20150115	3608	3627	3592	3642	3556	3573	3604	-54	-23	2546564	13,768,355.39	405240
	20150116	3573	3604	3635	3660	3613	3642	3635	38	31	2161856	11,789,306.54	387826
	20150119	3642	3635	3638	3783	3633	3767	3725	132	90	3544420	19,807,997.82	472114
	20150120	3767	3725	3770	3800	3745	3770	3770	45	45	1461346	8,264,019.08	479754
	20150121	3770	3770	3822	3919	3787	3890	3836	120	66	2675070	15,394,206.95	506162
	20150122	3890	3836	3887	3934	3798	3819	3865	-17	29	3079184	17,853,599.28	517020
	20150123	3819	3865	3843	3886	3822	3859	3859	-6	-6	2627510	15,212,863.22	502324
	20150126	3859	3859	3865	3888	3814	3849	3849	-10	-10	1834432	10,591,095.41	515488
	20150127	3849	3849	3836	3841	3763	3815	3803	-34	-46	1982320	11,308,833.98	522960
	20150128	3815	3803	3815	3837	3793	3806	3812	3	9	1463626	8,370,149.52	513360
	20150129	3806	3812	3817	3820	3750	3766	3792	-46	-20	1446720	8,229,316.42	511160
	20150130	3766	3792	3713	3721	3564	3573	3633	-219	-159	2849430	15,529,062.85	491344
	20150202	3573	3633	3593	3671	3551	3632	3618	-1	-15	2755340	14,956,819.34	459730
	20150203	3632	3618	3620	3681	3603	3669	3638	51	20	1905866	10,401,556.00	441120
	20150204	3669	3638	3668	3675	3612	3645	3645	7	7	2230030	12,193,085.17	456476
	20150205	3645	3645	3654	3710	3649	3675	3680	30	35	2235044	12,339,861.35	430468
	20150206	3675	3680	3655	3677	3628	3673	3652	-7	-28	1745320	9,563,106.62	415498
	20150209	3673	3652	3675	3687	3566	3595	3606	-57	-46	2979798	16,119,265.50	438030
	20150210	3595	3606	3606	3630	3593	3618	3613	12	7	1248764	6,768,476.10	419950
	20150211	3618	3613	3607	3638	3590	3618	3613	5	0	1462208	7,925,496.07	388998
	20150212	3618	3613	3615	3621	3557	3585	3593	-28	-20	1601470	8,633,105.66	388184
	20150213	3585	3593	3599	3650	3582	3631	3606	38	13	1544114	8,353,662.74	361214
	20150216	3631	3606	3623	3700	3620	3686	3674	80	68	1663548	9,169,934.38	326706
	20150217	3686	3674	3676	3695	3655	3672	3676	-2	2	590260	3,255,566.69	311484
	20150225	3672	3676	3563	3603	3562	3590	3585	-86	-91	392598	2,111,729.21	309022
	20150226	3590	3585	3588	3612	3578	3601	3592	16	7	795474	4,286,693.26	339218
	20150227	3601	3592	3617	3628	3590	3606	3608	14	16	956158	5,175,045.96	373818
	20150302	3606	3608	3592	3647	3580	3631	3616	23	8	1381658	7,495,359.33	383840
	20150303	3631	3616	3624	3633	3488	3586	3577	-30	-39	2033996	10,915,415.94	386932
	20150304	3586	3577	3591	3608	3548	3558	3573	-19	-4	1798608	9,641,995.29	416432
	20150305	3558	3573	3560	3569	3516	3539	3543	-34	-30	1485834	7,896,867.23	418416
	20150306	3539	3543	3535	3560	3513	3532	3539	-11	-4	1089368	5,783,972.88	413392
	20150309	3532	3539	3524	3531	3434	3470	3472	-69	-67	2174538	11,326,083.32	473530
	20150310	3470	3472	3462	3468	3422	3424	3449	-48	-23	1283922	6,643,654.05	493624
	20150311	3424	3449	3443	3461	3433	3450	3446	1	-3	1099402	5,683,110.46	498282
	20150312	3450	3446	3433	3460	3375	3453	3407	7	-39	2324538	11,882,910.28	563910
	20150313	3453	3407	3439	3470	3425	3442	3444	35	37	1316696	6,803,318.82	563064
	20150316	3442	3444	3448	3479	3417	3469	3442	25	-2	1360990	7,027,563.19	580236
	20150317	3469	3442	3455	3472	3428	3443	3451	1	9	1220700	6,320,439.90	586844
	20150318	3443	3451	3428	3458	3398	3420	3431	-31	-20	1741986	8,967,725.03	593452
	20150319	3420	3431	3418	3537	3410	3502	3467	71	36	1783026	9,274,521.85	573254
	20150320	3502	3467	3492	3535	3491	3516	3514	49	47	1391082	7,333,390.33	556166
	20150323	3516	3514	3525	3655	3523	3634	3610	120	96	2610940	14,142,009.74	567348
	20150324	3634	3610	3649	3699	3646	3670	3673	60	63	1815344	10,003,263.90	542542
	20150325	3670	3673	3681	3692	3633	3652	3661	-21	-12	1427656	7,840,613.43	521234
	20150326	3652	3661	3690	3710	3651	3692	3676	31	15	1511626	8,337,304.04	526078
	20150327	3692	3676	3680	3686	3646	3667	3671	-9	-5	1225598	6,749,121.53	480856
	20150330	3667	3671	3669	3676	3612	3615	3637	-56	-34	1551364	8,465,127.54	494348
	20150331	3615	3637	3605	3615	3548	3556	3588	-81	-49	1392912	7,497,402.58	487696
	20150401	3556	3588	3580	3596	3543	3565	3573	-23	-15	1166888	6,255,543.38	483224
	20150402	3565	3573	3580	3630	3575	3619	3604	46	31	1493140	8,072,230.48	448852
	20150403	3619	3604	3592	3607	3563	3595	3584	-9	-20	1151628	6,192,462.77	412946
	20150407	3595	3584	3596	3630	3591	3613	3618	29	34	336968	1,828,901.52	416596
	20150408	3613	3618	3611	3624	3598	3616	3613	-2	-5	677522	3,672,093.86	419448
	20150409	3616	3613	3606	3616	3489	3504	3558	-109	-55	1520726	8,117,075.89	463038
	20150410	3504	3558	3496	3515	3470	3498	3488	-60	-70	1064078	5,568,633.46	462546
	20150413	3498	3488	3526	3565	3516	3537	3539	49	51	1199680	6,370,222.94	464074
	20150414	3537	3539	3533	3542	3478	3501	3514	-38	-25	1048738	5,529,083.60	476672
	20150415	3501	3514	3485	3536	3483	3510	3515	-4	1	1106310	5,833,774.37	465072
	20150416	3510	3515	3508	3562	3503	3551	3531	36	16	998014	5,285,985.89	448234
	20150417	3551	3531	3560	3570	3510	3523	3531	-8	0	1217854	6,452,049.36	476076
	20150420	3523	3531	3520	3555	3517	3553	3530	22	-1	814654	4,314,795.95	460514
	20150421	3553	3530	3506	3513	3460	3486	3484	-44	-46	1204686	6,296,735.31	488146
	20150422	3486	3484	3493	3518	3481	3506	3497	22	13	876500	4,598,004.36	482784
	20150423	3506	3497	3497	3498	3443	3452	3463	-45	-34	1418428	7,369,024.98	489886
	20150424	3452	3463	3458	3488	3451	3475	3469	12	6	1024546	5,331,534.70	450406
	20150427	3475	3469	3465	3484	3427	3472	3456	3	-13	1321720	6,853,634.26	428316
	20150428	3472	3456	3482	3609	3480	3598	3566	142	110	2171488	11,617,627.47	444146
	20150429	3598	3566	3626	3654	3583	3599	3621	33	55	1607256	8,731,292.39	381880
	20150430	3599	3621	3617	3648	3591	3599	3619	-22	-2	1471756	7,991,013.80	346510
ag1507	20150105	3501	3528	3510	3518	3495	3518	3505	-10	-23	48	252.39	956
	20150106	3518	3505	3499	3569	3499	3567	3531	62	26	114	603.92	898
	20150107	3567	3531	3556	3595	3547	3561	3559	30	28	152	811.63	854
	20150108	3561	3559	3552	3578	3524	3564	3560	5	1	22	117.50	854
	20150109	3564	3560	3572	3576	3559	3566	3561	6	1	214	1,143.34	666
	20150112	3566	3561	3555	3612	3554	3612	3594	51	33	32	172.54	662
	20150113	3612	3594	3604	3633	3603	3633	3627	39	33	24	130.58	664
	20150114	3633	3627	3658	3670	3592	3601	3636	-26	9	36	196.36	656
	20150115	3601	3636	3598	3638	3594	3594	3606	-42	-30	18	97.38	654
	20150116	3594	3606	3662	3662	3637	3639	3653	33	47	28	153.44	652
	20150119	3639	3653	3657	3779	3657	3779	3743	126	90	140	786.20	618
	20150120	3779	3743	3772	3799	3733	3772	3773	29	30	174	984.89	654
	20150121	3772	3773	3824	3916	3737	3895	3838	122	65	180	1,036.46	620
	20150122	3895	3838	3920	3921	3845	3851	3855	13	17	118	682.38	630
	20150123	3851	3855	3849	3884	3849	3858	3865	3	10	34	197.16	616
	20150126	3858	3865	3876	3876	3843	3843	3861	-22	-4	56	324.33	632
	20150127	3843	3861	3809	3809	3771	3807	3778	-54	-83	86	487.37	656
	20150128	3807	3778	3826	3838	3811	3811	3828	33	50	36	206.76	652
	20150129	3811	3828	3828	3828	3762	3767	3784	-61	-44	66	374.70	644
	20150130	3767	3784	3717	3717	3591	3602	3615	-182	-169	146	791.90	624
	20150202	3602	3615	3587	3666	3563	3635	3632	20	17	112	610.33	650
	20150203	3635	3632	3620	3677	3620	3673	3655	41	23	50	274.19	636
	20150204	3673	3655	3554	3675	3554	3662	3663	7	8	132	725.29	648
	20150205	3662	3663	3673	3708	3665	3685	3695	22	32	252	1,396.93	714
	20150206	3685	3695	3650	3677	3639	3672	3653	-23	-42	108	591.83	708
	20150209	3672	3653	3664	3664	3584	3595	3609	-58	-44	42	227.40	682
	20150210	3595	3609	3627	3627	3616	3620	3620	11	11	16	86.88	682
	20150211	3620	3620	3614	3640	3600	3629	3633	9	13	138	752.16	758
	20150212	3629	3633	3619	3619	3571	3577	3598	-56	-35	50	269.91	754
	20150213	3577	3598	3605	3633	3591	3633	3618	35	20	36	195.38	744
	20150216	3633	3618	3637	3695	3637	3690	3676	72	58	18	99.26	740
	20150217	3690	3676	3694	3694	3666	3677	3680	1	4	44	242.94	736
	20150225	3677	3680	3587	3608	3584	3590	3593	-90	-87	20	107.81	732
	20150226	3590	3593	3604	3604	3600	3600	3600	7	7	42	226.81	734
	20150227	3600	3600	3617	3617	3612	3612	3614	12	14	12	65.06	736
	20150302	3612	3614	3604	3652	3604	3646	3643	32	29	152	830.76	830
	20150303	3646	3643	3627	3628	3512	3609	3580	-34	-63	376	2,019.53	792
	20150304	3609	3580	3600	3600	3576	3576	3588	-4	8	76	409.13	776
	20150305	3576	3588	3559	3564	3547	3547	3551	-41	-37	32	170.45	770
	20150306	3547	3551	3554	3560	3535	3535	3544	-16	-7	22	116.97	766
	20150309	3535	3544	3499	3505	3458	3481	3490	-63	-54	104	544.57	792
	20150310	3481	3490	3470	3473	3436	3436	3461	-54	-29	16	83.08	794
	20150311	3436	3461	3463	3463	3454	3454	3457	-7	-4	72	373.41	836
	20150312	3454	3457	3396	3458	3396	3458	3412	1	-45	204	1,044.19	684
	20150313	3458	3412	3448	3459	3448	3459	3454	47	42	8	41.45	690
	20150316	3459	3454	3440	3506	3432	3485	3476	31	22	268	1,397.48	750
	20150317	3485	3476	3469	3478	3446	3446	3455	-30	-21	516	2,674.35	750
	20150318	3446	3455	3411	3458	3411	3436	3438	-19	-17	46	237.29	760
	20150319	3436	3438	3449	3525	3439	3520	3484	82	46	118	616.79	724
	20150320	3520	3484	3520	3535	3517	3524	3527	40	43	50	264.53	718
	20150323	3524	3527	3560	3660	3560	3635	3625	108	98	246	1,337.66	650
	20150324	3635	3625	3689	3698	3659	3674	3679	49	54	170	938.24	592
	20150325	3674	3679	3675	3677	3654	3660	3665	-19	-14	30	164.95	582
	20150326	3660	3665	3701	3705	3667	3695	3691	30	26	80	442.92	582
	20150327	3695	3691	3681	3681	3673	3677	3678	-14	-13	10	55.18	582
	20150330	3677	3678	3660	3663	3587	3635	3634	-43	-44	110	599.61	578
	20150331	3635	3634	3588	3620	3564	3564	3600	-70	-34	116	626.40	582
	20150401	3564	3600	3596	3596	3570	3575	3575	-25	-25	94	504.18	576
	20150402	3575	3575	3597	3625	3594	3625	3613	50	38	42	227.66	584
	20150403	3625	3613	3604	3611	3580	3594	3599	-19	-14	102	550.69	598
	20150407	3594	3599	3625	3634	3625	3630	3628	31	29	20	108.85	596
	20150408	3630	3628	3597	3633	3597	3627	3621	-1	-7	58	315.08	604
	20150409	3627	3621	3578	3581	3510	3517	3540	-104	-81	100	531.14	640
	20150410	3517	3540	3488	3518	3488	3518	3513	-22	-27	12	63.23	648
	20150413	3518	3513	3543	3570	3542	3547	3553	34	40	60	319.78	660
	20150414	3547	3553	3517	3518	3505	3516	3513	-37	-40	64	337.26	640
	20150415	3516	3513	3519	3551	3514	3522	3527	9	14	176	931.24	566
	20150416	3522	3527	3524	3570	3524	3558	3549	31	22	88	468.51	536
	20150417	3558	3549	3580	3580	3525	3535	3545	-14	-4	100	531.77	540
	20150420	3535	3545	3541	3555	3528	3555	3542	10	-3	44	233.78	536
	20150421	3555	3542	3517	3517	3479	3496	3493	-46	-49	140	733.57	538
	20150422	3496	3493	3503	3519	3499	3516	3506	23	13	126	662.79	538
	20150423	3516	3506	3500	3500	3451	3468	3468	-38	-38	48	249.72	542
	20150424	3468	3468	3470	3484	3470	3480	3477	12	9	24	125.18	544
	20150427	3480	3477	3480	3496	3448	3476	3475	-1	-2	266	1,386.88	704
	20150428	3476	3475	3494	3619	3494	3594	3570	119	95	1420	7,604.65	890
	20150429	3594	3570	3615	3672	3595	3595	3643	25	73	1672	9,138.80	1084
	20150430	3595	3643	3614	3647	3600	3602	3621	-41	-22	256	1,390.75	1040
ag1508	20150105	3508	3532	3509	3518	3507	3518	3511	-14	-21	6	31.60	262
	20150106	3518	3511	3500	3536	3500	3536	3522	25	11	46	243.07	258
	20150107	3536	3522	3549	3592	3546	3564	3577	42	55	58	311.20	258
	20150108	3564	3577	3564	3571	3564	3565	3565	-12	-12	24	128.36	260
	20150109	3565	3565	3582	3583	3561	3561	3575	-4	10	6	32.18	258
	20150112	3561	3575	3559	3612	3559	3612	3595	37	20	52	280.42	248
	20150113	3612	3595	3597	3639	3597	3618	3626	23	31	180	979.23	238
	20150114	3618	3626	3652	3666	3590	3605	3627	-21	1	98	533.25	242
	20150115	3605	3627	3602	3624	3602	3624	3609	-3	-18	14	75.81	244
	20150116	3624	3609	3645	3650	3645	3650	3647	41	38	4	21.89	242
	20150119	3650	3647	3662	3745	3662	3744	3721	97	74	28	156.32	244
	20150120	3744	3721	3769	3775	3768	3775	3770	54	49	22	124.43	242
	20150121	3775	3770	3840	3924	3840	3918	3864	148	94	26	150.72	242
	20150122	3918	3864	3925	3926	3850	3850	3878	-14	14	30	174.52	248
	20150123	3850	3878	3862	3904	3700	3859	3850	-19	-28	5396	31,165.05	246
	20150126	3859	3850	3873	3888	3822	3849	3858	-1	8	188	1,088.09	252
	20150127	3849	3858	3820	3840	3774	3804	3806	-54	-52	76	434.00	246
	20150128	3804	3806	3823	3839	3815	3815	3833	9	27	18	103.51	240
	20150129	3815	3833	3808	3808	3771	3771	3777	-62	-56	38	215.30	242
	20150130	3771	3777	3714	3714	3594	3607	3634	-170	-143	34	185.36	244
	20150202	3607	3634	3624	3675	3584	3631	3637	-3	3	60	327.35	252
	20150203	3631	3637	3630	3662	3630	3662	3651	25	14	16	87.64	252
	20150204	3662	3651	3666	3669	3644	3669	3659	18	8	6	32.94	254
	20150205	3669	3659	3675	3683	3675	3680	3678	21	19	8	44.14	254
	20150206	3680	3678	3680	3685	3646	3685	3674	7	-4	18	99.21	256
	20150209	3685	3674	3675	3675	3595	3613	3617	-61	-57	66	358.11	258
	20150210	3613	3617	3615	3633	3615	3625	3626	8	9	26	141.42	242
	20150211	3625	3626	3628	3632	3628	3632	3630	6	4	4	21.78	242
	20150212	3632	3630				3630	3630	0	0	0	0.00	242
	20150213	3630	3630	3600	3614	3600	3614	3609	-16	-21	6	32.48	240
	20150216	3614	3609	3694	3694	3676	3692	3689	83	80	22	121.75	232
	20150217	3692	3689	3676	3684	3627	3675	3675	-14	-14	28	154.35	238
	20150225	3675	3675	3596	3606	3555	3600	3591	-75	-84	650	3,501.59	432
	20150226	3600	3591	3605	3605	3605	3605	3605	14	14	6	32.45	438
	20150227	3605	3605	3621	3621	3621	3621	3621	16	16	2	10.86	440
	20150302	3621	3621	3618	3650	3618	3649	3630	28	9	32	174.24	438
	20150303	3649	3630	3608	3617	3532	3614	3580	-16	-50	44	236.30	450
	20150304	3614	3580	3603	3603	3591	3591	3598	11	18	6	32.38	450
	20150305	3591	3598	3563	3563	3545	3552	3557	-46	-41	10	53.36	444
	20150306	3552	3557	3558	3560	3540	3553	3551	-4	-6	24	127.85	446
	20150309	3553	3551	3535	3535	3475	3481	3483	-70	-68	110	574.86	446
	20150310	3481	3483				3450	3450	-33	-33	0	0.00	446
	20150311	3450	3450	3474	3474	3462	3466	3465	16	15	44	228.71	446
	20150312	3466	3465	3484	3498	3412	3483	3426	18	-39	102	524.30	454
	20150313	3483	3426	3466	3477	3465	3475	3471	49	45	46	239.51	460
	20150316	3475	3471	3446	3491	3446	3491	3468	20	-3	12	62.43	456
	20150317	3491	3468	3478	3479	3452	3452	3469	-16	1	12	62.45	452
	20150318	3452	3469	3439	3439	3437	3437	3438	-32	-31	4	20.63	452
	20150319	3437	3438	3444	3543	3444	3524	3515	86	77	42	221.50	450
	20150320	3524	3515	3517	3544	3517	3534	3537	19	22	18	95.52	444
	20150323	3534	3537	3565	3660	3563	3641	3616	104	79	110	596.66	464
	20150324	3641	3616	3688	3692	3679	3681	3681	65	65	86	474.95	394
	20150325	3681	3681	3697	3697	3664	3688	3679	7	-2	14	77.28	392
	20150326	3688	3679	3675	3706	3675	3698	3695	19	16	8	44.34	390
	20150327	3698	3695	3699	3699	3680	3684	3689	-11	-6	16	88.55	394
	20150330	3684	3689	3658	3665	3648	3648	3658	-41	-31	42	230.49	390
	20150331	3648	3658	3611	3611	3603	3603	3607	-55	-51	4	21.64	390
	20150401	3603	3607	3595	3595	3570	3586	3581	-21	-26	12	64.47	392
	20150402	3586	3581	3629	3651	3620	3646	3638	65	57	26	141.89	392
	20150403	3646	3638	3606	3606	3564	3605	3594	-33	-44	64	345.10	396
	20150407	3605	3594				3594	3594	0	0	0	0.00	396
	20150408	3594	3594	3640	3640	3623	3640	3638	46	44	52	283.79	384
	20150409	3640	3638	3633	3633	3554	3555	3572	-83	-66	18	96.47	388
	20150410	3555	3572	3510	3533	3508	3518	3513	-54	-59	16	84.33	394
	20150413	3518	3513	3558	3563	3558	3563	3560	50	47	4	21.36	390
	20150414	3563	3560	3550	3570	3548	3548	3554	-12	-6	10	53.31	390
	20150415	3548	3554	3550	3550	3532	3537	3543	-17	-11	14	74.40	390
	20150416	3537	3543	3538	3586	3536	3571	3560	28	17	18	96.14	386
	20150417	3571	3560	3541	3542	3514	3536	3535	-24	-25	16	84.86	382
	20150420	3536	3535	3548	3556	3537	3550	3544	15	9	16	85.06	382
	20150421	3550	3544	3528	3528	3473	3503	3502	-41	-42	32	168.11	386
	20150422	3503	3502	3507	3520	3507	3520	3513	18	11	4	21.08	382
	20150423	3520	3513	3500	3500	3472	3477	3479	-36	-34	18	93.93	392
	20150424	3477	3479	3474	3498	3474	3487	3486	8	7	68	355.64	392
	20150427	3487	3486	3476	3502	3456	3491	3484	5	-2	88	459.97	378
	20150428	3491	3484	3538	3624	3538	3605	3610	121	126	196	1,061.53	372
	20150429	3605	3610	3630	3694	3623	3628	3632	18	22	78	424.94	370
	20150430	3628	3632	3629	3658	3612	3612	3635	-20	3	72	392.65	398
ag1509	20150105	3518	3510	3518	3521	3513	3521	3517	11	7	8	42.21	874
	20150106	3521	3517	3499	3571	3499	3567	3539	50	22	48	254.83	870
	20150107	3567	3539	3562	3602	3562	3581	3579	42	40	34	182.57	872
	20150108	3581	3579	3564	3595	3564	3571	3574	-8	-5	508	2,723.42	870
	20150109	3571	3574	3570	3604	3570	3575	3581	1	7	152	816.50	910
	20150112	3575	3581	3572	3627	3560	3627	3603	46	22	138	745.91	826
	20150113	3627	3603	3600	3654	3600	3645	3633	42	30	62	337.93	824
	20150114	3645	3633	3658	3676	3592	3620	3621	-13	-12	116	630.18	798
	20150115	3620	3621	3610	3639	3582	3582	3608	-39	-13	38	205.71	788
	20150116	3582	3608	3644	3658	3644	3658	3651	50	43	12	65.73	792
	20150119	3658	3651	3659	3772	3659	3760	3740	109	89	154	864.10	754
	20150120	3760	3740	3777	3793	3759	3783	3778	43	38	60	340.09	756
	20150121	3783	3778	3811	3922	3800	3911	3866	133	88	126	730.85	788
	20150122	3911	3866	3920	3928	3814	3814	3862	-52	-4	68	394.02	776
	20150123	3814	3862	3873	3884	3866	3868	3876	6	14	18	104.67	772
	20150126	3868	3876	3859	3895	3839	3851	3866	-25	-10	66	382.79	782
	20150127	3851	3866	3847	3855	3800	3813	3820	-53	-46	74	424.10	784
	20150128	3813	3820	3818	3837	3817	3817	3821	-3	1	40	229.31	778
	20150129	3817	3821	3790	3796	3779	3780	3785	-41	-36	56	317.98	760
	20150130	3780	3785	3730	3731	3586	3586	3633	-199	-152	90	490.56	778
	20150202	3586	3633	3575	3668	3572	3645	3615	12	-18	50	271.16	776
	20150203	3645	3615	3641	3688	3626	3688	3652	73	37	72	394.51	784
	20150204	3688	3652	3683	3683	3640	3656	3661	4	9	30	164.75	784
	20150205	3656	3661	3669	3712	3669	3702	3700	41	39	52	288.65	788
	20150206	3702	3700	3658	3687	3657	3687	3676	-13	-24	48	264.68	774
	20150209	3687	3676	3650	3658	3574	3610	3620	-66	-56	124	673.33	778
	20150210	3610	3620	3636	3646	3636	3643	3640	23	20	24	131.06	776
	20150211	3643	3640	3625	3643	3624	3638	3629	-2	-11	46	250.44	796
	20150212	3638	3629	3626	3627	3584	3599	3601	-30	-28	18	97.23	792
	20150213	3599	3601	3599	3646	3599	3642	3609	41	8	82	443.92	760
	20150216	3642	3609	3681	3702	3662	3695	3692	86	83	34	188.34	742
	20150217	3695	3692	3701	3757	3687	3688	3710	-4	18	48	267.14	748
	20150225	3688	3710	3614	3614	3570	3610	3602	-100	-108	70	378.29	738
	20150226	3610	3602	3611	3628	3611	3627	3619	25	17	8	43.43	736
	20150227	3627	3619	3635	3644	3620	3622	3627	3	8	34	185.00	738
	20150302	3622	3627	3611	3673	3611	3653	3648	26	21	34	186.05	734
	20150303	3653	3648	3669	3669	3525	3612	3593	-36	-55	128	689.93	776
	20150304	3612	3593	3626	3627	3587	3593	3602	0	9	36	194.54	762
	20150305	3593	3602	3586	3586	3564	3564	3575	-38	-27	22	118.00	770
	20150306	3564	3575	3560	3560	3547	3553	3553	-22	-22	48	255.83	776
	20150309	3553	3553	3538	3538	3471	3493	3503	-60	-50	68	357.38	782
	20150310	3493	3503	3492	3492	3446	3452	3468	-51	-35	88	457.88	792
	20150311	3452	3468	3465	3485	3465	3467	3470	-1	2	18	93.71	786
	20150312	3467	3470	3459	3491	3424	3475	3447	5	-23	184	951.39	796
	20150313	3475	3447	3488	3491	3470	3473	3477	26	30	40	208.65	792
	20150316	3473	3477	3472	3489	3449	3489	3467	12	-10	94	488.87	768
	20150317	3489	3467	3484	3485	3468	3470	3476	3	9	48	250.31	762
	20150318	3470	3476	3430	3480	3430	3447	3453	-29	-23	28	145.04	762
	20150319	3447	3453	3451	3557	3443	3527	3506	74	53	56	294.56	756
	20150320	3527	3506	3522	3546	3517	3534	3535	28	29	60	318.24	764
	20150323	3534	3535	3569	3660	3568	3660	3634	125	99	70	381.64	788
	20150324	3660	3634	3680	3716	3676	3694	3694	60	60	104	576.32	768
	20150325	3694	3694	3694	3694	3641	3675	3670	-19	-24	56	308.34	764
	20150326	3675	3670	3675	3718	3675	3695	3696	25	26	40	221.76	760
	20150327	3695	3696	3698	3707	3678	3694	3696	-2	0	54	299.44	762
	20150330	3694	3696	3680	3681	3647	3652	3664	-44	-32	312	1,714.76	770
	20150331	3652	3664	3609	3634	3576	3576	3618	-88	-46	152	824.94	814
	20150401	3576	3618	3591	3620	3586	3606	3601	-12	-17	50	270.14	816
	20150402	3606	3601	3605	3661	3605	3650	3636	49	35	246	1,341.96	780
	20150403	3650	3636	3590	3636	3590	3617	3607	-19	-29	458	2,478.48	792
	20150407	3617	3607	3641	3662	3641	3645	3652	38	45	44	241.09	782
	20150408	3645	3652	3644	3651	3629	3649	3641	-3	-11	86	469.75	790
	20150409	3649	3641	3647	3650	3537	3570	3582	-71	-59	150	806.16	760
	20150410	3570	3582	3560	3560	3512	3534	3530	-48	-52	134	709.56	742
	20150413	3534	3530	3553	3589	3550	3568	3567	38	37	138	738.37	768
	20150414	3568	3567	3571	3572	3515	3530	3550	-37	-17	110	585.86	782
	20150415	3530	3550	3549	3568	3528	3547	3550	-3	0	72	383.45	788
	20150416	3547	3550	3555	3586	3547	3579	3565	29	15	94	502.67	762
	20150417	3579	3565	3591	3594	3542	3557	3565	-8	0	162	866.38	760
	20150420	3557	3565	3562	3584	3555	3584	3563	19	-2	28	149.66	748
	20150421	3584	3563	3523	3526	3499	3514	3512	-49	-51	248	1,306.75	796
	20150422	3514	3512	3520	3551	3506	3520	3519	8	7	154	812.98	768
	20150423	3520	3519	3516	3516	3455	3470	3476	-49	-43	246	1,282.98	808
	20150424	3470	3476	3474	3514	3458	3510	3486	34	10	292	1,527.25	874
	20150427	3510	3486	3484	3511	3459	3495	3489	9	3	184	963.01	888
	20150428	3495	3489	3518	3650	3518	3650	3606	161	117	758	4,100.29	862
	20150429	3650	3606	3660	3660	3606	3620	3634	14	28	566	3,085.69	836
	20150430	3620	3634	3648	3654	3610	3621	3637	-13	3	150	818.41	860
ag1510	20150105	3523	3547	3450	3529	3450	3529	3502	-18	-45	30	157.63	2014
	20150106	3529	3502	3500	3588	3500	3588	3544	86	42	180	956.97	2110
	20150107	3588	3544	3585	3611	3564	3577	3580	33	36	36	193.37	2122
	20150108	3577	3580	3575	3587	3571	3571	3582	-9	2	490	2,633.36	1644
	20150109	3571	3582	3588	3607	3577	3577	3592	-5	10	12	64.67	1636
	20150112	3577	3592	3605	3627	3589	3620	3612	28	20	34	184.26	1626
	20150113	3620	3612	3611	3662	3607	3644	3632	32	20	62	337.81	1632
	20150114	3644	3632	3670	3683	3600	3637	3645	5	13	84	459.29	1644
	20150115	3637	3645	3621	3655	3591	3591	3625	-54	-20	28	152.25	1648
	20150116	3591	3625	3686	3686	3647	3658	3661	33	36	26	142.80	1646
	20150119	3658	3661	3671	3799	3671	3775	3759	114	98	178	1,003.74	1616
	20150120	3775	3759	3786	3800	3771	3786	3785	27	26	28	159.00	1616
	20150121	3786	3785	3838	3935	3808	3921	3860	136	75	78	451.65	1600
	20150122	3921	3860	3924	3924	3830	3830	3877	-30	17	62	360.59	1602
	20150123	3830	3877	3861	3901	3844	3882	3871	5	-6	310	1,800.20	1614
	20150126	3882	3871	3847	3898	3847	3866	3886	-5	15	184	1,072.79	1618
	20150127	3866	3886	3855	3855	3782	3828	3807	-58	-79	46	262.70	1612
	20150128	3828	3807	3830	3836	3823	3827	3827	20	20	20	114.82	1604
	20150129	3827	3827	3833	3835	3790	3798	3814	-29	-13	20	114.44	1600
	20150130	3798	3814	3734	3735	3588	3595	3637	-219	-177	288	1,571.36	1704
	20150202	3595	3637	3630	3693	3630	3658	3687	21	50	230	1,272.17	1820
	20150203	3658	3687	3649	3700	3631	3692	3660	5	-27	64	351.43	1824
	20150204	3692	3660	3689	3692	3643	3668	3670	8	10	32	176.20	1818
	20150205	3668	3670	3684	3710	3684	3705	3705	35	35	406	2,256.57	1650
	20150206	3705	3705	3670	3695	3659	3695	3673	-10	-32	240	1,322.60	1650
	20150209	3695	3673	3687	3687	3603	3614	3628	-59	-45	120	653.10	1656
	20150210	3614	3628	3632	3651	3627	3646	3639	18	11	22	120.09	1654
	20150211	3646	3639	3629	3647	3617	3645	3637	6	-2	16	87.29	1650
	20150212	3645	3637	3592	3610	3588	3610	3595	-27	-42	14	75.51	1648
	20150213	3610	3595	3636	3655	3614	3649	3632	54	37	22	119.87	1648
	20150216	3649	3632	3688	3720	3685	3697	3697	65	65	14	77.64	1646
	20150217	3697	3697	3699	3710	3690	3702	3707	5	10	212	1,179.06	1818
	20150225	3702	3707	3612	3627	3609	3622	3616	-85	-91	72	390.55	1816
	20150226	3622	3616	3626	3631	3615	3631	3620	15	4	56	304.11	1822
	20150227	3631	3620	3645	3656	3627	3642	3639	22	19	18	98.27	1826
	20150302	3642	3639	3633	3670	3618	3666	3646	27	7	36	196.93	1824
	20150303	3666	3646	3666	3856	3535	3636	3689	-10	43	782	4,328.33	1904
	20150304	3636	3689	3636	3636	3594	3596	3603	-93	-86	146	789.27	1898
	20150305	3596	3603	3584	3597	3564	3564	3586	-39	-17	90	484.24	1934
	20150306	3564	3586	3573	3587	3562	3562	3571	-24	-15	16	85.72	1938
	20150309	3562	3571	3551	3559	3470	3497	3509	-74	-62	174	916.04	1914
	20150310	3497	3509	3497	3497	3461	3461	3491	-48	-18	234	1,225.39	2078
	20150311	3461	3491	3483	3485	3470	3481	3480	-10	-11	64	334.13	2074
	20150312	3481	3480	3458	3470	3424	3470	3444	-10	-36	64	330.63	2072
	20150313	3470	3444	3496	3501	3473	3482	3484	38	40	92	480.80	2060
	20150316	3482	3484	3477	3506	3456	3496	3488	12	4	284	1,486.01	2248
	20150317	3496	3488	3487	3501	3470	3470	3485	-18	-3	16	83.64	2248
	20150318	3470	3485	3445	3487	3439	3473	3462	-12	-23	36	186.98	2238
	20150319	3473	3462	3462	3566	3454	3538	3520	76	58	64	337.97	2236
	20150320	3538	3520	3546	3546	3546	3546	3546	26	26	2	10.64	2238
	20150323	3546	3546	3574	3670	3573	3658	3648	112	102	212	1,160.33	2248
	20150324	3658	3648	3686	3725	3682	3708	3701	60	53	112	621.81	2232
	20150325	3708	3701	3713	3717	3672	3672	3694	-29	-7	30	166.24	2224
	20150326	3672	3694	3728	3728	3686	3712	3713	18	19	42	233.95	2216
	20150327	3712	3713	3684	3704	3680	3704	3695	-9	-18	18	99.77	2214
	20150330	3704	3695	3678	3682	3652	3661	3665	-34	-30	110	604.85	2148
	20150331	3661	3665	3624	3641	3590	3590	3619	-75	-46	68	369.15	2118
	20150401	3590	3619	3592	3608	3588	3605	3605	-14	-14	70	378.53	2068
	20150402	3605	3605	3622	3657	3622	3652	3641	47	36	70	382.36	2030
	20150403	3652	3641	3630	3638	3620	3634	3629	-7	-12	84	457.33	2028
	20150407	3634	3629	3663	3669	3658	3661	3661	32	32	72	395.49	1988
	20150408	3661	3661	3653	3653	3653	3653	3653	-8	-8	2	10.96	1988
	20150409	3653	3653	3607	3607	3538	3564	3572	-89	-81	54	289.37	2016
	20150410	3564	3572	3532	3532	3524	3529	3529	-43	-43	36	190.61	2016
	20150413	3529	3529	3604	3604	3568	3580	3587	51	58	20	107.61	2006
	20150414	3580	3587	3576	3576	3542	3542	3561	-45	-26	46	245.77	2020
	20150415	3542	3561	3560	3577	3540	3549	3563	-12	2	144	769.73	2046
	20150416	3549	3563	3547	3595	3547	3580	3574	17	11	60	321.70	2034
	20150417	3580	3574	3596	3596	3552	3564	3567	-10	-7	36	192.65	2022
	20150420	3564	3567	3570	3570	3560	3567	3566	0	-1	86	460.05	2016
	20150421	3567	3566	3546	3546	3506	3515	3517	-51	-49	148	780.85	2114
	20150422	3515	3517	3520	3553	3518	3538	3527	21	10	80	423.27	2136
	20150423	3538	3527	3523	3523	3475	3484	3488	-43	-39	104	544.14	2142
	20150424	3484	3488	3493	3518	3493	3501	3500	13	12	18	94.51	2140
	20150427	3501	3500	3505	3555	3469	3555	3499	55	-1	296	1,553.69	2096
	20150428	3555	3499	3496	3646	3495	3630	3601	131	102	552	2,982.04	2108
	20150429	3630	3601	3651	3676	3629	3630	3658	29	57	638	3,501.32	2004
	20150430	3630	3658	3642	3676	3624	3627	3658	-31	0	168	921.88	1990
ag1511	20150105	3527	3561	3523	3545	3523	3530	3530	-31	-31	16	84.74	264
	20150106	3530	3530	3493	3585	3493	3579	3535	49	5	36	190.91	264
	20150107	3579	3535	3571	3605	3569	3580	3580	45	45	54	289.99	254
	20150108	3580	3580	3575	3580	3575	3580	3576	0	-4	12	64.38	252
	20150109	3580	3576	3590	3602	3583	3593	3589	17	13	20	107.69	256
	20150112	3593	3589	3566	3635	3565	3635	3607	46	18	18	97.40	254
	20150113	3635	3607	3624	3670	3620	3654	3641	47	34	24	131.09	262
	20150114	3654	3641	3688	3688	3608	3608	3647	-33	6	32	175.09	244
	20150115	3608	3647	3660	3660	3620	3620	3640	-27	-7	4	21.84	244
	20150116	3620	3640	3682	3682	3657	3662	3669	22	29	14	77.06	246
	20150119	3662	3669	3667	3788	3667	3788	3755	119	86	92	518.32	248
	20150120	3788	3755	3786	3793	3786	3792	3790	37	35	10	56.85	244
	20150121	3792	3790	3846	3940	3833	3932	3847	142	57	112	646.36	236
	20150122	3932	3847	3942	3942	3847	3847	3869	0	22	80	464.33	234
	20150123	3847	3869	3878	3939	3871	3903	3895	34	26	28	163.62	236
	20150126	3903	3895	3873	3918	3851	3878	3888	-17	-7	28	163.31	244
	20150127	3878	3888	3820	3844	3809	3844	3820	-44	-68	10	57.31	246
	20150128	3844	3820	3845	3869	3830	3839	3846	19	26	36	207.72	246
	20150129	3839	3846	3801	3801	3801	3801	3801	-45	-45	2	11.40	244
	20150130	3801	3801	3700	3700	3595	3604	3625	-197	-176	128	696.18	240
	20150202	3604	3625	3615	3706	3603	3673	3665	48	40	16	87.97	240
	20150203	3673	3665	3644	3682	3644	3682	3657	17	-8	6	32.92	240
	20150204	3682	3657	3676	3676	3676	3676	3676	19	19	4	22.06	240
	20150205	3676	3676	3732	3732	3732	3732	3732	56	56	2	11.20	242
	20150206	3732	3732	3694	3704	3694	3700	3699	-32	-33	8	44.39	246
	20150209	3700	3699	3615	3618	3615	3618	3615	-81	-84	94	509.82	320
	20150210	3618	3615	3655	3655	3645	3645	3648	30	33	22	120.41	306
	20150211	3645	3648				3648	3648	0	0	0	0.00	306
	20150212	3648	3648	3638	3638	3602	3605	3615	-43	-33	6	32.54	306
	20150213	3605	3615	3622	3655	3622	3655	3635	40	20	8	43.63	304
	20150216	3655	3635	3704	3713	3703	3705	3706	70	71	20	111.20	296
	20150217	3705	3706	3714	3714	3699	3700	3706	-6	0	24	133.42	276
	20150225	3700	3706	3615	3622	3615	3622	3618	-84	-88	8	43.42	276
	20150226	3622	3618	3624	3624	3624	3624	3624	6	6	14	76.10	280
	20150227	3624	3624	3654	3654	3632	3646	3645	22	21	14	76.55	272
	20150302	3646	3645	3653	3672	3650	3672	3661	27	16	22	120.83	256
	20150303	3672	3661	3663	3663	3540	3628	3604	-33	-57	28	151.40	260
	20150304	3628	3604	3640	3640	3592	3600	3608	-4	4	8	43.30	258
	20150305	3600	3608	3585	3585	3558	3579	3576	-29	-32	24	128.74	262
	20150306	3579	3576	3568	3572	3551	3551	3564	-25	-12	8	42.77	260
	20150309	3551	3564	3540	3545	3468	3488	3506	-76	-58	24	126.25	262
	20150310	3488	3506	3500	3500	3463	3463	3482	-43	-24	14	73.13	250
	20150311	3463	3482	3476	3476	3476	3476	3476	-6	-6	2	10.43	248
	20150312	3476	3476	3458	3458	3432	3447	3446	-29	-30	48	248.15	246
	20150313	3447	3446	3472	3472	3472	3472	3472	26	26	2	10.42	246
	20150316	3472	3472	3466	3503	3464	3503	3480	31	8	10	52.20	244
	20150317	3503	3480	3497	3503	3473	3473	3485	-7	5	18	94.10	242
	20150318	3473	3485	3451	3481	3451	3463	3465	-22	-20	6	31.19	244
	20150319	3463	3465	3461	3567	3455	3546	3502	81	37	32	168.10	242
	20150320	3546	3502	3556	3556	3556	3556	3556	54	54	2	10.67	242
	20150323	3556	3556	3581	3674	3573	3674	3627	118	71	44	239.42	240
	20150324	3674	3627	3691	3731	3691	3711	3701	84	74	26	144.36	242
	20150325	3711	3701	3702	3716	3697	3697	3702	-4	1	34	188.81	258
	20150326	3697	3702	3730	3730	3697	3716	3722	14	20	32	178.69	232
	20150327	3716	3722				3722	3722	0	0	0	0.00	232
	20150330	3722	3722	3673	3685	3670	3670	3675	-52	-47	22	121.31	236
	20150331	3670	3675	3645	3645	3634	3634	3639	-41	-36	6	32.76	236
	20150401	3634	3639				3639	3639	0	0	0	0.00	236
	20150402	3639	3639	3640	3666	3639	3655	3644	16	5	58	317.05	238
	20150403	3655	3644	3635	3641	3624	3641	3633	-3	-11	6	32.70	238
	20150407	3641	3633	3678	3678	3678	3678	3678	45	45	2	11.03	240
	20150408	3678	3678	3679	3679	3662	3669	3668	-9	-10	16	88.05	244
	20150409	3669	3668	3623	3629	3559	3560	3578	-108	-90	34	182.51	256
	20150410	3560	3578	3558	3558	3535	3549	3546	-29	-32	66	351.09	250
	20150413	3549	3546	3622	3622	3622	3622	3622	76	76	6	32.60	244
	20150414	3622	3622	3583	3583	3543	3543	3573	-79	-49	32	171.52	244
	20150415	3543	3573	3578	3578	3558	3558	3570	-15	-3	24	128.54	252
	20150416	3558	3570	3558	3598	3551	3590	3576	20	6	14	75.11	252
	20150417	3590	3576	3585	3585	3557	3564	3566	-12	-10	12	64.20	252
	20150420	3564	3566	3571	3593	3571	3593	3585	27	19	10	53.78	252
	20150421	3593	3585	3524	3524	3516	3517	3518	-68	-67	14	73.89	252
	20150422	3517	3518	3522	3542	3522	3538	3531	20	13	8	42.37	252
	20150423	3538	3531	3500	3500	3482	3488	3491	-43	-40	16	83.80	252
	20150424	3488	3491	3505	3519	3501	3506	3506	15	15	68	357.66	270
	20150427	3506	3506	3500	3522	3477	3522	3501	16	-5	42	220.58	270
	20150428	3522	3501	3544	3660	3530	3627	3616	126	115	98	531.60	262
	20150429	3627	3616	3628	3697	3628	3657	3653	41	37	102	558.97	262
	20150430	3657	3653	3663	3676	3628	3633	3641	-20	-12	20	109.24	254
ag1512	20150105	3552	3548	3517	3539	3517	3533	3529	-15	-19	296	1,566.98	860
	20150106	3533	3529	3699	3699	3490	3586	3540	57	11	988	5,246.52	1204
	20150107	3586	3540	3577	3621	3561	3588	3587	48	47	702	3,777.83	1234
	20150108	3588	3587	3576	3608	3572	3580	3589	-7	2	582	3,133.86	1354
	20150109	3580	3589	3600	3615	3580	3590	3591	1	2	472	2,543.13	1480
	20150112	3590	3591	3567	3638	3553	3632	3610	41	19	866	4,689.61	1620
	20150113	3632	3610	3608	3676	3601	3649	3637	39	27	886	4,833.70	1642
	20150114	3649	3637	3675	3700	3606	3637	3651	0	14	1952	10,690.70	2366
	20150115	3637	3651	3552	3666	3552	3600	3631	-51	-20	1168	6,362.76	2314
	20150116	3600	3631	3675	3690	3645	3673	3662	42	31	1592	8,746.94	2660
	20150119	3673	3662	3667	3805	3667	3786	3763	124	101	3492	19,713.04	4106
	20150120	3786	3763	3791	3819	3771	3795	3795	32	32	1804	10,269.34	4450
	20150121	3795	3795	3820	3955	3820	3932	3861	137	66	9610	55,666.71	8414
	20150122	3932	3861	3920	3969	3838	3854	3887	-7	26	12958	75,564.26	14326
	20150123	3854	3887	3873	3918	3854	3896	3895	9	8	4594	26,841.89	15712
	20150126	3896	3895	3898	3932	3856	3897	3905	2	10	1660	9,723.58	15910
	20150127	3897	3905	3883	3890	3811	3859	3838	-46	-67	2684	15,455.61	16360
	20150128	3859	3838	3875	3875	3838	3858	3851	20	13	1748	10,099.39	16844
	20150129	3858	3851	3860	3865	3792	3800	3817	-51	-34	8664	49,611.02	16808
	20150130	3800	3817	3765	3765	3606	3613	3648	-204	-169	9316	50,990.61	16968
	20150202	3613	3648	3620	3710	3596	3668	3651	20	3	5120	28,042.48	17024
	20150203	3668	3651	3661	3718	3645	3711	3678	60	27	3764	20,769.88	17334
	20150204	3711	3678	3711	3713	3655	3688	3685	10	7	4234	23,407.63	18338
	20150205	3688	3685	3710	3749	3694	3716	3721	31	36	3310	18,477.65	18396
	20150206	3716	3721	3696	3718	3674	3709	3699	-12	-22	3858	21,410.33	18110
	20150209	3709	3699	3712	3728	3604	3630	3638	-69	-61	11502	62,778.18	17878
	20150210	3630	3638	3637	3666	3632	3652	3648	14	10	2468	13,507.43	17884
	20150211	3652	3648	3639	3670	3632	3657	3650	9	2	2276	12,462.12	18008
	20150212	3657	3650	3650	3655	3598	3624	3623	-26	-27	5668	30,803.24	18422
	20150213	3624	3623	3632	3683	3615	3672	3643	49	20	4790	26,178.91	18514
	20150216	3672	3643	3658	3736	3658	3727	3712	84	69	5050	28,121.85	18242
	20150217	3727	3712	3727	3729	3698	3716	3715	4	3	2532	14,111.22	18290
	20150225	3716	3715	3651	3651	3614	3625	3628	-90	-87	5048	27,472.74	18212
	20150226	3625	3628	3622	3650	3617	3642	3634	14	6	6922	37,732.45	19812
	20150227	3642	3634	3654	3667	3627	3645	3646	11	12	7964	43,565.04	19086
	20150302	3645	3646	3636	3684	3625	3673	3657	27	11	7220	39,615.59	20278
	20150303	3673	3657	3663	3675	3535	3625	3607	-32	-50	15960	86,353.19	20962
	20150304	3625	3607	3634	3642	3592	3597	3610	-10	3	11158	60,435.20	22284
	20150305	3597	3610	3600	3605	3554	3571	3580	-39	-30	15838	85,067.63	24572
	20150306	3571	3580	3568	3597	3552	3567	3572	-13	-8	8414	45,088.36	25656
	20150309	3567	3572	3577	3577	3470	3505	3506	-67	-66	20360	107,083.74	27752
	20150310	3505	3506	3500	3505	3462	3464	3486	-42	-20	11534	60,315.77	29748
	20150311	3464	3486	3477	3500	3473	3487	3486	1	0	8756	45,786.59	30678
	20150312	3487	3486	3474	3497	3416	3490	3450	4	-36	24158	125,029.89	33878
	20150313	3490	3450	3480	3509	3465	3480	3488	30	38	16546	86,585.13	31834
	20150316	3480	3488	3485	3514	3460	3506	3483	18	-5	20396	106,563.94	31146
	20150317	3506	3483	3487	3509	3467	3480	3486	-3	3	11524	60,271.25	31818
	20150318	3480	3486	3467	3498	3438	3457	3469	-29	-17	18830	97,987.26	32550
	20150319	3457	3469	3457	3573	3400	3543	3521	74	52	29486	155,772.98	33218
	20150320	3543	3521	3522	3572	3522	3553	3550	32	29	19028	101,341.27	35902
	20150323	3553	3550	3559	3686	3559	3675	3641	125	91	50768	277,271.18	36518
	20150324	3675	3641	3680	3737	3680	3716	3711	75	70	32952	183,466.23	42422
	20150325	3716	3711	3729	3734	3679	3695	3700	-16	-11	25420	141,103.40	44412
	20150326	3695	3700	3729	3749	3693	3736	3719	36	19	25984	144,962.76	46862
	20150327	3736	3719	3721	3729	3691	3717	3713	-2	-6	30596	170,409.59	49924
	20150330	3717	3713	3724	3724	3663	3669	3685	-44	-28	30918	170,931.02	53808
	20150331	3669	3685	3650	3663	3605	3610	3638	-75	-47	25852	141,078.24	57894
	20150401	3610	3638	3625	3649	3602	3626	3629	-12	-9	19172	104,366.93	57830
	20150402	3626	3629	3636	3692	3631	3685	3667	56	38	39170	215,469.96	58854
	20150403	3685	3667	3660	3668	3629	3657	3648	-10	-19	19604	107,273.48	60656
	20150407	3657	3648	3661	3692	3660	3680	3681	32	33	9532	52,640.94	61578
	20150408	3680	3681	3662	3686	3662	3679	3675	-2	-6	12494	68,888.27	62692
	20150409	3679	3675	3666	3679	3552	3567	3607	-108	-68	44652	241,592.54	71998
	20150410	3567	3607	3566	3578	3533	3566	3554	-41	-53	29774	158,751.95	74784
	20150413	3566	3554	3580	3637	3580	3606	3608	52	54	43308	234,402.24	74418
	20150414	3606	3608	3602	3610	3545	3569	3576	-39	-32	38722	207,724.77	74988
	20150415	3569	3576	3550	3603	3550	3561	3573	-15	-3	55908	299,686.68	89452
	20150416	3561	3573	3559	3610	3553	3598	3583	25	10	52438	281,899.08	94706
	20150417	3598	3583	3608	3617	3552	3564	3572	-19	-11	60734	325,498.70	104014
	20150420	3564	3572	3565	3607	3564	3606	3580	34	8	39532	212,308.84	102362
	20150421	3606	3580	3563	3564	3514	3519	3529	-61	-51	77110	408,280.85	122868
	20150422	3519	3529	3527	3560	3519	3542	3532	13	3	68028	360,421.17	136936
	20150423	3542	3532	3528	3529	3470	3484	3493	-48	-39	113186	593,206.03	170230
	20150424	3484	3493	3493	3527	3488	3518	3507	25	14	109112	574,017.00	194964
	20150427	3518	3507	3503	3542	3478	3522	3513	15	6	194074	1,022,951.91	251734
	20150428	3522	3513	3536	3655	3530	3648	3619	135	106	266538	1,447,053.91	263524
	20150429	3648	3619	3663	3682	3628	3644	3657	25	38	255112	1,399,669.42	269626
	20150430	3644	3657	3650	3692	3636	3647	3659	-10	2	198308	1,088,627.54	289166
ag1601	20150116	3631	3631				3631	3631	0	0	0	0.00	0
	20150119	3631	3631	3768	3851	3768	3797	3793	166	162	20	113.80	8
	20150120	3797	3793	3801	3808	3786	3808	3798	15	5	12	68.37	8
	20150121	3808	3798	3840	3950	3838	3945	3940	147	142	90	531.98	92
	20150122	3945	3940	3949	3949	3870	3890	3890	-50	-50	108	630.24	32
	20150123	3890	3890	3890	3917	3890	3901	3906	11	16	34	199.24	38
	20150126	3901	3906	3869	3920	3816	3915	3895	9	-11	30	175.28	32
	20150127	3915	3895				3895	3895	0	0	0	0.00	32
	20150128	3895	3895	3843	3889	3843	3867	3862	-28	-33	12	69.52	34
	20150129	3867	3862	3850	3850	3850	3850	3850	-12	-12	2	11.55	36
	20150130	3850	3850	3744	3744	3619	3619	3643	-231	-207	24	131.16	52
	20150202	3619	3643	3611	3689	3611	3689	3646	46	3	16	87.53	58
	20150203	3689	3646	3655	3700	3655	3700	3675	54	29	10	55.13	56
	20150204	3700	3675	3690	3690	3672	3690	3683	15	8	14	77.36	64
	20150205	3690	3683	3721	3743	3712	3742	3732	59	49	28	156.77	60
	20150206	3742	3732				3731	3731	-1	-1	0	0.00	60
	20150209	3731	3731	3642	3647	3630	3646	3641	-85	-90	24	131.09	62
	20150210	3646	3641	3662	3667	3661	3661	3664	20	23	22	120.92	58
	20150211	3661	3664				3664	3664	0	0	0	0.00	58
	20150212	3664	3664	3662	3663	3613	3625	3643	-39	-21	12	65.57	66
	20150213	3625	3643	3662	3681	3629	3669	3659	26	16	16	87.83	70
	20150216	3669	3659	3724	3742	3712	3727	3725	68	66	116	648.24	122
	20150217	3727	3725	3718	3718	3718	3718	3718	-7	-7	2	11.15	122
	20150225	3718	3718	3641	3656	3633	3634	3639	-84	-79	34	185.63	138
	20150226	3634	3639	3650	3654	3650	3654	3652	15	13	4	21.91	138
	20150227	3654	3652	3675	3675	3649	3649	3664	-3	12	14	76.94	134
	20150302	3649	3664	3649	3686	3635	3682	3668	18	4	56	308.15	126
	20150303	3682	3668	3657	3657	3558	3650	3609	-18	-59	84	454.85	134
	20150304	3650	3609	3634	3650	3608	3614	3618	5	9	44	238.82	142
	20150305	3614	3618	3597	3605	3579	3579	3592	-39	-26	60	323.33	148
	20150306	3579	3592	3589	3597	3562	3567	3579	-25	-13	42	225.48	140
	20150309	3567	3579	3555	3562	3488	3515	3513	-64	-66	132	695.63	186
	20150310	3515	3513	3505	3507	3494	3494	3503	-19	-10	28	147.13	182
	20150311	3494	3503	3487	3500	3487	3490	3493	-13	-10	20	104.81	190
	20150312	3490	3493	3483	3509	3430	3509	3458	16	-35	94	487.60	204
	20150313	3509	3458	3492	3510	3484	3499	3491	41	33	44	230.45	200
	20150316	3499	3491	3489	3520	3478	3518	3498	27	7	30	157.44	194
	20150317	3518	3498	3483	3495	3483	3487	3489	-11	-9	18	94.21	200
	20150318	3487	3489	3481	3481	3466	3466	3475	-23	-14	10	52.13	200
	20150319	3466	3475	3476	3579	3466	3544	3541	69	66	58	308.12	186
	20150320	3544	3541	3548	3571	3542	3562	3556	21	15	38	202.70	186
	20150323	3562	3556	3575	3680	3575	3673	3661	117	105	186	1,021.55	280
	20150324	3673	3661	3704	3748	3704	3727	3719	66	58	84	468.63	250
	20150325	3727	3719	3705	3712	3693	3696	3702	-23	-17	10	55.54	250
	20150326	3696	3702	3725	3735	3710	3735	3720	33	18	20	111.61	248
	20150327	3735	3720	3730	3730	3716	3724	3719	4	-1	46	256.64	258
	20150330	3724	3719	3721	3721	3677	3677	3698	-42	-21	46	255.17	260
	20150331	3677	3698	3667	3674	3626	3626	3650	-72	-48	98	536.66	220
	20150401	3626	3650	3650	3657	3617	3638	3640	-12	-10	50	273.05	222
	20150402	3638	3640	3650	3713	3650	3693	3685	53	45	62	342.73	228
	20150403	3693	3685	3675	3675	3646	3656	3653	-29	-32	68	372.69	234
	20150407	3656	3653	3696	3701	3688	3699	3696	46	43	48	266.14	224
	20150408	3699	3696	3692	3693	3676	3693	3686	-3	-10	36	199.05	224
	20150409	3693	3686	3689	3689	3572	3580	3615	-106	-71	314	1,703.00	216
	20150410	3580	3615	3573	3579	3552	3568	3564	-47	-51	162	866.10	242
	20150413	3568	3564	3597	3627	3597	3616	3612	52	48	40	216.75	238
	20150414	3616	3612	3619	3619	3562	3575	3594	-37	-18	356	1,919.24	306
	20150415	3575	3594	3585	3611	3549	3572	3584	-22	-10	94	505.46	290
	20150416	3572	3584	3574	3612	3565	3606	3595	22	11	88	474.60	312
	20150417	3606	3595	3619	3619	3562	3575	3583	-20	-12	150	806.26	298
	20150420	3575	3583	3588	3600	3584	3600	3589	17	6	46	247.67	298
	20150421	3600	3589	3566	3566	3528	3528	3544	-61	-45	76	404.12	306
	20150422	3528	3544	3535	3571	3532	3550	3542	6	-2	116	616.37	332
	20150423	3550	3542	3538	3563	3483	3496	3507	-46	-35	448	2,356.76	456
	20150424	3496	3507	3496	3530	3496	3524	3514	17	7	376	1,981.91	502
	20150427	3524	3514	3515	3618	3490	3527	3525	13	11	288	1,522.87	480
	20150428	3527	3525	3573	3664	3541	3651	3633	126	108	596	3,248.37	490
	20150429	3651	3633	3658	3686	3640	3649	3667	16	34	206	1,133.15	458
	20150430	3649	3667	3666	3696	3648	3664	3671	-3	4	134	738.01	466
ag1602	20150216	3659	3659				3725	3725	66	66	0	0.00	0
	20150217	3725	3725				3718	3718	-7	-7	0	0.00	0
	20150225	3718	3718	3629	3654	3629	3654	3641	-64	-77	4	21.85	2
	20150226	3654	3641				3654	3654	13	13	0	0.00	2
	20150227	3654	3654	3688	3688	3688	3688	3688	34	34	4	22.13	6
	20150302	3688	3688	3660	3684	3623	3684	3655	-4	-33	6	32.90	6
	20150303	3684	3655	3670	3670	3594	3654	3634	-1	-21	32	174.46	10
	20150304	3654	3634	3636	3636	3621	3624	3627	-10	-7	10	54.41	12
	20150305	3624	3627	3596	3596	3596	3596	3596	-31	-31	2	10.79	12
	20150306	3596	3596	3580	3580	3580	3580	3580	-16	-16	2	10.74	14
	20150309	3580	3580	3496	3503	3492	3501	3498	-79	-82	8	41.98	14
	20150310	3501	3498	3503	3503	3503	3503	3503	5	5	2	10.51	16
	20150311	3503	3503				3503	3503	0	0	0	0.00	16
	20150312	3503	3503	3462	3465	3462	3465	3462	-38	-41	12	62.33	18
	20150313	3465	3462				3488	3488	26	26	0	0.00	18
	20150316	3488	3488				3515	3515	27	27	0	0.00	18
	20150317	3515	3515	3502	3502	3502	3502	3502	-13	-13	2	10.51	20
	20150318	3502	3502	3465	3505	3454	3454	3481	-48	-21	8	41.78	22
	20150319	3454	3481	3489	3583	3489	3564	3556	83	75	18	96.01	26
	20150320	3564	3556	3565	3565	3565	3565	3565	9	9	2	10.70	24
	20150323	3565	3565	3596	3596	3596	3596	3596	31	31	2	10.79	22
	20150324	3596	3596	3730	3730	3710	3719	3722	123	126	14	78.16	26
	20150325	3719	3722	3708	3719	3706	3711	3713	-11	-9	18	100.27	24
	20150326	3711	3713	3712	3712	3712	3712	3712	-1	-1	2	11.14	24
	20150327	3712	3712	3723	3723	3721	3721	3722	9	10	4	22.33	24
	20150330	3721	3722	3707	3707	3707	3707	3707	-15	-15	2	11.12	24
	20150331	3707	3707	3660	3675	3648	3648	3662	-59	-45	10	54.94	24
	20150401	3648	3662	3645	3645	3645	3645	3645	-17	-17	2	10.94	26
	20150402	3645	3645	3656	3689	3656	3689	3669	44	24	6	33.03	24
	20150403	3689	3669	3650	3663	3648	3662	3656	-7	-13	10	54.84	28
	20150407	3662	3656				3692	3692	36	36	0	0.00	28
	20150408	3692	3692	3701	3701	3701	3701	3701	9	9	2	11.10	30
	20150409	3701	3701	3681	3681	3618	3618	3650	-83	-51	78	427.06	88
	20150410	3618	3650	3564	3590	3564	3590	3577	-60	-73	8	42.92	88
	20150413	3590	3577	3662	3662	3637	3637	3654	60	77	40	219.26	86
	20150414	3637	3654	3603	3618	3583	3589	3594	-65	-60	164	884.15	80
	20150415	3589	3594	3601	3624	3588	3588	3597	-6	3	34	183.48	78
	20150416	3588	3597	3585	3614	3585	3607	3598	10	1	8	43.18	78
	20150417	3607	3598	3587	3589	3572	3589	3582	-9	-16	6	32.24	74
	20150420	3589	3582	3599	3600	3590	3600	3593	18	11	28	150.93	66
	20150421	3600	3593	3554	3554	3554	3554	3554	-39	-39	8	42.65	58
	20150422	3554	3554	3541	3561	3541	3555	3547	1	-7	14	74.49	54
	20150423	3555	3547	3494	3494	3494	3494	3494	-53	-53	2	10.48	52
	20150424	3494	3494	3525	3525	3525	3525	3525	31	31	2	10.58	50
	20150427	3525	3525	3541	3547	3540	3540	3542	15	17	6	31.88	50
	20150428	3540	3542	3652	3656	3652	3656	3654	114	112	4	21.92	52
	20150429	3656	3654	3685	3685	3685	3685	3685	31	31	2	11.06	52
	20150430	3685	3685				3685	3685	0	0	0	0.00	52
ag1603	20150317	3515	3515	3491	3502	3491	3502	3494	-13	-21	6	31.45	4
	20150318	3502	3494	3543	3543	3500	3500	3528	6	34	6	31.76	0
	20150319	3500	3528				3556	3556	28	28	0	0.00	0
	20150320	3556	3556	3577	3577	3577	3577	3577	21	21	2	10.73	2
	20150323	3577	3577	3701	3701	3669	3669	3685	92	108	4	22.11	4
	20150324	3669	3685	3710	3751	3688	3751	3725	66	40	16	89.40	4
	20150325	3751	3725				3725	3725	0	0	0	0.00	4
	20150326	3725	3725				3725	3725	0	0	0	0.00	4
	20150327	3725	3725				3725	3725	0	0	0	0.00	4
	20150330	3725	3725				3725	3725	0	0	0	0.00	4
	20150331	3725	3725	3664	3664	3645	3645	3656	-80	-69	8	43.88	6
	20150401	3645	3656				3656	3656	0	0	0	0.00	6
	20150402	3656	3656	3667	3746	3630	3673	3679	17	23	8	44.15	6
	20150403	3673	3679				3679	3679	0	0	0	0.00	6
	20150407	3679	3679	3711	3725	3698	3700	3708	21	29	12	66.75	10
	20150408	3700	3708	3719	3719	3665	3700	3696	-8	-12	20	110.89	18
	20150409	3700	3696	3655	3655	3601	3601	3615	-95	-81	10	54.23	26
	20150410	3601	3615	3592	3592	3579	3579	3585	-36	-30	4	21.51	26
	20150413	3579	3585	3663	3663	3604	3628	3625	43	40	12	65.25	26
	20150414	3628	3625	3624	3631	3586	3586	3616	-39	-9	8	43.40	26
	20150415	3586	3616	3612	3624	3581	3590	3605	-26	-11	12	64.89	32
	20150416	3590	3605	3586	3625	3585	3625	3595	20	-10	12	64.72	36
	20150417	3625	3595	3625	3625	3601	3601	3613	6	18	4	21.68	36
	20150420	3601	3613	3609	3609	3609	3609	3609	-4	-4	2	10.83	34
	20150421	3609	3609	3558	3560	3543	3543	3547	-66	-62	18	95.78	40
	20150422	3543	3547	3561	3561	3555	3559	3556	12	9	44	234.73	64
	20150423	3559	3556	3550	3550	3505	3519	3522	-37	-34	22	116.24	72
	20150424	3519	3522	3505	3543	3505	3531	3530	9	8	16	84.74	78
	20150427	3531	3530	3510	3565	3505	3565	3527	35	-3	42	222.25	72
	20150428	3565	3527	3604	3670	3584	3656	3636	129	109	50	272.73	86
	20150429	3656	3636	3674	3677	3654	3660	3670	24	34	14	77.09	90
	20150430	3660	3670	3682	3682	3669	3669	3675	-1	5	4	22.05	92
ag1604	20150416	3605	3605				3595	3595	-10	-10	0	0.00	0
	20150417	3595	3595	3659	3659	3615	3615	3637	20	42	4	21.82	2
	20150420	3615	3637				3637	3637	0	0	0	0.00	2
	20150421	3637	3637	3546	3555	3546	3550	3550	-87	-87	6	31.95	8
	20150422	3550	3550	3540	3578	3540	3556	3555	6	5	26	138.68	26
	20150423	3556	3555	3532	3544	3515	3544	3522	-11	-33	14	73.98	34
	20150424	3544	3522				3522	3522	0	0	0	0.00	34
	20150427	3522	3522				3519	3519	-3	-3	0	0.00	34
	20150428	3519	3519	3610	3673	3610	3673	3643	154	124	8	43.73	36
	20150429	3673	3643	3680	3861	3653	3653	3693	10	50	46	254.86	48
	20150430	3653	3693	3700	3732	3666	3701	3705	8	12	100	555.83	50
al1501	20150105	12985	12945	12840	12855	12795	12825	12820	-120	-125	6448	41,341.47	31110
	20150106	12825	12820	12695	12780	12685	12750	12760	-70	-60	6550	41,789.05	30380
	20150107	12750	12760	12750	12750	12665	12675	12695	-85	-65	6980	44,320.73	30270
	20150108	12675	12695	12700	12755	12700	12745	12730	50	35	4430	28,201.85	30120
	20150109	12745	12730	12800	12835	12755	12825	12800	95	70	4460	28,550.80	27510
	20150112	12825	12800	12830	12835	12655	12715	12760	-85	-40	7410	47,279.33	21490
	20150113	12715	12760	12730	12730	12655	12685	12680	-75	-80	5190	32,916.05	17130
	20150114	12685	12680	12690	12690	12415	12555	12570	-125	-110	3670	23,072.18	15080
	20150115	12555	12570	12630	12980	12610	12980	12665	410	95	3260	20,648.88	13690
al1502	20150105	12990	13005	12800	12915	12800	12820	12865	-185	-140	21150	136,053.05	74594
	20150106	12820	12865	12785	12835	12705	12795	12790	-70	-75	22450	143,568.84	69198
	20150107	12795	12790	12775	12805	12695	12700	12730	-90	-60	12984	82,670.31	66630
	20150108	12700	12730	12740	12790	12710	12770	12745	40	15	8760	55,840.66	65650
	20150109	12770	12745	12790	12855	12740	12830	12805	85	60	8564	54,836.03	64112
	20150112	12830	12805	12800	12820	12725	12725	12765	-80	-40	8076	51,561.16	62552
	20150113	12725	12765	12700	12740	12660	12715	12685	-50	-80	12266	77,805.63	57786
	20150114	12715	12685	12650	12730	12435	12585	12570	-100	-115	14526	91,311.91	54404
	20150115	12585	12570	12650	12940	12615	12780	12720	210	150	11512	73,228.04	50330
	20150116	12780	12720	12855	12855	12720	12760	12770	40	50	6318	40,344.74	48540
	20150119	12760	12770	12790	12900	12790	12800	12820	30	50	5646	36,199.61	46930
	20150120	12800	12820	12755	12805	12730	12735	12760	-85	-60	4384	27,970.07	45694
	20150121	12735	12760	12805	12810	12710	12730	12735	-30	-25	3848	24,504.24	44790
	20150122	12730	12735	12720	12800	12695	12780	12770	45	35	3680	23,498.42	43728
	20150123	12780	12770	12790	12815	12745	12760	12765	-10	-5	7312	46,679.24	41156
	20150126	12760	12765	12705	12745	12665	12700	12705	-65	-60	8728	55,464.11	37726
	20150127	12700	12705	12715	12835	12715	12770	12770	65	65	4748	30,325.00	38258
	20150128	12770	12770	12675	12780	12675	12770	12735	0	-35	5084	32,374.46	37318
	20150129	12770	12735	12760	12760	12710	12710	12725	-25	-10	2784	17,715.65	36156
	20150130	12710	12725	12740	12760	12650	12760	12690	35	-35	5536	35,126.27	34050
	20150202	12760	12690	12750	12800	12700	12785	12745	95	55	5570	35,501.40	32190
	20150203	12785	12745	12820	13080	12820	13080	12965	335	220	6520	42,275.28	28780
	20150204	13080	12965	13010	13120	13010	13120	13085	155	120	5630	36,845.05	25890
	20150205	13120	13085	13055	13185	13055	13100	13130	15	45	6920	45,442.85	24060
	20150206	13100	13130	13110	13250	13100	13210	13205	80	75	6340	41,867.40	19030
	20150209	13210	13205	13190	13190	13145	13145	13160	-60	-45	2770	18,231.85	16610
	20150210	13145	13160	13145	13150	13005	13055	13100	-105	-60	4300	28,167.45	13830
al1503	20150105	13060	13080	12970	12985	12860	12895	12915	-185	-165	56386	364,185.65	157426
	20150106	12895	12915	12860	12880	12800	12845	12835	-70	-80	56276	361,168.76	160562
	20150107	12845	12835	12800	12860	12760	12760	12790	-75	-45	63712	407,487.33	168550
	20150108	12760	12790	12780	12845	12755	12805	12800	15	10	47172	301,940.80	166856
	20150109	12805	12800	12850	12900	12780	12855	12845	55	45	62750	403,152.41	161134
	20150112	12855	12845	12840	12855	12760	12770	12805	-75	-40	41144	263,460.13	162158
	20150113	12770	12805	12705	12770	12685	12750	12725	-55	-80	55832	355,243.90	160048
	20150114	12750	12725	12700	12755	12445	12620	12605	-105	-120	115790	730,005.54	155188
	20150115	12620	12605	12670	13005	12665	12840	12770	235	165	96998	619,438.21	139916
	20150116	12840	12770	12930	12930	12765	12820	12815	50	45	44358	284,330.97	136906
	20150119	12820	12815	12840	12950	12825	12845	12870	30	55	45928	295,612.81	135432
	20150120	12845	12870	12835	12850	12765	12775	12805	-95	-65	33438	214,163.60	133104
	20150121	12775	12805	12820	12850	12745	12775	12785	-30	-20	36746	234,977.05	128830
	20150122	12775	12785	12760	12855	12740	12825	12805	40	20	34910	223,592.09	126454
	20150123	12825	12805	12880	12880	12795	12815	12820	10	15	30180	193,526.30	122420
	20150126	12815	12820	12790	12805	12710	12775	12765	-45	-55	34984	223,287.35	119076
	20150127	12775	12765	12800	12895	12765	12840	12830	75	65	39482	253,335.71	111106
	20150128	12840	12830	12800	12830	12750	12805	12800	-25	-30	28512	182,479.30	104836
	20150129	12805	12800	12830	12830	12765	12775	12785	-25	-15	18054	115,430.64	100328
	20150130	12775	12785	12850	12850	12715	12740	12750	-45	-35	18062	115,153.17	92764
	20150202	12740	12750	12790	12850	12775	12840	12805	90	55	21278	136,275.93	83840
	20150203	12840	12805	12840	13170	12835	13140	12985	335	180	25956	168,553.71	75960
	20150204	13140	12985	13300	13300	13055	13165	13130	180	145	15632	102,658.83	72262
	20150205	13165	13130	13160	13270	13115	13170	13175	40	45	21654	142,681.02	72734
	20150206	13170	13175	13150	13305	13130	13285	13255	110	80	15496	102,729.98	69634
	20150209	13285	13255	13275	13280	13155	13175	13205	-80	-50	8858	58,493.40	67276
	20150210	13175	13205	13190	13200	13060	13060	13125	-145	-80	9114	59,827.62	65570
	20150211	13060	13125	13080	13100	12980	12990	13010	-135	-115	5622	36,585.03	63928
	20150212	12990	13010	12995	12995	12905	12925	12930	-85	-80	6656	43,031.53	62432
	20150213	12925	12930	12960	13160	12940	13025	13005	95	75	4780	31,089.37	61288
	20150216	13025	13005	13000	13085	12975	12995	13000	-10	-5	5792	37,651.29	58714
	20150217	12995	13000	12990	13030	12945	13000	12980	0	-20	3674	23,849.42	57044
	20150225	13000	12980	12975	13035	12925	12935	12955	-45	-25	3894	25,228.99	54902
	20150226	12935	12955	12900	12960	12875	12950	12915	-5	-40	10444	67,460.53	51840
	20150227	12950	12915	12965	12970	12890	12890	12910	-25	-5	7094	45,809.13	48764
	20150302	12890	12910	12880	13030	12870	13020	12945	110	35	7854	50,847.56	46360
	20150303	13020	12945	12960	12995	12940	12950	12950	5	5	5410	35,039.05	43590
	20150304	12950	12950	12920	12950	12865	12900	12905	-50	-45	9560	61,702.18	38300
	20150305	12900	12905	12935	12935	12880	12905	12895	0	-10	4320	27,859.85	35780
	20150306	12905	12895	12930	12940	12890	12900	12900	5	5	3470	22,387.05	35610
	20150309	12900	12900	12900	12900	12860	12890	12875	-10	-25	3490	22,473.75	35310
	20150310	12890	12875	12870	12920	12870	12885	12900	10	25	5770	37,216.68	33060
	20150311	12885	12900	12850	12895	12850	12895	12880	-5	-20	5620	36,193.08	29640
	20150312	12895	12880	12885	13035	12880	13035	12945	155	65	7410	47,964.93	24780
	20150313	13035	12945	13300	13300	13080	13150	13135	205	190	5990	39,346.88	21810
	20150316	13150	13135	13200	13200	13020	13020	13100	-115	-35	4500	29,483.38	19750
al1504	20150105	13150	13170	13040	13060	12930	12960	12985	-210	-185	17198	111,668.83	64838
	20150106	12960	12985	12800	12940	12800	12910	12895	-75	-90	17314	111,640.59	66700
	20150107	12910	12895	12805	12915	12805	12835	12855	-60	-40	13988	89,909.30	72578
	20150108	12835	12855	12880	12905	12820	12865	12865	10	10	14084	90,617.34	75198
	20150109	12865	12865	12885	12950	12840	12920	12905	55	40	19124	123,405.62	78452
	20150112	12920	12905	12875	12910	12815	12820	12855	-85	-50	14668	94,308.50	81676
	20150113	12820	12855	12805	12810	12730	12795	12770	-60	-85	19772	126,272.97	84996
	20150114	12795	12770	12720	12805	12520	12680	12670	-90	-100	38696	245,209.73	90928
	20150115	12680	12670	12745	13150	12745	12905	12830	235	160	35458	227,516.55	92022
	20150116	12905	12830	12920	12995	12830	12870	12880	40	50	19586	126,137.90	95748
	20150119	12870	12880	12890	13000	12885	12915	12930	35	50	27350	176,836.20	101216
	20150120	12915	12930	12880	12905	12830	12850	12870	-80	-60	22626	145,600.01	105000
	20150121	12850	12870	12905	12915	12810	12830	12845	-40	-25	27342	175,605.54	110710
	20150122	12830	12845	12830	12920	12800	12880	12870	35	25	25612	164,872.31	116826
	20150123	12880	12870	12900	12920	12855	12875	12880	5	10	24880	160,285.69	118540
	20150126	12875	12880	12865	12865	12765	12825	12815	-55	-65	33432	214,260.70	123432
	20150127	12825	12815	12840	12960	12815	12900	12890	85	75	39026	251,603.04	131160
	20150128	12900	12890	12855	12890	12800	12865	12850	-25	-40	27478	176,601.69	134836
	20150129	12865	12850	12870	12875	12815	12830	12840	-20	-10	18792	120,660.18	136722
	20150130	12830	12840	12820	12835	12770	12810	12795	-30	-45	29420	188,276.64	143652
	20150202	12810	12795	12855	12910	12835	12885	12865	90	70	35638	229,306.34	144530
	20150203	12885	12865	12890	13300	12885	13160	13040	295	175	63988	417,300.35	142264
	20150204	13160	13040	13200	13250	13105	13225	13180	185	140	48574	320,211.57	141478
	20150205	13225	13180	13200	13350	13180	13235	13250	55	70	75206	498,366.74	135176
	20150206	13235	13250	13200	13375	13195	13360	13310	110	60	46732	311,084.32	131290
	20150209	13360	13310	13350	13350	13220	13235	13270	-75	-40	34228	227,158.04	124518
	20150210	13235	13270	13250	13255	13125	13155	13185	-115	-85	30268	199,617.04	118844
	20150211	13155	13185	13125	13160	13030	13035	13070	-150	-115	33430	218,548.10	117494
	20150212	13035	13070	13030	13045	12960	12990	12990	-80	-80	29642	192,535.89	116708
	20150213	12990	12990	13035	13115	13000	13080	13060	90	70	29074	189,866.55	112718
	20150216	13080	13060	13085	13135	13035	13060	13065	0	5	21448	140,153.51	109892
	20150217	13060	13065	13050	13095	12995	13060	13035	-5	-30	19590	127,725.85	110034
	20150225	13060	13035	13035	13145	12975	12990	13010	-45	-25	16314	106,142.29	108462
	20150226	12990	13010	12920	13005	12905	12980	12950	-30	-60	33526	217,158.29	104990
	20150227	12980	12950	13025	13025	12925	12930	12955	-20	5	22422	145,286.50	100432
	20150302	12930	12955	12930	13060	12910	13050	12980	95	25	21930	142,331.57	93708
	20150303	13050	12980	13010	13040	12960	12965	12990	-15	10	19046	123,748.39	89718
	20150304	12965	12990	12950	12965	12885	12890	12925	-100	-65	14300	92,441.60	88492
	20150305	12890	12925	12930	12975	12900	12930	12925	5	0	8030	51,895.84	88514
	20150306	12930	12925	12945	12965	12890	12890	12920	-35	-5	6176	39,904.56	89632
	20150309	12890	12920	12915	12925	12845	12900	12880	-20	-40	11398	73,430.28	84678
	20150310	12900	12880	12865	12945	12850	12885	12900	5	20	7240	46,700.61	82938
	20150311	12885	12900	12840	12920	12840	12885	12870	-15	-30	9130	58,753.68	78810
	20150312	12885	12870	12890	13245	12860	13100	12975	230	105	15388	99,834.28	72642
	20150313	13100	12975	13070	13170	13025	13075	13110	100	135	16878	110,672.47	66712
	20150316	13075	13110	13065	13125	13050	13075	13075	-35	-35	8122	53,102.06	66124
	20150317	13075	13075	13040	13105	13040	13070	13070	-5	-5	5532	36,160.56	65856
	20150318	13070	13070	13030	13130	13030	13120	13110	50	40	7576	49,663.41	62092
	20150319	13120	13110	13115	13310	13090	13220	13230	110	120	10288	68,058.99	57722
	20150320	13220	13230	13275	13360	13220	13265	13305	35	75	14968	99,609.96	53720
	20150323	13265	13305	13235	13345	13235	13260	13295	-45	-10	5880	39,093.05	51588
	20150324	13260	13295	13290	13320	13235	13310	13295	15	0	3940	26,191.76	50998
	20150325	13310	13295	13305	13320	13275	13320	13285	25	-10	2556	16,982.96	49752
	20150326	13320	13285	13285	13325	13265	13320	13300	35	15	3822	25,417.66	47936
	20150327	13320	13300	13340	13370	13320	13355	13345	55	45	4906	32,739.28	45990
	20150330	13355	13345	13340	13360	13325	13330	13335	-15	-10	7068	47,139.09	41954
	20150331	13330	13335	12840	13420	12840	13300	13385	-35	50	7680	51,407.13	39242
	20150401	13300	13385	13340	13395	13340	13380	13380	-5	-5	2632	17,609.23	38310
	20150402	13380	13380	13385	13395	13385	13390	13390	10	10	2530	16,940.23	38110
	20150403	13390	13390	13375	13395	13375	13390	13385	0	-5	1610	10,777.70	37270
	20150407	13390	13385	13400	13435	13395	13400	13400	15	15	3830	25,664.85	36680
	20150408	13400	13400	13390	13400	13365	13370	13385	-30	-15	2880	19,275.70	36460
	20150409	13370	13385	13340	13340	13070	13225	13185	-160	-200	6490	42,799.00	35240
	20150410	13225	13185	13200	13275	13190	13250	13225	65	40	5580	36,907.75	31970
	20150413	13250	13225	13320	13320	13000	13080	13165	-145	-60	5820	38,313.38	27380
	20150414	13080	13165	13095	13165	12960	13020	13025	-145	-140	4490	29,250.95	25050
	20150415	13020	13025	12890	13085	12890	13085	13035	60	10	4240	27,636.70	22180
al1505	20150105	13230	13245	13060	13140	13005	13045	13050	-200	-195	10872	70,961.71	27294
	20150106	13045	13050	13000	13000	12900	12975	12950	-75	-100	13998	90,670.04	33784
	20150107	12975	12950	12910	12970	12900	12900	12920	-50	-30	7468	48,244.43	36536
	20150108	12900	12920	12940	12970	12880	12925	12930	5	10	6156	39,812.26	38006
	20150109	12925	12930	12950	13005	12900	12970	12965	40	35	7792	50,517.08	40370
	20150112	12970	12965	12965	12965	12870	12870	12915	-95	-50	6412	41,416.39	42762
	20150113	12870	12915	12835	12860	12785	12840	12820	-75	-95	9098	58,322.00	46488
	20150114	12840	12820	12780	12865	12580	12745	12725	-75	-95	15684	99,797.02	52028
	20150115	12745	12725	12815	13105	12800	12965	12895	240	170	12486	80,525.03	54592
	20150116	12965	12895	13015	13020	12895	12930	12940	35	45	12426	80,396.99	57460
	20150119	12930	12940	12960	13060	12955	12985	12990	45	50	9632	62,565.68	58586
	20150120	12985	12990	12965	12965	12890	12910	12935	-80	-55	7668	49,596.51	58898
	20150121	12910	12935	12950	12970	12860	12890	12905	-45	-30	8940	57,696.24	61206
	20150122	12890	12905	12890	12970	12865	12940	12935	35	30	9746	63,048.77	64088
	20150123	12940	12935	12960	12980	12915	12925	12935	-10	0	11128	71,983.10	67690
	20150126	12925	12935	12870	12915	12830	12870	12875	-65	-60	15288	98,422.71	70346
	20150127	12870	12875	12850	13020	12850	12955	12945	80	70	19062	123,396.26	74036
	20150128	12955	12945	12970	12970	12870	12920	12915	-25	-30	11336	73,205.66	76366
	20150129	12920	12915	12915	12935	12880	12900	12900	-15	-15	6770	43,680.21	77998
	20150130	12900	12900	12900	12905	12835	12860	12860	-40	-40	13406	86,231.67	83798
	20150202	12860	12860	12915	12970	12895	12945	12925	85	65	13624	88,068.33	86336
	20150203	12945	12925	12945	13250	12945	13225	13085	300	160	28112	183,977.07	87360
	20150204	13225	13085	13275	13300	13165	13285	13240	200	155	23392	154,866.29	84764
	20150205	13285	13240	13280	13415	13235	13295	13315	55	75	36568	243,457.23	85494
	20150206	13295	13315	13275	13420	13240	13405	13365	90	50	21998	147,011.11	89162
	20150209	13405	13365	13395	13400	13270	13290	13325	-75	-40	13160	87,680.31	88252
	20150210	13290	13325	13290	13305	13180	13200	13230	-125	-95	17710	117,174.57	90114
	20150211	13200	13230	13190	13210	13065	13070	13120	-160	-110	19850	130,230.58	94602
	20150212	13070	13120	13080	13085	13005	13025	13030	-95	-90	18174	118,436.98	96188
	20150213	13025	13030	13070	13150	13045	13115	13100	85	70	17462	114,413.20	98308
	20150216	13115	13100	13115	13165	13070	13100	13100	0	0	11524	75,489.75	98540
	20150217	13100	13100	13085	13125	13030	13095	13075	-5	-25	9794	64,044.79	99158
	20150225	13095	13075	13100	13165	13005	13020	13050	-55	-25	13210	86,197.64	103128
	20150226	13020	13050	13000	13045	12955	13025	12995	-25	-55	27288	177,352.70	111168
	20150227	13025	12995	13045	13055	12965	12965	13000	-30	5	26980	175,379.54	119332
	20150302	12965	13000	12960	13100	12955	13095	13030	95	30	45394	295,836.91	124192
	20150303	13095	13030	13080	13085	13005	13020	13040	-10	10	36124	235,566.10	124222
	20150304	13020	13040	13000	13020	12925	12970	12960	-70	-80	43946	284,876.43	124584
	20150305	12970	12960	12970	13020	12940	12975	12965	15	5	27402	177,695.70	121018
	20150306	12975	12965	12985	13020	12940	12940	12965	-25	0	19934	129,270.46	121236
	20150309	12940	12965	12950	12965	12880	12940	12920	-25	-45	33936	219,280.02	126206
	20150310	12940	12920	12925	12995	12890	12915	12935	-5	15	31078	201,058.09	123238
	20150311	12915	12935	12880	12925	12865	12900	12900	-35	-35	25678	165,661.97	123242
	20150312	12900	12900	12920	13290	12890	13120	13005	220	105	58044	377,442.63	116542
	20150313	13120	13005	13100	13200	13045	13110	13130	105	125	54878	360,318.03	110196
	20150316	13110	13130	13095	13150	13065	13100	13105	-30	-25	35454	232,374.17	109868
	20150317	13100	13105	13080	13130	13070	13090	13100	-15	-5	31158	204,151.33	113148
	20150318	13090	13100	13080	13160	13060	13140	13130	40	30	29222	191,865.72	110184
	20150319	13140	13130	13130	13340	13105	13290	13235	160	105	59452	393,507.20	109150
	20150320	13290	13235	13300	13400	13250	13265	13315	30	80	46606	310,347.08	104086
	20150323	13265	13315	13295	13360	13235	13280	13295	-35	-20	33886	225,319.51	100234
	20150324	13280	13295	13310	13335	13260	13310	13300	15	5	19526	129,855.95	93602
	20150325	13310	13300	13315	13335	13270	13300	13285	0	-15	11570	76,878.23	91374
	20150326	13300	13285	13270	13330	13250	13320	13290	35	5	10674	70,929.80	90536
	20150327	13320	13290	13290	13385	13290	13345	13330	55	40	12626	84,172.03	86048
	20150330	13345	13330	13325	13345	13300	13345	13325	15	-5	9372	62,456.82	83598
	20150331	13345	13325	13335	13425	13320	13375	13385	50	60	22828	152,795.74	77528
	20150401	13375	13385	13375	13410	13345	13380	13385	-5	0	7874	52,697.50	74472
	20150402	13380	13385	13370	13410	13350	13385	13385	0	0	7254	48,557.54	71644
	20150403	13385	13385	13385	13400	13375	13395	13385	10	0	4484	30,015.28	70516
	20150407	13395	13385	13395	13455	13395	13420	13420	35	35	4346	29,168.01	68654
	20150408	13420	13420	13440	13445	13385	13390	13395	-30	-25	4826	32,331.84	66862
	20150409	13390	13395	13350	13375	13070	13270	13220	-125	-175	13766	91,001.40	64606
	20150410	13270	13220	13240	13285	13210	13260	13240	40	20	5016	33,215.08	63852
	20150413	13260	13240	13250	13265	13100	13105	13160	-135	-80	7846	51,636.28	62186
	20150414	13105	13160	13145	13145	13005	13040	13055	-120	-105	11366	74,218.86	58468
	20150415	13040	13055	13050	13100	13005	13040	13055	-15	0	5352	34,947.88	57452
	20150416	13040	13055	13065	13170	13050	13135	13120	80	65	5126	33,630.39	56098
	20150417	13135	13120	13195	13245	13160	13195	13205	75	85	6832	45,114.88	54040
	20150420	13195	13205	13160	13205	13070	13125	13115	-80	-90	5488	35,996.70	53678
	20150421	13125	13115	13105	13125	13070	13095	13085	-20	-30	2590	16,949.05	53274
	20150422	13095	13085	13025	13150	13025	13150	13110	65	25	3450	22,620.22	52590
	20150423	13150	13110	13120	13225	13105	13215	13180	105	70	7744	51,034.79	49268
	20150424	13215	13180	13215	13225	13165	13220	13205	40	25	2510	16,574.24	48050
	20150427	13220	13205	13250	13350	13240	13325	13305	120	100	12798	85,168.37	44092
	20150428	13325	13305	13335	13370	13250	13280	13300	-25	-5	5692	37,863.80	41306
	20150429	13280	13300	13360	13370	13250	13260	13300	-40	0	6280	41,769.10	39488
	20150430	13260	13300	13265	13320	13260	13280	13285	-20	-15	5790	38,466.84	36928
al1506	20150105	13320	13325	13295	13295	13070	13100	13110	-225	-215	1594	10,450.82	4830
	20150106	13100	13110	13040	13060	13000	13050	13020	-60	-90	2048	13,337.26	6230
	20150107	13050	13020	13000	13030	12965	12970	12980	-50	-40	2818	18,294.54	7366
	20150108	12970	12980	12990	13035	12955	13000	12990	20	10	1014	6,586.57	7638
	20150109	13000	12990	13010	13065	12970	13040	13025	50	35	1438	9,368.00	8058
	20150112	13040	13025	13015	13020	12935	12950	12960	-75	-65	952	6,171.20	8682
	20150113	12950	12960	12875	12915	12855	12890	12880	-70	-80	5178	33,348.37	12238
	20150114	12890	12880	12860	12930	12680	12805	12795	-75	-85	7874	50,375.06	16802
	20150115	12805	12795	12880	13140	12880	13030	12950	235	155	4388	28,415.79	17202
	20150116	13030	12950	13050	13080	12965	13000	13005	50	55	3816	24,813.92	17700
	20150119	13000	13005	13030	13120	13025	13055	13050	50	45	3080	20,100.01	19236
	20150120	13055	13050	13000	13025	12950	12965	12995	-85	-55	3002	19,505.72	20474
	20150121	12965	12995	12980	13025	12930	12970	12975	-25	-20	2942	19,088.90	22218
	20150122	12970	12975	12920	13025	12920	13005	12990	30	15	3090	20,076.24	23174
	20150123	13005	12990	13020	13050	12975	12990	13000	0	10	2922	18,996.23	23990
	20150126	12990	13000	12960	12975	12890	12950	12935	-50	-65	2950	19,080.29	25188
	20150127	12950	12935	12955	13065	12950	13015	13000	80	65	5082	33,044.54	26688
	20150128	13015	13000	12970	13005	12955	12985	12970	-15	-30	3362	21,810.43	27610
	20150129	12985	12970	12985	12985	12940	12955	12960	-15	-10	1222	7,918.64	28140
	20150130	12955	12960	12945	12950	12900	12915	12915	-45	-45	3172	20,488.39	29246
	20150202	12915	12915	12960	13020	12955	12990	12985	75	70	3182	20,663.06	29786
	20150203	12990	12985	13015	13265	12995	13265	13140	280	155	8074	53,055.33	31180
	20150204	13265	13140	13265	13360	13215	13360	13290	220	150	4956	32,932.95	30894
	20150205	13360	13290	13340	13465	13285	13340	13350	50	60	6718	44,858.70	31572
	20150206	13340	13350	13305	13465	13290	13450	13405	100	55	4770	31,982.23	32368
	20150209	13450	13405	13475	13475	13315	13370	13355	-35	-50	3290	21,969.21	33736
	20150210	13370	13355	13355	13355	13230	13245	13275	-110	-80	4528	30,061.85	33572
	20150211	13245	13275	13240	13250	13120	13120	13160	-155	-115	4562	30,025.85	34988
	20150212	13120	13160	13135	13135	13045	13060	13065	-100	-95	5682	37,129.38	37888
	20150213	13060	13065	13070	13180	13070	13125	13140	60	75	4646	30,534.31	38692
	20150216	13125	13140	13125	13190	13110	13130	13130	-10	-10	5184	34,043.64	40096
	20150217	13130	13130	13115	13155	13065	13140	13105	10	-25	4174	27,355.35	41080
	20150225	13140	13105	13115	13145	13040	13060	13070	-45	-35	4746	31,017.83	41056
	20150226	13060	13070	13020	13080	12990	13075	13030	5	-40	6108	39,800.87	42396
	20150227	13075	13030	13120	13120	13010	13020	13045	-10	15	9114	59,452.16	46458
	20150302	13020	13045	13020	13145	13000	13145	13090	100	45	12498	81,815.63	50278
	20150303	13145	13090	13120	13130	13070	13075	13085	-15	-5	9338	61,117.03	54378
	20150304	13075	13085	13050	13065	12980	13020	13020	-65	-65	12756	83,043.48	59552
	20150305	13020	13020	13050	13070	13000	13030	13015	10	-5	14794	96,286.38	61708
	20150306	13030	13015	13040	13070	12990	13005	13020	-10	5	9444	61,495.01	61548
	20150309	13005	13020	13005	13010	12940	12995	12975	-25	-45	16696	108,323.06	66714
	20150310	12995	12975	12980	13040	12940	12965	12985	-10	10	17690	114,886.14	68716
	20150311	12965	12985	12930	12975	12925	12940	12950	-45	-35	11510	74,542.59	70116
	20150312	12940	12950	12940	13290	12935	13195	13050	245	100	30972	202,101.62	76592
	20150313	13195	13050	13175	13230	13080	13145	13160	95	110	30270	199,222.72	77974
	20150316	13145	13160	13145	13180	13090	13120	13125	-40	-35	21196	139,138.52	82132
	20150317	13120	13125	13090	13150	13090	13095	13115	-30	-10	12958	85,004.29	84370
	20150318	13095	13115	13085	13180	13080	13160	13150	45	35	20300	133,507.80	88450
	20150319	13160	13150	13145	13360	13130	13315	13270	165	120	50440	334,685.13	101974
	20150320	13315	13270	13350	13400	13255	13265	13325	-5	55	54718	364,564.80	110252
	20150323	13265	13325	13285	13365	13230	13295	13300	-30	-25	52396	348,498.64	117938
	20150324	13295	13300	13300	13345	13270	13315	13305	15	5	35658	237,248.21	120410
	20150325	13315	13305	13325	13350	13270	13315	13290	10	-15	24568	163,269.70	123150
	20150326	13315	13290	13300	13325	13250	13300	13280	10	-10	31306	207,917.83	122146
	20150327	13300	13280	13380	13380	13300	13330	13325	50	45	29912	199,298.05	120896
	20150330	13330	13325	13300	13340	13285	13310	13315	-15	-10	26856	178,843.55	120146
	20150331	13310	13315	13315	13420	13310	13370	13375	55	60	58312	390,030.84	126646
	20150401	13370	13375	13360	13405	13330	13370	13370	-5	-5	25522	170,655.96	125400
	20150402	13370	13370	13350	13400	13330	13370	13370	0	0	27312	182,642.33	128402
	20150403	13370	13370	13365	13385	13355	13375	13365	5	-5	17410	116,379.52	125408
	20150407	13375	13365	13380	13445	13365	13410	13405	45	40	16288	109,189.87	125520
	20150408	13410	13405	13405	13435	13370	13385	13390	-20	-15	18402	123,211.87	123756
	20150409	13385	13390	13315	13365	13050	13255	13200	-135	-190	97334	642,553.86	120416
	20150410	13255	13200	13245	13275	13180	13265	13230	65	30	31024	205,238.64	114990
	20150413	13265	13230	13250	13265	13100	13105	13160	-125	-70	41976	276,265.92	117146
	20150414	13105	13160	13155	13155	13000	13020	13050	-140	-110	67982	443,708.54	119072
	20150415	13020	13050	13040	13105	13005	13060	13060	10	10	27882	182,113.10	121674
	20150416	13060	13060	13060	13195	13050	13180	13120	120	60	31486	206,577.31	122168
	20150417	13180	13120	13235	13250	13160	13190	13210	70	90	36348	240,137.04	113880
	20150420	13190	13210	13205	13215	13075	13110	13125	-100	-85	31388	206,042.23	115256
	20150421	13110	13125	13100	13140	13065	13095	13090	-30	-35	14598	95,565.25	112870
	20150422	13095	13090	13090	13155	13020	13150	13110	60	20	18334	120,220.95	109822
	20150423	13150	13110	13130	13260	13100	13190	13170	80	60	34756	228,899.98	102142
	20150424	13190	13170	13160	13230	13160	13225	13205	55	35	25774	170,235.23	90400
	20150427	13225	13205	13250	13385	13250	13330	13330	125	125	33800	225,293.17	80216
	20150428	13330	13330	13375	13400	13275	13310	13320	-20	-10	18862	125,645.39	74436
	20150429	13310	13320	13380	13405	13280	13290	13340	-30	20	14306	95,424.48	72562
	20150430	13290	13340	13330	13355	13300	13325	13325	-15	-15	13294	88,592.09	70358
al1507	20150105	13395	13410	13360	13360	13175	13190	13220	-220	-190	266	1,758.49	694
	20150106	13190	13220	13100	13115	13045	13115	13095	-105	-125	128	838.12	778
	20150107	13115	13095	13075	13085	13035	13035	13050	-60	-45	248	1,618.43	806
	20150108	13035	13050	13055	13090	13030	13065	13060	15	10	184	1,201.95	896
	20150109	13065	13060	13070	13115	13030	13095	13080	35	20	418	2,734.20	1114
	20150112	13095	13080	13075	13075	12995	13000	13025	-80	-55	174	1,133.29	1214
	20150113	13000	13025	12900	12965	12900	12960	12950	-65	-75	126	815.91	1248
	20150114	12960	12950	12925	13010	12745	12860	12895	-90	-55	1358	8,757.27	1880
	20150115	12860	12895	13210	13210	12960	13100	13040	205	145	1362	8,881.97	2432
	20150116	13100	13040	13130	13130	13030	13055	13065	15	25	560	3,658.84	2404
	20150119	13055	13065	13085	13145	13075	13075	13110	10	45	260	1,704.74	2408
	20150120	13075	13110	13075	13075	13020	13020	13055	-90	-55	712	4,648.68	2632
	20150121	13020	13055	13060	13060	13000	13015	13025	-40	-30	124	807.79	2718
	20150122	13015	13025	12955	13070	12955	13065	13045	40	20	436	2,843.85	2782
	20150123	13065	13045	13450	13450	13020	13025	13120	-20	75	600	3,936.12	3022
	20150126	13025	13120	13025	13035	12955	12995	12995	-125	-125	312	2,027.91	3074
	20150127	12995	12995	13005	13100	13005	13050	13060	55	65	494	3,226.07	3106
	20150128	13050	13060	13000	13055	13000	13035	13025	-25	-35	152	990.23	3148
	20150129	13035	13025	13030	13030	12995	13020	13005	-5	-20	58	377.28	3114
	20150130	13020	13005	13000	13010	12950	12950	12985	-55	-20	436	2,831.75	3026
	20150202	12950	12985	13010	13070	13010	13050	13030	65	45	294	1,915.61	3056
	20150203	13050	13030	13080	13280	13075	13280	13170	250	140	444	2,924.60	3144
	20150204	13280	13170	13325	13365	13260	13365	13320	195	150	344	2,291.59	3164
	20150205	13365	13320	13340	13510	13340	13385	13390	65	70	686	4,592.77	3478
	20150206	13385	13390	13365	13505	13365	13500	13490	110	100	1030	6,949.29	3502
	20150209	13500	13490	13490	13490	13385	13385	13425	-105	-65	394	2,645.22	3668
	20150210	13385	13425	13370	13405	13285	13300	13320	-125	-105	1308	8,714.38	4358
	20150211	13300	13320	13700	13700	13175	13175	13210	-145	-110	1834	12,113.77	5442
	20150212	13175	13210	13165	13165	13100	13120	13120	-90	-90	1730	11,349.31	6442
	20150213	13120	13120	13350	13350	13140	13190	13195	70	75	1084	7,153.18	6800
	20150216	13190	13195	13215	13230	13165	13185	13185	-10	-10	934	6,158.80	7266
	20150217	13185	13185	13170	13205	13110	13180	13170	-5	-15	438	2,884.74	7456
	20150225	13180	13170	13190	13255	13080	13090	13120	-80	-50	1092	7,164.68	7900
	20150226	13090	13120	13005	13130	13005	13105	13070	-15	-50	1216	7,947.68	8230
	20150227	13105	13070	13130	13130	13055	13060	13080	-10	10	1898	12,416.30	9354
	20150302	13060	13080	13060	13195	13060	13195	13145	115	65	2916	19,166.26	10630
	20150303	13195	13145	13135	13175	13120	13120	13135	-25	-10	1452	9,537.13	11214
	20150304	13120	13135	13105	13105	13035	13070	13065	-65	-70	5532	36,150.65	14624
	20150305	13070	13065	13090	13110	13040	13070	13060	5	-5	3262	21,302.34	16554
	20150306	13070	13060	13085	13110	13035	13040	13060	-20	0	2078	13,570.02	17838
	20150309	13040	13060	13040	13045	12995	13030	13020	-30	-40	5618	36,574.21	19798
	20150310	13030	13020	13000	13075	12990	13010	13025	-10	5	4350	28,334.01	21138
	20150311	13010	13025	12980	13010	12980	12990	12995	-35	-30	4516	29,349.54	23702
	20150312	12990	12995	12995	13325	12980	13200	13060	205	65	7988	52,162.77	26474
	20150313	13200	13060	13200	13250	13110	13150	13180	90	120	5826	38,401.67	27148
	20150316	13150	13180	13145	13190	13120	13150	13145	-30	-35	4232	27,822.02	28704
	20150317	13150	13145	13145	13170	13115	13130	13135	-15	-10	4118	27,051.42	30096
	20150318	13130	13135	13130	13200	13120	13185	13170	50	35	6328	41,677.53	32248
	20150319	13185	13170	13180	13380	13160	13340	13260	170	90	12654	83,925.92	36668
	20150320	13340	13260	13375	13430	13270	13280	13350	20	90	19144	127,789.56	42902
	20150323	13280	13350	13280	13375	13250	13300	13305	-50	-45	12736	84,755.16	46498
	20150324	13300	13305	13330	13360	13285	13335	13320	30	15	13122	87,420.96	50608
	20150325	13335	13320	13330	13355	13290	13290	13305	-30	-15	6940	46,178.52	51876
	20150326	13290	13305	13295	13335	13260	13315	13295	10	-10	7376	49,033.10	53698
	20150327	13315	13295	13295	13365	13295	13335	13335	40	40	8104	54,035.32	55652
	20150330	13335	13335	13290	13345	13290	13325	13320	-10	-15	9950	66,291.52	58726
	20150331	13325	13320	13345	13425	13330	13365	13385	45	65	13376	89,531.42	62800
	20150401	13365	13385	13370	13405	13335	13380	13375	-5	-10	7224	48,328.48	64036
	20150402	13380	13375	13325	13410	13325	13375	13380	0	5	9904	66,264.26	63878
	20150403	13375	13380	13380	13385	13360	13380	13370	0	-10	7558	50,530.74	66294
	20150407	13380	13370	13440	13450	13380	13415	13415	45	45	8092	54,278.08	67136
	20150408	13415	13415	13425	13435	13375	13395	13390	-20	-25	9054	60,633.09	69510
	20150409	13395	13390	13370	13370	13085	13265	13215	-125	-175	47026	310,794.04	80932
	20150410	13265	13215	13275	13280	13200	13255	13235	40	20	18936	125,344.37	87264
	20150413	13255	13235	13260	13260	13105	13130	13170	-105	-65	26592	175,127.94	97086
	20150414	13130	13170	13160	13160	13020	13030	13065	-140	-105	38834	253,744.21	97766
	20150415	13030	13065	13030	13125	13030	13075	13080	10	15	20128	131,671.96	98050
	20150416	13075	13080	13075	13210	13070	13195	13135	115	55	29138	191,433.54	102440
	20150417	13195	13135	13230	13275	13185	13210	13225	75	90	27672	183,042.11	103624
	20150420	13210	13225	13200	13235	13095	13125	13150	-100	-75	27616	181,595.92	106792
	20150421	13125	13150	13100	13150	13090	13110	13105	-40	-45	17636	115,596.55	111556
	20150422	13110	13105	13100	13165	13040	13155	13125	50	20	25344	166,321.47	117800
	20150423	13155	13125	13130	13280	13105	13210	13185	85	60	58130	383,331.38	119028
	20150424	13210	13185	13180	13240	13170	13230	13210	45	25	28630	189,132.43	123644
	20150427	13230	13210	13275	13400	13265	13360	13335	150	125	70880	472,648.32	133392
	20150428	13360	13335	13360	13420	13280	13320	13345	-15	10	52922	353,171.90	137144
	20150429	13320	13345	13385	13420	13290	13305	13360	-40	15	66102	441,717.52	141968
	20150430	13305	13360	13340	13380	13315	13345	13350	-15	-10	47484	317,014.89	145898
al1508	20150105	13475	13475	13425	13425	13250	13250	13355	-225	-120	76	507.65	338
	20150106	13250	13355	13180	13185	13170	13175	13175	-180	-180	54	355.77	382
	20150107	13175	13175	13065	13150	13065	13105	13105	-70	-70	38	249.00	394
	20150108	13105	13105	13115	13115	13100	13115	13110	10	5	14	91.79	398
	20150109	13115	13110	13140	13150	13140	13150	13145	40	35	20	131.45	402
	20150112	13150	13145	13015	13120	12995	13095	13050	-50	-95	18	117.45	410
	20150113	13095	13050	13015	13015	13015	13015	13015	-35	-35	2	13.02	410
	20150114	13015	13015	13000	13050	12735	12945	13005	-70	-10	628	4,084.89	844
	20150115	12945	13005	13040	13170	13015	13170	13105	165	100	346	2,267.47	910
	20150116	13170	13105	13175	13190	13100	13105	13105	0	0	692	4,535.79	1214
	20150119	13105	13105	13155	13195	13150	13150	13155	45	50	22	144.73	1210
	20150120	13150	13155	13125	13130	13060	13070	13110	-85	-45	144	943.92	1286
	20150121	13070	13110	13110	13120	13050	13050	13070	-60	-40	118	771.25	1318
	20150122	13050	13070	13055	13110	13025	13110	13080	40	10	188	1,229.87	1324
	20150123	13110	13080	13085	13105	13080	13080	13085	0	5	62	405.66	1328
	20150126	13080	13085	13070	13070	13020	13025	13045	-60	-40	56	365.31	1364
	20150127	13025	13045	13080	13185	13080	13105	13105	60	60	76	498.04	1372
	20150128	13105	13105	13085	13105	13050	13090	13095	-15	-10	138	903.56	1394
	20150129	13090	13095	13055	13080	13055	13070	13065	-25	-30	14	91.46	1398
	20150130	13070	13065	13050	13050	13005	13020	13025	-45	-40	32	208.47	1410
	20150202	13020	13025	13075	13110	13060	13105	13085	80	60	72	471.20	1386
	20150203	13105	13085	13145	13305	13145	13305	13175	220	90	134	883.04	1454
	20150204	13305	13175	13390	13390	13285	13375	13350	200	175	74	493.97	1438
	20150205	13375	13350	13375	13520	13375	13400	13445	50	95	88	591.72	1428
	20150206	13400	13445	13400	13570	13400	13560	13505	115	60	188	1,269.62	1434
	20150209	13560	13505	13490	13490	13440	13450	13450	-55	-55	20	134.53	1438
	20150210	13450	13450	13435	13435	13385	13385	13395	-65	-55	78	522.56	1438
	20150211	13385	13395	13385	13385	13185	13185	13245	-210	-150	198	1,311.35	1374
	20150212	13185	13245	13215	13215	13150	13165	13175	-80	-70	40	263.57	1364
	20150213	13165	13175	13240	13250	13210	13250	13235	75	60	164	1,085.55	1426
	20150216	13250	13235	13275	13290	13230	13230	13240	-5	5	104	688.72	1462
	20150217	13230	13240	13230	13240	13190	13240	13225	0	-15	96	634.94	1520
	20150225	13240	13225	13245	13245	13145	13145	13175	-80	-50	70	461.21	1482
	20150226	13145	13175	13125	13180	13100	13165	13160	-10	-15	364	2,395.28	1778
	20150227	13165	13160	13195	13195	13125	13125	13150	-35	-10	76	499.72	1822
	20150302	13125	13150	13125	13250	13125	13250	13205	100	55	334	2,205.67	2012
	20150303	13250	13205	13210	13230	13175	13175	13195	-30	-10	354	2,335.75	2158
	20150304	13175	13195	13150	13160	13085	13120	13095	-75	-100	1322	8,657.48	2760
	20150305	13120	13095	13140	13150	13090	13110	13105	15	10	272	1,782.76	2832
	20150306	13110	13105	13130	13150	13085	13100	13110	-5	5	744	4,877.24	3284
	20150309	13100	13110	13050	13095	13045	13090	13070	-20	-40	706	4,615.22	3776
	20150310	13090	13070	13090	13105	13050	13050	13075	-20	5	834	5,452.57	4298
	20150311	13050	13075	13035	13060	13035	13050	13045	-25	-30	616	4,019.18	4786
	20150312	13050	13045	13050	13360	13020	13240	13125	195	80	1814	11,905.52	5958
	20150313	13240	13125	13200	13290	13160	13165	13225	40	100	680	4,496.71	6206
	20150316	13165	13225	13180	13225	13145	13150	13165	-75	-60	1596	10,509.09	6844
	20150317	13150	13165	13180	13180	13140	13140	13160	-25	-5	400	2,632.84	6832
	20150318	13140	13160	13140	13215	13140	13195	13195	35	35	1670	11,019.72	7814
	20150319	13195	13195	13210	13405	13195	13370	13335	175	140	4068	27,125.29	9722
	20150320	13370	13335	13355	13465	13295	13295	13370	-40	35	5044	33,727.88	13058
	20150323	13295	13370	13310	13385	13300	13315	13325	-55	-45	2416	16,098.00	13826
	20150324	13315	13325	13325	13370	13310	13350	13340	25	15	1820	12,142.74	13788
	20150325	13350	13340	13350	13360	13315	13345	13325	5	-15	480	3,198.31	13790
	20150326	13345	13325	13330	13355	13280	13330	13320	5	-5	1250	8,325.79	14468
	20150327	13330	13320	13355	13375	13330	13340	13355	20	35	2838	18,951.00	15318
	20150330	13340	13355	13315	13360	13305	13335	13340	-20	-15	1692	11,286.98	16046
	20150331	13335	13340	13350	13430	13350	13385	13390	45	50	2820	18,886.50	17442
	20150401	13385	13390	13350	13410	13350	13385	13380	-5	-10	1936	12,956.03	18028
	20150402	13385	13380	13375	13420	13360	13400	13385	20	5	626	4,189.89	18220
	20150403	13400	13385	13395	13395	13365	13380	13370	-5	-15	1784	11,928.93	19164
	20150407	13380	13370	13415	13440	13410	13425	13415	55	45	986	6,616.04	18826
	20150408	13425	13415	13440	13440	13380	13405	13400	-10	-15	1344	9,007.74	19312
	20150409	13405	13400	13350	13375	13130	13290	13250	-110	-150	9078	60,153.30	23948
	20150410	13290	13250	13275	13295	13215	13280	13245	30	-5	8166	54,095.29	27594
	20150413	13280	13245	13265	13270	13125	13150	13170	-95	-75	6192	40,785.16	30028
	20150414	13150	13170	13160	13165	13055	13075	13090	-95	-80	11980	78,429.34	33408
	20150415	13075	13090	13080	13150	13060	13090	13100	0	10	5488	35,959.77	34790
	20150416	13090	13100	13090	13225	13090	13225	13165	125	65	5856	38,552.22	36450
	20150417	13225	13165	13230	13290	13210	13230	13250	65	85	6400	42,408.59	37338
	20150420	13230	13250	13215	13260	13135	13160	13170	-90	-80	6602	43,487.47	39650
	20150421	13160	13170	13140	13175	13120	13130	13135	-40	-35	2460	16,160.15	40626
	20150422	13130	13135	13090	13190	13070	13185	13150	50	15	3394	22,320.89	41530
	20150423	13185	13150	13160	13270	13125	13220	13210	70	60	12684	83,793.68	44496
	20150424	13220	13210	13220	13255	13185	13235	13235	25	25	7808	51,670.52	48576
	20150427	13235	13235	13295	13420	13285	13380	13355	145	120	16244	108,484.77	55334
	20150428	13380	13355	13380	13435	13305	13330	13365	-25	10	9030	60,362.10	57124
	20150429	13330	13365	13400	13435	13310	13320	13375	-45	10	12624	84,450.52	56888
	20150430	13320	13375	13345	13400	13335	13380	13370	5	-5	13956	93,304.30	59568
al1509	20150105	13545	13545	13465	13465	13270	13275	13400	-270	-145	80	536.02	358
	20150106	13275	13400	13280	13280	13220	13240	13255	-160	-145	64	424.19	370
	20150107	13240	13255	13200	13210	13155	13210	13180	-45	-75	42	276.85	386
	20150108	13210	13180	13150	13170	13150	13170	13160	-10	-20	6	39.48	388
	20150109	13170	13160	13265	13265	13160	13200	13190	40	30	80	527.66	416
	20150112	13200	13190	13150	13150	13100	13100	13130	-90	-60	22	144.48	428
	20150113	13100	13130	13075	13075	12975	12975	13030	-155	-100	8	52.14	424
	20150114	12975	13030	13095	13095	13000	13000	13020	-30	-10	16	104.19	436
	20150115	13000	13020	13095	13225	13060	13225	13180	205	160	108	711.72	516
	20150116	13225	13180	13165	13190	13130	13190	13160	10	-20	134	881.96	558
	20150119	13190	13160	13205	13260	13200	13200	13225	40	65	34	224.91	550
	20150120	13200	13225	13170	13195	13130	13130	13175	-95	-50	86	566.64	608
	20150121	13130	13175	13130	13170	13100	13110	13120	-65	-55	124	813.61	644
	20150122	13110	13120	13120	13160	13115	13160	13150	40	30	54	355.06	634
	20150123	13160	13150	13170	13170	13140	13140	13140	-10	-10	48	315.45	672
	20150126	13140	13140	13095	13110	13095	13095	13095	-45	-45	8	52.40	670
	20150127	13095	13095	13125	13190	13125	13160	13165	65	70	44	289.71	650
	20150128	13160	13165	13120	13155	13120	13155	13135	-10	-30	36	236.47	660
	20150129	13155	13135	13125	13150	13125	13150	13135	15	0	10	65.68	656
	20150130	13150	13135	13140	13140	13060	13070	13080	-65	-55	264	1,726.87	734
	20150202	13070	13080	13110	13175	13110	13170	13145	90	65	20	131.45	736
	20150203	13170	13145	13175	13385	13175	13380	13285	235	140	76	504.93	746
	20150204	13380	13285	13400	13400	13400	13400	13400	115	115	2	13.40	746
	20150205	13400	13400	13420	13560	13420	13505	13530	105	130	48	324.83	768
	20150206	13505	13530	13450	13615	13445	13610	13525	80	-5	64	432.89	774
	20150209	13610	13525	13520	13540	13460	13490	13515	-35	-10	54	364.98	752
	20150210	13490	13515	13470	13470	13400	13400	13435	-115	-80	40	268.71	730
	20150211	13400	13435	13370	13375	13280	13280	13295	-155	-140	56	372.38	736
	20150212	13280	13295	13225	13255	13200	13200	13220	-95	-75	14	92.55	734
	20150213	13200	13220	13245	13320	13245	13320	13280	100	60	58	385.26	734
	20150216	13320	13280	13280	13310	13280	13300	13295	20	15	92	611.71	788
	20150217	13300	13295	13260	13280	13240	13275	13260	-20	-35	26	172.43	788
	20150225	13275	13260	13225	13250	13170	13170	13215	-90	-45	60	396.45	796
	20150226	13170	13215	13135	13220	13135	13210	13175	-5	-40	152	1,001.45	932
	20150227	13210	13175	13220	13250	13175	13180	13195	5	20	190	1,253.78	976
	20150302	13180	13195	13150	13265	13150	13260	13245	65	50	398	2,636.36	1248
	20150303	13260	13245	13285	13285	13220	13240	13245	-5	0	74	490.11	1230
	20150304	13240	13245	13200	13210	13150	13180	13170	-65	-75	96	632.34	1248
	20150305	13180	13170	13195	13205	13155	13155	13175	-15	5	148	975.15	1300
	20150306	13155	13175	13175	13180	13155	13155	13165	-20	-10	30	197.48	1310
	20150309	13155	13165	13110	13145	13100	13145	13130	-20	-35	260	1,707.23	1292
	20150310	13145	13130	13145	13175	13115	13115	13135	-15	5	116	761.90	1270
	20150311	13115	13135	13120	13140	13080	13095	13105	-40	-30	164	1,074.99	1298
	20150312	13095	13105	13125	13310	13095	13220	13125	115	20	382	2,507.05	1380
	20150313	13220	13125	13260	13315	13190	13240	13260	115	135	358	2,373.82	1442
	20150316	13240	13260	13215	13245	13185	13185	13210	-75	-50	466	3,078.90	1564
	20150317	13185	13210	13190	13220	13180	13180	13200	-30	-10	174	1,148.59	1562
	20150318	13180	13200	13170	13295	13165	13225	13240	25	40	582	3,852.93	1592
	20150319	13225	13240	13265	13400	13230	13400	13345	160	105	220	1,468.02	1608
	20150320	13400	13345	13510	13510	13320	13320	13410	-25	65	544	3,648.68	1628
	20150323	13320	13410	13285	13420	13285	13330	13350	-80	-60	1136	7,583.25	2080
	20150324	13330	13350	13330	13400	13330	13380	13355	30	5	818	5,462.30	2446
	20150325	13380	13355	13345	13350	13335	13350	13340	-5	-15	382	2,548.25	2504
	20150326	13350	13340	13340	13345	13310	13340	13330	0	-10	178	1,186.67	2534
	20150327	13340	13330	13370	13385	13345	13345	13365	15	35	882	5,894.27	2918
	20150330	13345	13365	13340	13365	13320	13355	13350	-10	-15	1590	10,616.62	4146
	20150331	13355	13350	13360	13445	13360	13380	13405	30	55	1648	11,048.06	5034
	20150401	13380	13405	13375	13425	13365	13400	13400	-5	-5	696	4,664.02	5360
	20150402	13400	13400	13370	13430	13370	13395	13400	-5	0	640	4,289.38	5674
	20150403	13395	13400	13405	13405	13370	13390	13390	-10	-10	610	4,084.22	5862
	20150407	13390	13390	13440	13445	13425	13435	13430	45	40	498	3,344.71	6038
	20150408	13435	13430	13430	13430	13390	13390	13400	-40	-30	1084	7,265.08	6668
	20150409	13390	13400	13375	13375	13150	13305	13280	-95	-120	2692	17,877.33	7702
	20150410	13305	13280	13250	13355	13235	13275	13260	-5	-20	606	4,018.86	7814
	20150413	13275	13260	13255	13285	13150	13170	13210	-90	-50	826	5,456.44	8022
	20150414	13170	13210	13190	13190	13075	13090	13105	-120	-105	2318	15,190.43	8692
	20150415	13090	13105	13125	13175	13095	13135	13120	30	15	1836	12,047.21	9524
	20150416	13135	13120	13145	13250	13145	13250	13185	130	65	1316	8,676.42	9694
	20150417	13250	13185	13280	13325	13240	13265	13275	80	90	856	5,683.26	9644
	20150420	13265	13275	13235	13280	13165	13190	13205	-85	-70	1104	7,291.57	9936
	20150421	13190	13205	13180	13195	13150	13180	13165	-25	-40	1560	10,269.15	10596
	20150422	13180	13165	13125	13215	13125	13200	13175	35	10	1732	11,411.20	11194
	20150423	13200	13175	13205	13275	13145	13235	13225	60	50	4270	28,245.25	13614
	20150424	13235	13225	13225	13275	13205	13250	13240	25	15	2146	14,210.09	15160
	20150427	13250	13240	13320	13425	13300	13400	13365	160	125	9696	64,806.66	20432
	20150428	13400	13365	13390	13440	13310	13345	13370	-20	5	5772	38,589.87	23250
	20150429	13345	13370	13485	13485	13320	13330	13385	-40	15	7066	47,300.55	25882
	20150430	13330	13385	13355	13410	13340	13380	13380	-5	-5	3326	22,251.66	26410
al1510	20150105	13600	13560	13400	13405	13390	13390	13395	-170	-165	86	576.19	314
	20150106	13390	13395				13390	13390	-5	-5	0	0.00	314
	20150107	13390	13390	13235	13235	13230	13230	13230	-160	-160	16	105.85	312
	20150108	13230	13230	13245	13245	13230	13240	13235	10	5	10	66.20	308
	20150109	13240	13235	13295	13295	13250	13290	13270	55	35	26	172.53	308
	20150112	13290	13270	13235	13235	13235	13235	13235	-35	-35	2	13.24	310
	20150113	13235	13235	13130	13150	13130	13145	13140	-90	-95	10	65.72	312
	20150114	13145	13140				13140	13140	0	0	0	0.00	312
	20150115	13140	13140	13190	13270	13175	13235	13200	95	60	30	198.00	318
	20150116	13235	13200	13240	13240	13240	13240	13240	40	40	2	13.24	316
	20150119	13240	13240	13280	13280	13280	13280	13280	40	40	2	13.28	318
	20150120	13280	13280	13270	13270	13200	13200	13255	-80	-25	70	463.96	370
	20150121	13200	13255	13225	13225	13155	13155	13205	-100	-50	10	66.04	370
	20150122	13155	13205	13185	13230	13185	13215	13210	10	5	16	105.69	376
	20150123	13215	13210	13215	13215	13215	13215	13215	5	5	10	66.08	366
	20150126	13215	13215	13185	13185	13150	13150	13180	-65	-35	26	171.37	368
	20150127	13150	13180	13185	13245	13185	13235	13235	55	55	52	344.18	378
	20150128	13235	13235	13225	13225	13195	13205	13215	-30	-20	10	66.08	380
	20150129	13205	13215	13205	13205	13195	13200	13200	-15	-15	6	39.60	380
	20150130	13200	13200	13165	13165	13100	13100	13105	-100	-95	118	773.30	430
	20150202	13100	13105	13155	13210	13155	13210	13190	105	85	100	659.66	512
	20150203	13210	13190	13200	13375	13200	13375	13260	185	70	20	132.63	522
	20150204	13375	13260	13465	13465	13430	13430	13445	170	185	8	53.79	522
	20150205	13430	13445	13480	13615	13480	13525	13555	80	110	22	149.11	506
	20150206	13525	13555	13555	13665	13555	13630	13625	75	70	20	136.25	512
	20150209	13630	13625	13595	13595	13550	13550	13570	-75	-55	8	54.28	510
	20150210	13550	13570	13505	13510	13445	13450	13460	-120	-110	62	417.28	474
	20150211	13450	13460	13375	13375	13340	13340	13345	-120	-115	12	80.10	480
	20150212	13340	13345	13285	13290	13240	13240	13260	-105	-85	40	265.22	482
	20150213	13240	13260	13265	13340	13265	13340	13315	80	55	84	559.32	518
	20150216	13340	13315	13345	13375	13320	13320	13345	5	30	82	547.31	574
	20150217	13320	13345	13340	13355	13340	13355	13340	10	-5	26	173.45	584
	20150225	13355	13340	13285	13285	13250	13250	13270	-90	-70	18	119.45	590
	20150226	13250	13270	13205	13285	13205	13250	13220	-20	-50	68	449.63	634
	20150227	13250	13220	13260	13320	13205	13235	13255	15	35	170	1,127.04	728
	20150302	13235	13255	13230	13370	13230	13370	13325	115	70	108	719.67	824
	20150303	13370	13325	13320	13345	13225	13290	13300	-35	-25	70	465.55	836
	20150304	13290	13300	13220	13235	13200	13235	13215	-65	-85	108	713.65	892
	20150305	13235	13215	13240	13240	13215	13240	13220	25	5	32	211.59	890
	20150306	13240	13220	13260	13260	13205	13205	13225	-15	5	18	119.07	894
	20150309	13205	13225	13180	13225	13135	13175	13180	-50	-45	128	843.53	836
	20150310	13175	13180	13185	13185	13185	13185	13185	5	5	2	13.19	834
	20150311	13185	13185	13115	13135	13115	13135	13130	-50	-55	82	538.52	754
	20150312	13135	13130	13185	13335	13185	13295	13275	165	145	20	132.75	752
	20150313	13295	13275	13290	13320	13270	13285	13300	10	25	176	1,170.67	816
	20150316	13285	13300	13245	13290	13245	13245	13265	-55	-35	70	464.32	816
	20150317	13245	13265	13265	13320	13220	13220	13265	-45	0	244	1,618.88	826
	20150318	13220	13265	13265	13290	13255	13275	13270	10	5	250	1,659.30	830
	20150319	13275	13270	13270	13425	13270	13425	13360	155	90	110	734.87	838
	20150320	13425	13360	13405	13520	13355	13355	13415	-5	55	216	1,449.21	844
	20150323	13355	13415	13360	13415	13335	13350	13350	-65	-65	238	1,588.79	930
	20150324	13350	13350	13350	13410	13350	13410	13405	60	55	534	3,579.24	1074
	20150325	13410	13405	13370	13385	13365	13380	13370	-25	-35	224	1,497.97	1064
	20150326	13380	13370	13355	13380	13340	13380	13365	10	-5	272	1,817.84	1128
	20150327	13380	13365	13375	13410	13375	13380	13385	15	20	44	294.48	1152
	20150330	13380	13385	13360	13395	13355	13390	13390	5	5	328	2,196.08	1366
	20150331	13390	13390	13390	13445	13390	13415	13425	25	35	116	778.75	1446
	20150401	13415	13425	13390	13445	13390	13435	13435	10	10	878	5,899.75	2196
	20150402	13435	13435	13420	13455	13415	13435	13445	0	10	114	766.37	2206
	20150403	13435	13445	13420	13445	13415	13435	13425	-10	-20	132	886.14	2286
	20150407	13435	13425	13475	13475	13445	13450	13450	25	25	48	322.89	2286
	20150408	13450	13450	13425	13465	13425	13465	13440	15	-10	6	40.32	2288
	20150409	13465	13440	13410	13410	13180	13340	13285	-100	-155	200	1,328.84	2298
	20150410	13340	13285	13310	13315	13270	13315	13280	30	-5	66	438.37	2300
	20150413	13315	13280	13280	13310	13195	13200	13235	-80	-45	166	1,098.75	2424
	20150414	13200	13235	13215	13215	13120	13160	13145	-75	-90	186	1,222.64	2452
	20150415	13160	13145	13145	13210	13140	13175	13160	30	15	152	1,000.17	2504
	20150416	13175	13160	13185	13260	13180	13240	13215	80	55	58	383.30	2488
	20150417	13240	13215	13290	13350	13290	13295	13315	80	100	148	985.48	2520
	20150420	13295	13315	13270	13315	13205	13215	13245	-100	-70	130	861.22	2526
	20150421	13215	13245	13230	13230	13190	13190	13200	-55	-45	488	3,221.88	2764
	20150422	13190	13200	13180	13250	13180	13240	13220	40	20	256	1,692.62	2834
	20150423	13240	13220	13210	13320	13190	13280	13255	60	35	270	1,789.50	2826
	20150424	13280	13255	13300	13310	13255	13285	13280	30	25	120	796.82	2840
	20150427	13285	13280	13330	13445	13330	13415	13390	135	110	1266	8,477.32	3114
	20150428	13415	13390	13440	13470	13340	13350	13375	-40	-15	1062	7,103.12	3510
	20150429	13350	13375	13440	13465	13335	13340	13375	-35	0	1152	7,706.09	4138
	20150430	13340	13375	13355	13420	13355	13395	13390	20	15	1246	8,342.54	4746
al1511	20150105	13690	13630	13555	13555	13445	13445	13470	-185	-160	26	175.17	152
	20150106	13445	13470	13400	13400	13400	13400	13400	-70	-70	22	147.40	160
	20150107	13400	13400	13330	13380	13330	13370	13360	-30	-40	40	267.24	178
	20150108	13370	13360				13360	13360	0	0	0	0.00	178
	20150109	13360	13360	13390	13390	13305	13375	13345	15	-15	16	106.79	174
	20150112	13375	13345	13310	13310	13310	13310	13310	-35	-35	2	13.31	176
	20150113	13310	13310	13180	13180	13180	13180	13180	-130	-130	10	65.90	180
	20150114	13180	13180	13110	13110	13105	13105	13105	-75	-75	4	26.22	178
	20150115	13105	13105	13220	13285	13195	13195	13220	90	115	28	185.09	176
	20150116	13195	13220	13375	13375	13295	13330	13310	110	90	14	93.19	166
	20150119	13330	13310	13295	13295	13295	13295	13295	-15	-15	10	66.48	174
	20150120	13295	13295	13290	13335	13290	13300	13315	5	20	72	479.45	184
	20150121	13300	13315				13265	13265	-50	-50	0	0.00	184
	20150122	13265	13265	13250	13280	13250	13280	13265	15	0	60	397.95	202
	20150123	13280	13265	13280	13280	13280	13280	13280	15	15	6	39.84	200
	20150126	13280	13280	13245	13245	13210	13210	13230	-70	-50	24	158.79	200
	20150127	13210	13230	13295	13300	13295	13300	13295	70	65	80	532.00	242
	20150128	13300	13295	13295	13295	13295	13295	13295	0	0	6	39.89	246
	20150129	13295	13295				13275	13275	-20	-20	0	0.00	246
	20150130	13275	13275	13225	13225	13130	13175	13170	-100	-105	28	184.40	264
	20150202	13175	13170	13180	13260	13180	13260	13195	90	25	84	554.35	280
	20150203	13260	13195	13295	13420	13275	13420	13340	225	145	26	173.43	276
	20150204	13420	13340	13515	13515	13375	13475	13460	135	120	70	471.12	306
	20150205	13475	13460	13520	13520	13520	13520	13520	60	60	2	13.52	304
	20150206	13520	13520	13660	13660	13660	13660	13660	140	140	2	13.66	306
	20150209	13660	13660	13575	13625	13565	13565	13580	-95	-80	20	135.85	310
	20150210	13565	13580	13530	13535	13465	13465	13515	-115	-65	20	135.20	306
	20150211	13465	13515	13420	13425	13350	13350	13385	-165	-130	12	80.32	306
	20150212	13350	13385	13315	13315	13290	13290	13300	-95	-85	4	26.61	308
	20150213	13290	13300	13370	13370	13370	13370	13370	70	70	32	213.92	328
	20150216	13370	13370	13425	13425	13385	13385	13405	15	35	38	254.72	344
	20150217	13385	13405	13370	13370	13325	13350	13345	-55	-60	34	226.93	368
	20150225	13350	13345	13395	13395	13320	13320	13345	-25	0	22	146.84	356
	20150226	13320	13345	13350	13350	13350	13350	13350	5	5	2	13.35	356
	20150227	13350	13350	13320	13330	13255	13265	13290	-85	-60	118	784.30	406
	20150302	13265	13290	13375	13390	13375	13390	13380	100	90	4	26.77	404
	20150303	13390	13380	13355	13355	13340	13340	13340	-40	-40	24	160.10	404
	20150304	13340	13340	13285	13285	13285	13285	13285	-55	-55	10	66.43	404
	20150305	13285	13285	13300	13300	13260	13265	13270	-20	-15	22	146.01	410
	20150306	13265	13270	13295	13295	13250	13250	13270	-20	0	4	26.55	412
	20150309	13250	13270	13245	13245	13235	13240	13235	-30	-35	32	211.83	408
	20150310	13240	13235				13235	13235	0	0	0	0.00	408
	20150311	13235	13235	13225	13225	13225	13225	13225	-10	-10	16	105.80	408
	20150312	13225	13225	13280	13435	13280	13435	13365	210	140	34	227.23	426
	20150313	13435	13365	13360	13415	13320	13345	13355	-20	-10	140	934.98	462
	20150316	13345	13355	13340	13340	13325	13335	13330	-20	-25	10	66.67	462
	20150317	13335	13330	13310	13310	13280	13280	13290	-50	-40	6	39.88	466
	20150318	13280	13290	13330	13335	13320	13320	13325	30	35	42	279.85	470
	20150319	13320	13325	13455	13455	13455	13455	13455	130	130	6	40.37	470
	20150320	13455	13455	13595	13595	13385	13385	13465	-70	10	312	2,100.80	570
	20150323	13385	13465	13435	13435	13410	13410	13410	-55	-55	48	321.94	564
	20150324	13410	13410	13415	13415	13410	13410	13410	0	0	20	134.13	574
	20150325	13410	13410	13400	13400	13400	13400	13400	-10	-10	4	26.80	574
	20150326	13400	13400	13430	13430	13430	13430	13430	30	30	2	13.43	576
	20150327	13430	13430				13430	13430	0	0	0	0.00	576
	20150330	13430	13430	13385	13400	13385	13400	13395	-30	-35	86	576.04	594
	20150331	13400	13395	13455	13455	13445	13445	13450	50	55	8	53.81	588
	20150401	13445	13450	13455	13455	13455	13455	13455	5	5	2	13.46	588
	20150402	13455	13455	13455	13455	13455	13455	13455	0	0	40	269.10	628
	20150403	13455	13455	13465	13470	13465	13470	13465	15	10	22	148.16	648
	20150407	13470	13465	13515	13515	13490	13490	13490	25	25	22	148.42	648
	20150408	13490	13490				13490	13490	0	0	0	0.00	648
	20150409	13490	13490	13390	13415	13210	13415	13300	-75	-190	78	518.82	650
	20150410	13415	13300	13340	13350	13295	13350	13310	50	10	30	199.72	652
	20150413	13350	13310	13330	13330	13220	13260	13250	-50	-60	36	238.58	670
	20150414	13260	13250	13215	13250	13175	13175	13190	-75	-60	28	184.67	690
	20150415	13175	13190	13250	13250	13185	13200	13200	10	10	152	1,003.20	716
	20150416	13200	13200	13265	13265	13260	13260	13260	60	60	44	291.77	710
	20150417	13260	13260	13400	13400	13320	13320	13365	60	105	6	40.10	710
	20150420	13320	13365	13315	13315	13240	13280	13270	-85	-95	28	185.84	710
	20150421	13280	13270	13220	13240	13215	13240	13215	-30	-55	44	290.79	714
	20150422	13240	13215	13270	13270	13270	13270	13270	55	55	4	26.54	714
	20150423	13270	13270	13230	13365	13230	13315	13270	45	0	12	79.64	716
	20150424	13315	13270	13285	13325	13285	13300	13300	30	30	22	146.32	728
	20150427	13300	13300	13400	13465	13395	13445	13425	145	125	284	1,906.87	880
	20150428	13445	13425	13475	13480	13350	13405	13400	-20	-25	54	361.80	874
	20150429	13405	13400	13465	13465	13370	13375	13420	-25	20	232	1,556.86	886
	20150430	13375	13420	13415	13440	13405	13420	13420	0	0	32	214.80	882
al1512	20150105	13755	13685				13565	13565	-120	-120	0	0.00	32
	20150106	13565	13565				13565	13565	0	0	0	0.00	32
	20150107	13565	13565	13400	13400	13400	13400	13400	-165	-165	2	13.40	32
	20150108	13400	13400	13440	13440	13390	13390	13405	-10	5	6	40.23	28
	20150109	13390	13405	13420	13420	13415	13420	13415	15	10	6	40.26	26
	20150112	13420	13415				13360	13360	-55	-55	0	0.00	26
	20150113	13360	13360	13280	13300	13280	13300	13290	-60	-70	6	39.88	20
	20150114	13300	13290	13295	13295	12955	13140	13190	-150	-100	24	158.28	32
	20150115	13140	13190	13290	13320	13205	13310	13280	120	90	62	411.80	62
	20150116	13310	13280	13350	13410	13325	13325	13340	45	60	28	186.76	78
	20150119	13325	13340	13395	13470	13330	13330	13355	-10	15	40	267.12	102
	20150120	13330	13355	13315	13380	13280	13280	13335	-75	-20	102	680.27	188
	20150121	13280	13335	13325	13325	13265	13265	13300	-70	-35	32	212.87	196
	20150122	13265	13300	13305	13330	13305	13330	13315	30	15	12	79.91	198
	20150123	13330	13315	13325	13325	13310	13310	13315	-5	0	16	106.56	206
	20150126	13310	13315	13285	13285	13130	13130	13235	-185	-80	30	198.57	228
	20150127	13130	13235	13305	13340	13305	13335	13325	100	90	54	359.78	246
	20150128	13335	13325	13310	13310	13290	13310	13305	-15	-20	20	133.06	260
	20150129	13310	13305	13290	13300	13290	13300	13295	-5	-10	18	119.66	262
	20150130	13300	13295	13250	13300	13250	13250	13295	-45	0	86	571.75	348
	20150202	13250	13295	13310	13325	13310	13325	13320	30	25	92	612.92	390
	20150203	13325	13320	13310	13525	13310	13525	13405	205	85	12	80.45	392
	20150204	13525	13405	13555	13620	13465	13535	13535	130	130	12	81.24	394
	20150205	13535	13535	13675	13690	13600	13600	13615	65	80	50	340.44	434
	20150206	13600	13615	13600	13700	13600	13700	13650	85	35	22	150.16	456
	20150209	13700	13650	13655	13655	13580	13580	13615	-70	-35	46	313.18	460
	20150210	13580	13615	13560	13560	13535	13535	13540	-80	-75	8	54.18	464
	20150211	13535	13540	13445	13455	13385	13385	13425	-155	-115	10	67.13	468
	20150212	13385	13425	13360	13360	13325	13340	13355	-85	-70	40	267.13	506
	20150213	13340	13355	13285	13425	13285	13425	13385	70	30	14	93.70	510
	20150216	13425	13385	13450	13450	13405	13430	13435	45	50	28	188.14	502
	20150217	13430	13435	13400	13440	13400	13440	13425	5	-10	18	120.86	508
	20150225	13440	13425	13380	13380	13380	13380	13380	-45	-45	6	40.14	502
	20150226	13380	13380	13290	13320	13290	13315	13310	-65	-70	18	119.81	496
	20150227	13315	13310	13335	13335	13305	13305	13320	-5	10	82	546.26	484
	20150302	13305	13320	13355	13360	13355	13360	13355	40	35	26	173.67	510
	20150303	13360	13355	13385	13390	13355	13355	13380	0	25	16	107.05	512
	20150304	13355	13380	13335	13335	13335	13335	13335	-45	-45	4	26.67	512
	20150305	13335	13335	13310	13320	13310	13320	13315	-15	-20	12	79.89	506
	20150306	13320	13315	13375	13375	13335	13335	13360	20	45	16	106.90	500
	20150309	13335	13360	13290	13320	13275	13320	13290	-40	-70	54	358.92	478
	20150310	13320	13290	13280	13290	13280	13290	13280	0	-10	22	146.09	476
	20150311	13290	13280	13170	13275	13170	13275	13210	-5	-70	32	211.43	478
	20150312	13275	13210	13270	13270	13260	13260	13265	50	55	4	26.53	478
	20150313	13260	13265	13400	13450	13385	13385	13400	120	135	48	321.64	484
	20150316	13385	13400	13370	13380	13320	13320	13340	-80	-60	66	440.33	460
	20150317	13320	13340	13340	13340	13305	13305	13305	-35	-35	26	173.00	460
	20150318	13305	13305	13300	13425	13300	13370	13355	65	50	130	868.37	460
	20150319	13370	13355	13370	13485	13350	13455	13425	100	70	48	322.22	492
	20150320	13455	13425	13600	13600	13435	13435	13475	10	50	230	1,550.17	554
	20150323	13435	13475	13455	13460	13425	13425	13445	-50	-30	118	793.51	544
	20150324	13425	13445	13500	13515	13445	13515	13475	70	30	8	53.92	544
	20150325	13515	13475	13450	13450	13450	13450	13450	-25	-25	12	80.70	546
	20150326	13450	13450	13465	13485	13440	13450	13450	0	0	34	228.65	556
	20150327	13450	13450	13495	13495	13465	13465	13475	15	25	6	40.44	560
	20150330	13465	13475	13410	13440	13410	13440	13430	-35	-45	16	107.46	570
	20150331	13440	13430	13460	13460	13460	13460	13460	30	30	2	13.46	570
	20150401	13460	13460	13415	13485	13415	13485	13460	25	0	14	94.23	574
	20150402	13485	13460	13495	13495	13495	13495	13495	35	35	2	13.50	572
	20150403	13495	13495	13510	13510	13510	13510	13510	15	15	22	148.61	586
	20150407	13510	13510	13540	13545	13520	13520	13535	10	25	18	121.86	598
	20150408	13520	13535				13535	13535	0	0	0	0.00	598
	20150409	13535	13535	13365	13370	13230	13370	13305	-165	-230	84	558.93	580
	20150410	13370	13305				13305	13305	0	0	0	0.00	580
	20150413	13305	13305	13315	13360	13315	13325	13330	20	25	24	159.96	580
	20150414	13325	13330	13240	13240	13190	13190	13205	-140	-125	58	382.97	584
	20150415	13190	13205	13240	13240	13240	13240	13240	35	35	42	278.04	582
	20150416	13240	13240	13285	13285	13285	13285	13285	45	45	20	132.85	582
	20150417	13285	13285	13400	13400	13400	13400	13400	115	115	2	13.40	580
	20150420	13400	13400	13355	13355	13285	13320	13310	-80	-90	8	53.26	588
	20150421	13320	13310				13310	13310	0	0	0	0.00	588
	20150422	13310	13310				13310	13310	0	0	0	0.00	588
	20150423	13310	13310	13290	13600	13290	13380	13380	70	70	50	334.52	596
	20150424	13380	13380	13360	13380	13290	13290	13360	-90	-20	34	227.20	604
	20150427	13290	13360	13455	13510	13430	13510	13455	150	95	142	955.52	634
	20150428	13510	13455	13495	13495	13475	13475	13490	20	35	12	80.95	634
	20150429	13475	13490	13500	13505	13430	13430	13485	-60	-5	68	458.64	624
	20150430	13430	13485	13460	13460	13425	13425	13440	-60	-45	14	94.09	622
al1601	20150116	13280	13280				13340	13340	60	60	0	0.00	0
	20150119	13340	13340				13340	13340	0	0	0	0.00	0
	20150120	13340	13340				13340	13340	0	0	0	0.00	0
	20150121	13340	13340	13325	13325	13315	13315	13315	-25	-25	8	53.27	8
	20150122	13315	13315				13355	13355	40	40	0	0.00	8
	20150123	13355	13355				13355	13355	0	0	0	0.00	8
	20150126	13355	13355	13300	13300	13300	13300	13300	-55	-55	2	13.30	8
	20150127	13300	13300				13300	13300	0	0	0	0.00	8
	20150128	13300	13300				13300	13300	0	0	0	0.00	8
	20150129	13300	13300				13290	13290	-10	-10	0	0.00	8
	20150130	13290	13290				13290	13290	0	0	0	0.00	8
	20150202	13290	13290				13290	13290	0	0	0	0.00	8
	20150203	13290	13290	13530	13530	13530	13530	13530	240	240	4	27.06	12
	20150204	13530	13530	13615	13645	13360	13635	13595	105	65	42	285.50	22
	20150205	13635	13595	13635	13710	13635	13660	13680	65	85	98	670.53	78
	20150206	13660	13680	13715	13795	13705	13720	13730	40	50	106	727.91	164
	20150209	13720	13730	13665	13665	13605	13610	13625	-120	-105	148	1,008.49	248
	20150210	13610	13625	13580	13580	13550	13555	13550	-70	-75	36	243.99	248
	20150211	13555	13550	13505	13510	13450	13450	13485	-100	-65	28	188.83	238
	20150212	13450	13485	13385	13385	13355	13355	13365	-130	-120	12	80.21	250
	20150213	13355	13365	13400	13475	13400	13460	13455	95	90	90	605.57	256
	20150216	13460	13455	13455	13475	13450	13475	13455	20	0	30	201.84	264
	20150217	13475	13455	13465	13510	13455	13510	13485	55	30	22	148.34	268
	20150225	13510	13485				13485	13485	0	0	0	0.00	268
	20150226	13485	13485	13360	13360	13360	13360	13360	-125	-125	6	40.08	264
	20150227	13360	13360	13370	13370	13370	13370	13370	10	10	2	13.37	262
	20150302	13370	13370	13410	13440	13410	13440	13425	70	55	4	26.85	262
	20150303	13440	13425				13425	13425	0	0	0	0.00	262
	20150304	13425	13425				13375	13375	-50	-50	0	0.00	262
	20150305	13375	13375	13355	13355	13355	13355	13355	-20	-20	4	26.71	264
	20150306	13355	13355				13400	13400	45	45	0	0.00	264
	20150309	13400	13400	13330	13335	13330	13335	13330	-65	-70	28	186.63	242
	20150310	13335	13330				13330	13330	0	0	0	0.00	242
	20150311	13330	13330	13300	13300	13300	13300	13300	-30	-30	2	13.30	242
	20150312	13300	13300	13300	13565	13300	13465	13515	165	215	24	162.22	248
	20150313	13465	13515	13455	13500	13430	13430	13465	-85	-50	58	390.50	250
	20150316	13430	13465	13425	13425	13420	13420	13420	-45	-45	6	40.27	256
	20150317	13420	13420	13400	13400	13380	13390	13390	-30	-30	12	80.36	258
	20150318	13390	13390	13420	13420	13420	13420	13420	30	30	8	53.68	258
	20150319	13420	13420	13505	13560	13465	13560	13485	140	65	16	107.90	258
	20150320	13560	13485	13580	13580	13525	13525	13555	40	70	10	67.79	260
	20150323	13525	13555	13530	13530	13500	13500	13500	-55	-55	82	553.53	262
	20150324	13500	13500	13545	13550	13530	13530	13535	30	35	38	257.17	254
	20150325	13530	13535	13530	13530	13480	13480	13505	-55	-30	4	27.01	254
	20150326	13480	13505				13505	13505	0	0	0	0.00	254
	20150327	13505	13505	13485	13485	13485	13485	13485	-20	-20	30	202.28	280
	20150330	13485	13485	13430	13430	13430	13430	13430	-55	-55	2	13.43	280
	20150331	13430	13430	13510	13510	13510	13510	13510	80	80	8	54.04	288
	20150401	13510	13510	13500	13505	13450	13505	13495	-5	-15	18	121.49	288
	20150402	13505	13495				13495	13495	0	0	0	0.00	288
	20150403	13495	13495	13530	13530	13530	13530	13530	35	35	2	13.53	288
	20150407	13530	13530				13530	13530	0	0	0	0.00	288
	20150408	13530	13530				13530	13530	0	0	0	0.00	288
	20150409	13530	13530	13390	13485	13320	13445	13405	-85	-125	38	254.75	272
	20150410	13445	13405				13405	13405	0	0	0	0.00	272
	20150413	13405	13405	13370	13415	13305	13305	13355	-100	-50	12	80.15	262
	20150414	13305	13355	13300	13300	13230	13230	13245	-125	-110	8	52.99	264
	20150415	13230	13245				13245	13245	0	0	0	0.00	264
	20150416	13245	13245	13335	13340	13335	13340	13335	95	90	18	120.03	278
	20150417	13340	13335	13420	13420	13420	13420	13420	85	85	2	13.42	278
	20150420	13420	13420	13355	13355	13305	13305	13330	-115	-90	6	40.00	278
	20150421	13305	13330	13330	13345	13255	13315	13320	-15	-10	24	159.86	290
	20150422	13315	13320	13350	13350	13305	13305	13325	-15	5	40	266.55	304
	20150423	13305	13325	13320	13320	13320	13320	13320	-5	-5	2	13.32	302
	20150424	13320	13320	13465	13465	13465	13465	13465	145	145	2	13.47	304
	20150427	13465	13465	13595	13595	13470	13545	13510	80	45	18	121.61	310
	20150428	13545	13510	13570	13570	13385	13490	13480	-20	-30	6	40.45	308
	20150429	13490	13480	13490	13550	13490	13500	13520	20	40	14	94.65	312
	20150430	13500	13520	13425	13425	13425	13425	13425	-95	-95	2	13.43	312
al1602	20150216	13455	13455				13455	13455	0	0	0	0.00	0
	20150217	13455	13455	13560	13560	13560	13560	13560	105	105	6	40.68	6
	20150225	13560	13560				13560	13560	0	0	0	0.00	6
	20150226	13560	13560	13375	13380	13375	13380	13375	-180	-185	10	66.88	10
	20150227	13380	13375	13510	13510	13390	13390	13410	15	35	12	80.48	20
	20150302	13390	13410				13410	13410	0	0	0	0.00	20
	20150303	13410	13410	13425	13475	13425	13460	13465	50	55	30	201.99	46
	20150304	13460	13465	13395	13395	13395	13395	13395	-70	-70	4	26.79	46
	20150305	13395	13395				13370	13370	-25	-25	0	0.00	46
	20150306	13370	13370	13380	13410	13380	13410	13395	40	25	4	26.79	46
	20150309	13410	13395				13395	13395	0	0	0	0.00	46
	20150310	13395	13395				13395	13395	0	0	0	0.00	46
	20150311	13395	13395	13365	13380	13365	13380	13370	-15	-25	8	53.49	46
	20150312	13380	13370	13375	13510	13330	13510	13380	140	10	40	267.66	74
	20150313	13510	13380	13500	13535	13495	13495	13510	115	130	72	486.49	102
	20150316	13495	13510	13415	13415	13410	13410	13410	-100	-100	10	67.06	112
	20150317	13410	13410	13415	13415	13340	13370	13380	-40	-30	14	93.67	118
	20150318	13370	13380	13360	13440	13360	13440	13430	60	50	84	564.15	150
	20150319	13440	13430	13395	13550	13395	13545	13455	115	25	34	228.74	178
	20150320	13545	13455	13780	13780	13605	13605	13710	150	255	10	68.56	176
	20150323	13605	13710				13690	13690	-20	-20	0	0.00	176
	20150324	13690	13690				13675	13675	-15	-15	0	0.00	176
	20150325	13675	13675	13535	13535	13535	13535	13535	-140	-140	8	54.14	170
	20150326	13535	13535	13500	13500	13500	13500	13500	-35	-35	80	540.00	242
	20150327	13500	13500	13550	13550	13525	13525	13530	25	30	6	40.60	246
	20150330	13525	13530	13510	13520	13510	13515	13515	-15	-15	10	67.58	250
	20150331	13515	13515	13565	13585	13565	13585	13575	70	60	4	27.15	246
	20150401	13585	13575	13545	13545	13545	13545	13545	-30	-30	2	13.55	246
	20150402	13545	13545				13545	13545	0	0	0	0.00	246
	20150403	13545	13545	13560	13560	13375	13530	13500	-15	-45	12	81.01	248
	20150407	13530	13500				13500	13500	0	0	0	0.00	248
	20150408	13500	13500				13500	13500	0	0	0	0.00	248
	20150409	13500	13500	13390	13405	13305	13305	13360	-195	-140	16	106.91	244
	20150410	13305	13360				13360	13360	0	0	0	0.00	244
	20150413	13360	13360	13430	13455	13430	13435	13440	75	80	22	147.88	244
	20150414	13435	13440				13290	13290	-150	-150	0	0.00	244
	20150415	13290	13290				13290	13290	0	0	0	0.00	244
	20150416	13290	13290	13375	13375	13375	13375	13375	85	85	2	13.38	244
	20150417	13375	13375				13375	13375	0	0	0	0.00	244
	20150420	13375	13375				13375	13375	0	0	0	0.00	244
	20150421	13375	13375	13340	13340	13340	13340	13340	-35	-35	6	40.02	250
	20150422	13340	13340				13340	13340	0	0	0	0.00	250
	20150423	13340	13340				13340	13340	0	0	0	0.00	250
	20150424	13340	13340	13445	13445	13445	13445	13445	105	105	2	13.45	252
	20150427	13445	13445	13530	13565	13530	13565	13545	120	100	4	27.10	252
	20150428	13565	13545	13505	13505	13505	13505	13505	-40	-40	2	13.51	252
	20150429	13505	13505	13535	13535	13535	13535	13535	30	30	2	13.54	252
	20150430	13535	13535	13540	13565	13540	13565	13555	30	20	8	54.22	250
al1603	20150317	13410	13410				13410	13410	0	0	0	0.00	0
	20150318	13410	13410				13410	13410	0	0	0	0.00	0
	20150319	13410	13410				13465	13465	55	55	0	0.00	0
	20150320	13465	13465	13680	13680	13525	13525	13605	60	140	10	68.04	10
	20150323	13525	13605	13535	13625	13535	13595	13570	-10	-35	8	54.30	12
	20150324	13595	13570				13570	13570	0	0	0	0.00	12
	20150325	13570	13570				13570	13570	0	0	0	0.00	12
	20150326	13570	13570				13570	13570	0	0	0	0.00	12
	20150327	13570	13570				13570	13570	0	0	0	0.00	12
	20150330	13570	13570				13570	13570	0	0	0	0.00	12
	20150331	13570	13570	13595	13595	13595	13595	13595	25	25	4	27.19	10
	20150401	13595	13595	13580	13580	13580	13580	13580	-15	-15	6	40.74	8
	20150402	13580	13580				13580	13580	0	0	0	0.00	8
	20150403	13580	13580				13580	13580	0	0	0	0.00	8
	20150407	13580	13580				13580	13580	0	0	0	0.00	8
	20150408	13580	13580				13580	13580	0	0	0	0.00	8
	20150409	13580	13580	13525	13545	13410	13545	13490	-35	-90	14	94.44	10
	20150410	13545	13490	13470	13470	13470	13470	13470	-20	-20	2	13.47	10
	20150413	13470	13470	13490	13500	13490	13500	13495	30	25	80	539.98	90
	20150414	13500	13495	13305	13305	13305	13305	13305	-190	-190	2	13.31	90
	20150415	13305	13305				13305	13305	0	0	0	0.00	90
	20150416	13305	13305				13305	13305	0	0	0	0.00	90
	20150417	13305	13305	13450	13485	13315	13460	13425	155	120	20	134.30	90
	20150420	13460	13425	13375	13375	13375	13375	13375	-50	-50	6	40.13	90
	20150421	13375	13375	13360	13360	13360	13360	13360	-15	-15	4	26.72	94
	20150422	13360	13360				13360	13360	0	0	0	0.00	94
	20150423	13360	13360				13360	13360	0	0	0	0.00	94
	20150424	13360	13360	13470	13470	13470	13470	13470	110	110	10	67.35	104
	20150427	13470	13470				13470	13470	0	0	0	0.00	104
	20150428	13470	13470				13470	13470	0	0	0	0.00	104
	20150429	13470	13470	13580	13580	13580	13580	13580	110	110	2	13.58	106
	20150430	13580	13580				13600	13600	20	20	0	0.00	106
al1604	20150416	13305	13305				13305	13305	0	0	0	0.00	0
	20150417	13305	13305	12300	13450	12300	13440	13040	135	-265	32	208.69	12
	20150420	13440	13040	13555	13555	13555	13555	13555	515	515	2	13.56	10
	20150421	13555	13555	13375	13375	13375	13375	13375	-180	-180	2	13.38	12
	20150422	13375	13375	13485	13485	13235	13375	13350	0	-25	8	53.42	12
	20150423	13375	13350	13380	13380	13380	13380	13380	30	30	2	13.38	12
	20150424	13380	13380				13490	13490	110	110	0	0.00	12
	20150427	13490	13490	13600	13600	13600	13600	13600	110	110	2	13.60	12
	20150428	13600	13600				13600	13600	0	0	0	0.00	12
	20150429	13600	13600	13605	13605	13600	13600	13600	0	0	12	81.61	20
	20150430	13600	13600	13620	13620	13620	13620	13620	20	20	10	68.10	20
au1501	20150105	242.2	241.4	236.25	246.85	236.2	236.2	241.3	-5.2	-.1	24	579.15	126
	20150106	236.2	241.3	239.15	239.15	239.15	239.15	239.15	-2.15	-2.15	12	286.98	114
	20150107	239.15	239.15				239.15	239.15	0	0	0	0.00	114
	20150108	239.15	239.15	246	246	242.5	242.5	244.15	3.35	5	42	1,025.58	78
	20150109	242.5	244.15	244	244	242	242	243	-2.15	-1.15	12	291.60	72
	20150112	242	243	253.15	253.15	245.5	245.55	249.3	2.55	6.3	24	598.38	60
	20150113	245.55	249.3				249.3	249.3	0	0	0	0.00	60
	20150114	249.3	249.3				249.3	249.3	0	0	0	0.00	60
	20150115	249.3	249.3				249.3	249.3	0	0	0	0.00	60
au1502	20150105	240.6	241.35	239.3	240.1	238.6	240.1	239.55	-1.25	-1.8	24	574.94	140
	20150106	240.1	239.55	240.25	242.75	240.25	242.75	241.55	3.2	2	136	3,285.55	156
	20150107	242.75	241.55	243.15	244.65	241.55	243.6	243	2.05	1.45	260	6,318.91	150
	20150108	243.6	243	242.75	243.95	242.25	242.8	243.15	-.2	.15	88	2,139.97	132
	20150109	242.8	243.15	242.75	244	242.75	243.5	243.4	.35	.25	76	1,850.13	128
	20150112	243.5	243.4	243.25	246.8	243.25	246.65	245.15	3.25	1.75	44	1,078.75	108
	20150113	246.65	245.15	244.25	247.9	244.25	247.25	246.4	2.1	1.25	56	1,379.97	112
	20150114	247.25	246.4	248.5	248.5	245.1	246	246.85	-.4	.45	88	2,172.52	128
	20150115	246	246.85	246.05	248.1	245.45	245.8	246.5	-1.05	-.35	32	788.85	130
	20150116	245.8	246.5	250.25	258	250.1	251.9	251.85	5.4	5.35	264	6,649.98	134
	20150119	251.9	251.85	252.35	256.5	252.35	256	255.35	4.15	3.5	80	2,043.09	142
	20150120	256	255.35	256.15	256.4	255.95	255.95	256.1	.6	.75	8	204.89	138
	20150121	255.95	256.1	259.2	260.7	257.95	260.05	259.65	3.95	3.55	88	2,285.13	152
	20150122	260.05	259.65	260.8	260.8	256.55	256.55	258.4	-3.1	-1.25	84	2,170.74	128
	20150123	256.55	258.4	257.55	265	257.55	259.35	260.8	.95	2.4	3126	81,537.57	452
	20150126	259.35	260.8	259.85	260.75	257.05	260	259.8	-.8	-1	294	7,639.56	268
	20150127	260	259.8	258.55	258.55	257.1	257.2	257.2	-2.6	-2.6	134	3,446.99	152
	20150128	257.2	257.2	259.6	259.65	259.6	259.65	259.6	2.45	2.4	4	103.85	148
	20150129	259.65	259.6	259.1	259.1	257.75	258	258.25	-1.6	-1.35	68	1,756.39	94
	20150130	258	258.25	253.7	255.95	245.3	252.45	252.7	-5.8	-5.55	70	1,769.12	66
	20150202	252.45	252.7				255.85	255.85	3.15	3.15	0	0.00	66
	20150203	255.85	255.85				255.85	255.85	0	0	0	0.00	66
	20150204	255.85	255.85	257	257	254	254	255.1	-1.85	-.75	30	765.30	36
	20150205	254	255.1	263.95	263.95	251.05	251.05	257	-4.05	1.9	24	616.80	30
	20150206	251.05	257				257	257	0	0	0	0.00	30
	20150209	257	257				257	257	0	0	0	0.00	30
	20150210	257	257				257	257	0	0	0	0.00	30
au1503	20150105	240.65	240.65	240.15	240.15	240.15	240.15	240.15	-.5	-.5	2	48.03	2
	20150106	240.15	240.15				242.15	242.15	2	2	0	0.00	2
	20150107	242.15	242.15	243.55	243.55	243.55	243.55	243.55	1.4	1.4	2	48.71	4
	20150108	243.55	243.55	242.7	245.45	242.7	245.45	244.05	1.9	.5	4	97.63	2
	20150109	245.45	244.05				244.3	244.3	.25	.25	0	0.00	2
	20150112	244.3	244.3	245.6	247	243.15	247	244.9	2.7	.6	10	244.90	6
	20150113	247	244.9	247.65	248.75	247.65	248.75	248.2	3.85	3.3	4	99.28	4
	20150114	248.75	248.2				248.65	248.65	.45	.45	0	0.00	4
	20150115	248.65	248.65	248.6	250.25	245.15	246.15	247.05	-2.5	-1.6	10	247.06	4
	20150116	246.15	247.05	253.05	253.05	251.05	252.55	252.45	5.5	5.4	32	807.89	8
	20150119	252.55	252.45	253	253	252.7	252.7	252.85	.25	.4	4	101.14	4
	20150120	252.7	252.85	255.8	257.55	255.8	257.55	256.65	4.7	3.8	4	102.67	6
	20150121	257.55	256.65	256.85	262.1	256.5	259.75	259.15	3.1	2.5	44	1,140.28	4
	20150122	259.75	259.15	259.95	260	258.7	258.85	259.45	-.3	.3	14	363.26	12
	20150123	258.85	259.45	262.15	262.2	259.55	260.4	260.9	.95	1.45	10	260.94	10
	20150126	260.4	260.9	262.2	262.5	258.35	262.5	260.5	1.6	-.4	12	312.63	16
	20150127	262.5	260.5	258.4	258.4	257.35	257.35	257.6	-3.15	-2.9	8	206.09	10
	20150128	257.35	257.6	260.05	260.05	260.05	260.05	260.05	2.45	2.45	2	52.01	10
	20150129	260.05	260.05				258.7	258.7	-1.35	-1.35	0	0.00	10
	20150130	258.7	258.7				253.15	253.15	-5.55	-5.55	0	0.00	10
	20150202	253.15	253.15				253.15	253.15	0	0	0	0.00	10
	20150203	253.15	253.15				253.15	253.15	0	0	0	0.00	10
	20150204	253.15	253.15				252.4	252.4	-.75	-.75	0	0.00	10
	20150205	252.4	252.4				254.25	254.25	1.85	1.85	0	0.00	10
	20150206	254.25	254.25	256.35	257.55	256.35	257.55	256.95	3.3	2.7	4	102.78	10
	20150209	257.55	256.95	249.2	249.2	249.2	249.2	249.2	-7.75	-7.75	2	49.84	8
	20150210	249.2	249.2				249.2	249.2	0	0	0	0.00	8
	20150211	249.2	249.2				249.2	249.2	0	0	0	0.00	8
	20150212	249.2	249.2				249.2	249.2	0	0	0	0.00	8
	20150213	249.2	249.2				249.2	249.2	0	0	0	0.00	8
	20150216	249.2	249.2				249.2	249.2	0	0	0	0.00	8
	20150217	249.2	249.2	245.45	247.85	245.45	247.85	246.65	-1.35	-2.55	4	98.66	6
	20150225	247.85	246.65	244.6	245.1	244.15	245.1	244.6	-1.55	-2.05	10	244.62	0
	20150226	245.1	244.6				244.6	244.6	0	0	0	0.00	0
	20150227	244.6	244.6				244.6	244.6	0	0	0	0.00	0
	20150302	244.6	244.6				244.6	244.6	0	0	0	0.00	0
	20150303	244.6	244.6				244.6	244.6	0	0	0	0.00	0
	20150304	244.6	244.6				244.6	244.6	0	0	0	0.00	0
	20150305	244.6	244.6				244.6	244.6	0	0	0	0.00	0
	20150306	244.6	244.6				244.6	244.6	0	0	0	0.00	0
	20150309	244.6	244.6				244.6	244.6	0	0	0	0.00	0
	20150310	244.6	244.6				244.6	244.6	0	0	0	0.00	0
	20150311	244.6	244.6				244.6	244.6	0	0	0	0.00	0
	20150312	244.6	244.6				244.6	244.6	0	0	0	0.00	0
	20150313	244.6	244.6				244.6	244.6	0	0	0	0.00	0
	20150316	244.6	244.6				244.6	244.6	0	0	0	0.00	0
au1504	20150105	241.9	241.75	240.05	241.4	240.05	241.4	240.8	-.35	-.95	24	577.99	30
	20150106	241.4	240.8				242.8	242.8	2	2	0	0.00	30
	20150107	242.8	242.8				242.8	242.8	0	0	0	0.00	30
	20150108	242.8	242.8				243.25	243.25	.45	.45	0	0.00	30
	20150109	243.25	243.25				244.05	244.05	.8	.8	0	0.00	30
	20150112	244.05	244.05	244	244	243.8	243.8	243.85	-.25	-.2	8	195.11	30
	20150113	243.8	243.85	247.6	247.95	247.6	247.95	247.7	4.1	3.85	6	148.63	32
	20150114	247.95	247.7	248.7	249	245.85	246.1	247.6	-1.6	-.1	20	495.21	30
	20150115	246.1	247.6				246.45	246.45	-1.15	-1.15	0	0.00	30
	20150116	246.45	246.45	252.55	252.55	252.05	252.05	252.3	5.6	5.85	4	100.92	30
	20150119	252.05	252.3	254.05	257.55	254.05	257.55	255.5	5.25	3.2	10	255.54	32
	20150120	257.55	255.5	257.4	257.4	256.5	257.1	256.95	1.6	1.45	10	256.96	34
	20150121	257.1	256.95	258.6	262.3	258.6	262.3	260.85	5.35	3.9	14	365.19	30
	20150122	262.3	260.85	258.35	259.5	258.3	259.35	258.7	-1.5	-2.15	20	517.44	34
	20150123	259.35	258.7	259.5	261.85	259.5	260.15	260.4	1.45	1.7	98	2,552.37	102
	20150126	260.15	260.4	260.2	261.75	259.2	261.15	260.45	.75	.05	46	1,198.07	106
	20150127	261.15	260.45	259.55	259.95	257.8	257.8	259.4	-2.65	-1.05	12	311.32	98
	20150128	257.8	259.4	260.75	260.75	259.65	259.65	260.2	.25	.8	4	104.08	98
	20150129	259.65	260.2	259.95	259.95	259.25	259.25	259.6	-.95	-.6	4	103.84	98
	20150130	259.25	259.6	253.85	253.85	253.85	253.85	253.85	-5.75	-5.75	2	50.77	98
	20150202	253.85	253.85	255.7	258.85	254.75	258.6	257.8	4.75	3.95	78	2,011.19	116
	20150203	258.6	257.8	258.2	258.4	257.05	258.4	257.55	.6	-.25	20	515.13	116
	20150204	258.4	257.55	257.5	257.6	254.6	254.6	255.9	-2.95	-1.65	24	614.22	114
	20150205	254.6	255.9	256.25	257.15	256.25	256.7	256.7	.8	.8	26	667.48	114
	20150206	256.7	256.7	255.75	255.75	255.75	255.75	255.75	-.95	-.95	2	51.15	112
	20150209	255.75	255.75	256.95	256.95	249.3	250.8	252.65	-4.95	-3.1	120	3,032.00	120
	20150210	250.8	252.65	249.65	251.3	249.4	251.3	249.95	-1.35	-2.7	18	449.98	118
	20150211	251.3	249.95	249.75	249.9	248.55	249.9	249.3	-.05	-.65	40	997.36	124
	20150212	249.9	249.3	247	247	246.95	247	246.95	-2.3	-2.35	8	197.59	130
	20150213	247	246.95	245.55	247.65	245.55	247.65	246.5	.7	-.45	8	197.20	128
	20150216	247.65	246.5	250.3	250.3	248.05	249.15	249.15	2.65	2.65	22	548.17	134
	20150217	249.15	249.15	249.4	249.4	248.1	248.35	248.85	-.8	-.3	24	597.32	126
	20150225	248.35	248.85	244.9	244.9	244.15	244.15	244.5	-4.7	-4.35	4	97.81	126
	20150226	244.15	244.5	243.65	244.85	243.65	244.85	244.3	.35	-.2	20	488.69	126
	20150227	244.85	244.3	244.6	245.25	244.6	245.15	245.05	.85	.75	60	1,470.50	72
	20150302	245.15	245.05	246.5	248	246.5	248	247.55	2.95	2.5	16	396.14	60
	20150303	248	247.55	245.5	246.3	244.6	245.55	245.4	-2	-2.15	24	589.05	62
	20150304	245.55	245.4	245.2	245.5	244.35	245.5	245	.1	-.4	14	343.00	60
	20150305	245.5	245	244.7	244.8	244.05	244.6	244.45	-.4	-.55	14	342.26	58
	20150306	244.6	244.45				244.45	244.45	0	0	0	0.00	58
	20150309	244.45	244.45	239.65	239.65	237.35	238.3	238.65	-6.15	-5.8	40	954.66	58
	20150310	238.3	238.65	236.45	236.7	235.95	236.7	236.3	-1.95	-2.35	26	614.42	60
	20150311	236.7	236.3	236.2	236.75	236.2	236.75	236.55	.45	.25	6	141.94	56
	20150312	236.75	236.55	234.45	235.35	234.3	235.35	234.55	-1.2	-2	10	234.57	54
	20150313	235.35	234.55				234.55	234.55	0	0	0	0.00	54
	20150316	234.55	234.55	235.1	236.5	235.1	236.5	235.7	1.95	1.15	14	329.98	54
	20150317	236.5	235.7	236.5	236.5	233.6	234.85	235	-.85	-.7	8	188.01	56
	20150318	234.85	235	232.6	233.35	232.6	233.35	232.85	-1.65	-2.15	6	139.71	58
	20150319	233.35	232.85	236.05	236.35	236.05	236.25	236.2	3.4	3.35	44	1,039.32	58
	20150320	236.25	236.2	235.3	235.3	235	235	235.15	-1.2	-1.05	4	94.06	56
	20150323	235	235.15	240.25	246.8	238.15	238.35	239.85	3.2	4.7	60	1,439.38	58
	20150324	238.35	239.85	239.05	243.2	235.65	239.75	238.65	-.1	-1.2	22	525.12	56
	20150325	239.75	238.65	240.35	240.35	238.45	239.45	239.35	.8	.7	30	718.19	56
	20150326	239.45	239.35	241.95	241.95	237.35	240.65	240.5	1.3	1.15	44	1,058.20	64
	20150327	240.65	240.5	238.65	242.6	238.65	240.8	240.85	.3	.35	118	2,842.51	44
	20150330	240.8	240.85	239.25	239.3	238.15	238.7	238.95	-2.15	-1.9	38	908.01	24
	20150331	238.7	238.95	237.5	237.5	237	237	237.1	-1.95	-1.85	8	189.70	18
	20150401	237	237.1				237.1	237.1	0	0	0	0.00	18
	20150402	237.1	237.1	240	240	240	240	240	2.9	2.9	6	144.00	18
	20150403	240	240				240	240	0	0	0	0.00	18
	20150407	240	240				240	240	0	0	0	0.00	18
	20150408	240	240				240	240	0	0	0	0.00	18
	20150409	240	240				240	240	0	0	0	0.00	18
	20150410	240	240				240	240	0	0	0	0.00	18
	20150413	240	240				240	240	0	0	0	0.00	18
	20150414	240	240	238.5	238.5	238.5	238.5	238.5	-1.5	-1.5	18	429.30	0
	20150415	238.5	238.5				238.5	238.5	0	0	0	0.00	0
au1505	20150216	246.5	246.5	245.45	251.8	245.45	251.8	248.6	5.3	2.1	4	99.45	2
	20150217	251.8	248.6				248.3	248.3	-.3	-.3	0	0.00	2
	20150225	248.3	248.3	244.05	247.15	243.85	247.15	245.5	-1.15	-2.8	16	392.82	2
	20150226	247.15	245.5	245.65	246	245.65	246	245.8	.5	.3	4	98.33	2
	20150227	246	245.8	248.25	248.25	245.15	248.2	246.8	2.4	1	20	493.69	4
	20150302	248.2	246.8	248.1	250.45	247.35	248.85	248.95	2.05	2.15	100	2,489.63	12
	20150303	248.85	248.95	248.95	248.95	244.25	246.65	246.8	-2.3	-2.15	14	345.58	14
	20150304	246.65	246.8	245.8	248.05	245.5	246.75	247.1	-.05	.3	550	13,590.98	66
	20150305	246.75	247.1	245.3	245.3	245.1	245.1	245.2	-2	-1.9	6	147.14	60
	20150306	245.1	245.2	245.75	245.75	243.2	244.5	243.85	-.7	-1.35	46	1,121.89	40
	20150309	244.5	243.85	242.35	242.35	239.1	239.1	240.75	-4.75	-3.1	24	577.91	34
	20150310	239.1	240.75				240.75	240.75	0	0	0	0.00	34
	20150311	240.75	240.75	238.3	238.85	237.5	237.5	238.25	-3.25	-2.5	48	1,143.70	36
	20150312	237.5	238.25	237.5	237.95	235.15	236.75	236.3	-1.5	-1.95	16	378.11	32
	20150313	236.75	236.3	237.45	237.45	234.4	236.45	236.6	.15	.3	12	283.92	34
	20150316	236.45	236.6	235.6	238.15	235.6	236.35	237.05	-.25	.45	54	1,280.27	20
	20150317	236.35	237.05	236.8	236.8	235.2	235.2	236.25	-1.85	-.8	90	2,126.64	18
	20150318	235.2	236.25	232.15	236.55	232.15	234.8	234.5	-1.45	-1.75	24	562.80	22
	20150319	234.8	234.5	232.5	238.9	232.5	238.6	236.1	4.1	1.6	24	566.71	22
	20150320	238.6	236.1	235.55	237.7	235.55	237.35	236.6	1.25	.5	94	2,224.32	26
	20150323	237.35	236.6	240.15	240.5	238.25	240.5	239.4	3.9	2.8	16	383.08	26
	20150324	240.5	239.4	240	240.25	239.7	239.75	239.75	.35	.35	62	1,486.69	66
	20150325	239.75	239.75	241.95	242.2	239.9	240	241.1	.25	1.35	32	771.52	76
	20150326	240	241.1	241.75	243.45	241.1	243.45	241.95	2.35	.85	24	580.74	78
	20150327	243.45	241.95	241.5	242.95	241.5	241.75	242.15	-.2	.2	20	484.33	78
	20150330	241.75	242.15	240.1	240.1	240.1	240.1	240.1	-2.05	-2.05	26	624.26	52
	20150331	240.1	240.1	239.2	239.2	236.1	237.1	237.5	-3	-2.6	14	332.50	50
	20150401	237.1	237.5	237.95	237.95	237	237	237.6	-.5	.1	20	475.28	42
	20150402	237	237.6	237.6	241.7	237.6	240.85	240.1	3.25	2.5	14	336.20	42
	20150403	240.85	240.1	240.5	240.85	239.55	240.6	240.35	.5	.25	12	288.44	40
	20150407	240.6	240.35	242.45	242.95	242.15	242.95	242.55	2.6	2.2	16	388.12	34
	20150408	242.95	242.55	243.4	243.4	240.95	242.3	242.35	-.25	-.2	24	581.65	34
	20150409	242.3	242.35				239.5	239.5	-2.85	-2.85	0	0.00	34
	20150410	239.5	239.5	251	251	237.55	238.85	240.4	-.65	.9	16	384.67	34
	20150413	238.85	240.4	241.25	241.8	240.8	240.8	241.35	.4	.95	22	531.01	28
	20150414	240.8	241.35	240.5	241.3	239.95	239.95	240.45	-1.4	-.9	14	336.65	26
	20150415	239.95	240.45	239.2	239.2	239.2	239.2	239.2	-1.25	-1.25	2	47.84	26
	20150416	239.2	239.2	241	241	240	240	240.5	.8	1.3	4	96.20	26
	20150417	240	240.5	242.05	242.05	235.25	239.55	240.15	-.95	-.35	14	336.23	28
	20150420	239.55	240.15	241.3	241.4	241.3	241.4	241.3	1.25	1.15	10	241.32	24
	20150421	241.4	241.3	240.45	240.45	238.5	239.7	239.6	-1.6	-1.7	56	1,341.95	24
	20150422	239.7	239.6	239.75	240.95	239.45	240.5	240.25	.9	.65	36	864.94	16
	20150423	240.5	240.25	240.1	240.1	233.45	237.9	237.3	-2.35	-2.95	22	522.12	20
	20150424	237.9	237.3	237.8	240.65	233.25	239.05	238.25	1.75	.95	92	2,192.30	34
	20150427	239.05	238.25	238	238	236	237.45	237.05	-.8	-1.2	30	711.19	26
	20150428	237.45	237.05	238	241.45	237.4	240.45	239.2	3.4	2.15	18	430.56	24
	20150429	240.45	239.2	240.5	243.2	238.95	240.7	241.1	1.5	1.9	34	819.75	6
	20150430	240.7	241.1	241.85	244.25	236.25	236.25	239.65	-4.85	-1.45	26	623.12	6
au1506	20150105	241.65	242.65	240	242.5	240	242.15	241.4	-.5	-1.25	61846	1,492,967.32	199292
	20150106	242.15	241.4	240.95	245	240.35	244.45	242.8	3.05	1.4	237512	5,767,933.40	214248
	20150107	244.45	242.8	244.7	247.3	243.8	245.25	245.35	2.45	2.55	237538	5,828,353.55	214320
	20150108	245.25	245.35	245.2	246.2	244.3	244.5	245.2	-.85	-.15	176986	4,339,732.48	216874
	20150109	244.5	245.2	245	246.15	244.55	245.15	245.35	-.05	.15	148366	3,640,331.51	217668
	20150112	245.15	245.35	244.7	248.7	243.95	247.75	246.35	2.4	1	271728	6,694,356.85	229588
	20150113	247.75	246.35	246.35	250	246	249	248.1	2.65	1.75	197054	4,889,606.31	233632
	20150114	249	248.1	249.5	250.5	246.3	247.9	248.5	-.2	.4	249476	6,200,412.36	229310
	20150115	247.9	248.5	248	250.1	246.35	246.75	248.3	-1.75	-.2	288116	7,154,453.84	227196
	20150116	246.75	248.3	251.85	253.75	251	253.65	252.45	5.35	4.15	403772	10,193,908.18	237232
	20150119	253.65	252.45	253.8	259	253.5	257.85	256.7	5.4	4.25	381174	9,784,740.59	239050
	20150120	257.85	256.7	258	258.3	256.85	257.65	257.5	.95	.8	139018	3,580,379.14	238328
	20150121	257.65	257.5	260.55	263	259.15	262.2	260.75	4.7	3.25	294908	7,690,020.91	239610
	20150122	262.2	260.75	262.15	263.2	258.05	259.05	260.5	-1.7	-.25	349310	9,100,731.12	236052
	20150123	259.05	260.5	259.55	262.85	258.95	261.4	261.1	.9	.6	380550	9,936,185.10	242060
	20150126	261.4	261.1	261.6	262.55	259.25	261.6	261.15	.5	.05	237780	6,210,226.62	242814
	20150127	261.6	261.15	259.85	260.6	258.3	259.9	259.45	-1.25	-1.7	225122	5,840,804.66	244742
	20150128	259.9	259.45	259.75	261.95	259.05	260.8	260.55	1.35	1.1	219708	5,725,347.82	245924
	20150129	260.8	260.55	261.2	261.75	258.6	259.3	260	-1.25	-.55	204518	5,318,393.79	241628
	20150130	259.3	260	256.55	257.7	252.75	255.05	255.4	-4.95	-4.6	332588	8,495,400.54	222422
	20150202	255.05	255.4	255.8	260	254.6	259.1	257.45	3.7	2.05	291006	7,492,146.46	226434
	20150203	259.1	257.45	258	259.6	256.75	259.4	258.1	1.95	.65	212940	5,496,886.64	223518
	20150204	259.4	258.1	258	258.2	254.9	256.35	256.35	-1.75	-1.75	288614	7,398,839.80	228788
	20150205	256.35	256.35	257	258.3	255.3	257.5	256.95	1.15	.6	232176	5,966,658.15	226486
	20150206	257.5	256.95	256.05	256.85	255	256.7	256	-.25	-.95	178268	4,563,665.80	227854
	20150209	256.7	256	256.25	260.25	249.7	251.4	252.1	-4.6	-3.9	419660	10,580,856.10	227334
	20150210	251.4	252.1	251.45	252.4	250.6	252.05	251.6	-.05	-.5	140404	3,532,599.29	223390
	20150211	252.05	251.6	251.15	251.45	250	250.8	250.7	-.8	-.9	163350	4,095,445.85	223966
	20150212	250.8	250.7	250.7	250.85	247.35	247.85	248.7	-2.85	-2	204948	5,097,777.39	224192
	20150213	247.85	248.7	248.25	249.65	247.55	249.45	248.45	.75	-.25	179138	4,451,432.09	215430
	20150216	249.45	248.45	248.55	250.75	248.45	250.3	249.75	1.85	1.3	142798	3,566,496.60	213136
	20150217	250.3	249.75	250.15	250.75	248.8	249	250.1	-.75	.35	70090	1,753,170.25	210000
	20150225	249	250.1	245.5	246.55	245.5	246.3	246	-3.8	-4.1	38726	952,779.34	211012
	20150226	246.3	246	245.85	246.75	244.1	246.45	245.65	.45	-.35	127444	3,131,032.65	216280
	20150227	246.45	245.65	247.5	248.15	245.7	246.65	246.75	1	1.1	137716	3,398,445.53	222660
	20150302	246.65	246.75	246.3	249.75	246.3	249.3	248.15	2.55	1.4	206588	5,126,721.96	227628
	20150303	249.3	248.15	248.4	249.05	243.85	247.05	246.95	-1.1	-1.2	234398	5,788,670.20	223844
	20150304	247.05	246.95	247.4	248.35	245.75	246.7	246.8	-.25	-.15	198668	4,903,861.20	210838
	20150305	246.7	246.8	246.35	246.9	245	245.65	245.9	-1.15	-.9	162428	3,994,416.15	202582
	20150306	245.65	245.9	245.4	246.9	244.4	245	245.45	-.9	-.45	147354	3,617,056.34	197516
	20150309	245	245.45	244.65	244.85	238.25	239.9	240.8	-5.55	-4.65	327884	7,896,419.48	202522
	20150310	239.9	240.8	239.65	240.3	237.1	237.5	238.8	-3.3	-2	153080	3,656,073.35	201910
	20150311	237.5	238.8	238.7	239.4	237.2	238.25	238.25	-.55	-.55	175340	4,178,299.52	210238
	20150312	238.25	238.25	237.45	238.8	235.05	238.4	236.5	.15	-1.75	251356	5,945,491.73	205228
	20150313	238.4	236.5	236.85	237.9	235.75	237.2	237	.7	.5	145612	3,451,117.80	205186
	20150316	237.2	237	237.5	238.3	236.05	238	236.95	1	-.05	152944	3,624,353.54	207076
	20150317	238	236.95	236.4	237.25	235.65	236.25	236.3	-.7	-.65	155364	3,671,942.13	212226
	20150318	236.25	236.3	235.1	241.35	224.5	233.65	234.85	-2.65	-1.45	334944	7,866,361.48	207576
	20150319	233.65	234.85	233.3	239.55	233.3	237.75	236.2	2.9	1.35	228062	5,387,522.20	205168
	20150320	237.75	236.2	235.75	238.15	235.75	237.4	237	1.2	.8	176958	4,194,489.53	203432
	20150323	237.4	237	236.95	241.1	236.95	240.1	239.7	3.1	2.7	229898	5,510,704.32	201292
	20150324	240.1	239.7	240.2	241.9	239.8	241.1	241	1.4	1.3	167166	4,029,204.40	200064
	20150325	241.1	241	241.85	242.55	240.5	241.15	241.25	.15	.25	262864	6,342,380.16	199772
	20150326	241.15	241.25	243	243.95	242.1	243.9	242.85	2.65	1.6	169740	4,122,440.09	202018
	20150327	243.9	242.85	243.85	244.25	242.75	243.25	243.6	.4	.75	156580	3,814,576.80	195698
	20150330	243.25	243.6	242.8	243.15	240.3	240.4	241.75	-3.2	-1.85	199746	4,829,699.72	190546
	20150331	240.4	241.75	239.3	239.9	237.85	237.85	239	-3.9	-2.75	175542	4,196,080.25	188526
	20150401	237.85	239	239.3	239.65	237.75	238.35	238.75	-.65	-.25	165432	3,949,900.56	190284
	20150402	238.35	238.75	239.95	243.05	239.5	242.95	241.55	4.2	2.8	244050	5,895,573.34	193926
	20150403	242.95	241.55	242.4	242.65	240.2	241.75	241.35	.2	-.2	173668	4,191,647.45	182772
	20150407	241.75	241.35	243.15	244.1	243.15	243.9	243.75	2.55	2.4	48968	1,193,620.23	183068
	20150408	243.9	243.75	243.5	244.2	242.65	243.75	243.55	0	-.2	123654	3,011,880.54	183796
	20150409	243.75	243.55	243	243.65	239.7	240.5	241.75	-3.05	-1.8	185616	4,487,848.20	180862
	20150410	240.5	241.75	240.9	241.2	239.5	240.25	240.1	-1.5	-1.65	134150	3,221,442.29	180468
	20150413	240.25	240.1	242.4	243.6	242	242.65	242.8	2.55	2.7	166920	4,053,475.61	172632
	20150414	242.65	242.8	242.65	243.05	239.15	240.15	241.25	-2.65	-1.55	172328	4,157,901.77	181184
	20150415	240.15	241.25	239.2	242.7	239.05	240.1	240.25	-1.15	-1	159376	3,829,349.93	176908
	20150416	240.1	240.25	240.1	242.6	239.8	241.75	241.15	1.5	.9	162448	3,917,631.93	172594
	20150417	241.75	241.15	242.05	242.15	239.85	240.85	240.8	-.3	-.35	162154	3,904,799.54	174318
	20150420	240.85	240.8	241.3	242.9	240.95	242.75	241.55	1.95	.75	141530	3,419,216.92	172528
	20150421	242.75	241.55	240.45	241.2	239.45	239.9	240.1	-1.65	-1.45	167564	4,023,323.38	174398
	20150422	239.9	240.1	241.05	241.65	240	241.2	240.8	1.1	.7	139054	3,348,479.86	165958
	20150423	241.2	240.8	240.4	240.45	236.95	237.4	238.3	-3.4	-2.5	275116	6,556,174.11	176366
	20150424	237.4	238.3	237.65	239.4	237.2	238.9	238.25	.6	-.05	156290	3,724,280.40	165370
	20150427	238.9	238.25	237.6	238.1	235.5	236.55	236.5	-1.7	-1.75	211312	4,998,043.01	168400
	20150428	236.55	236.5	237.65	242.5	237.35	240.75	240.4	4.25	3.9	264478	6,358,240.88	140582
	20150429	240.75	240.4	241.5	243.65	240.85	242.45	242.6	2.05	2.2	191776	4,652,816.56	129284
	20150430	242.45	242.6	242.3	243.15	240.5	241.2	242	-1.4	-.6	179948	4,355,454.78	119576
au1507	20150416	240.25	240.25				241.15	241.15	.9	.9	0	0.00	0
	20150417	241.15	241.15	242.5	242.5	237.5	241.3	240.1	.15	-1.05	160	3,842.13	44
	20150420	241.3	240.1	242.55	244	241.7	243.4	242.45	3.3	2.35	38	921.36	30
	20150421	243.4	242.45	238.25	242.45	238.25	239.65	241.2	-2.8	-1.25	22	530.67	30
	20150422	239.65	241.2	240.95	240.95	240.1	240.35	240.4	-.85	-.8	14	336.56	26
	20150423	240.35	240.4	238.6	238.75	238.6	238.75	238.65	-1.65	-1.75	6	143.21	24
	20150424	238.75	238.65	238.7	238.7	238.7	238.7	238.7	.05	.05	4	95.48	20
	20150427	238.7	238.7				236.95	236.95	-1.75	-1.75	0	0.00	20
	20150428	236.95	236.95	238.35	243.75	238.35	240.5	241.1	3.55	4.15	12	289.33	18
	20150429	240.5	241.1	242.8	244.1	239.6	243.3	242.75	2.2	1.65	16	388.42	16
	20150430	243.3	242.75	242.55	242.55	242.55	242.55	242.55	-.2	-.2	2	48.51	18
au1508	20150105	242.6	243.15	241.4	242	241.4	242	241.6	-1.15	-1.55	8	193.29	40
	20150106	242	241.6	244	245.4	244	245.4	244.65	3.8	3.05	10	244.66	40
	20150107	245.4	244.65	245.1	245.15	245.1	245.15	245.1	.5	.45	4	98.05	36
	20150108	245.15	245.1				245.1	245.1	0	0	0	0.00	36
	20150109	245.1	245.1	245.35	245.9	245.35	245.55	245.65	.45	.55	12	294.80	42
	20150112	245.55	245.65	245.55	249.05	244.4	249.05	247.35	3.4	1.7	44	1,088.52	42
	20150113	249.05	247.35	247.55	250.35	247.5	249.15	249.1	1.8	1.75	50	1,245.70	58
	20150114	249.15	249.1	249.15	250.35	246.8	248.15	248.6	-.95	-.5	70	1,740.26	50
	20150115	248.15	248.6	248.45	250.25	247.3	247.3	249.2	-1.3	.6	24	598.14	44
	20150116	247.3	249.2	252.25	253.35	251.5	253.3	252.55	4.1	3.35	88	2,222.82	92
	20150119	253.3	252.55	256.3	258	256.3	258	257.35	5.45	4.8	26	669.22	96
	20150120	258	257.35	257.65	258	257.1	258	257.6	.65	.25	34	875.90	80
	20150121	258	257.6	259.5	263.15	259.5	262.25	260.7	4.65	3.1	36	938.67	94
	20150122	262.25	260.7	263.2	263.2	259.4	259.4	260.95	-1.3	.25	176	4,592.82	92
	20150123	259.4	260.95	259.7	262.45	259.7	261.35	261.6	.4	.65	26	680.22	92
	20150126	261.35	261.6				261.6	261.6	0	0	0	0.00	92
	20150127	261.6	261.6	259.25	259.75	259.2	259.2	259.35	-2.4	-2.25	28	726.30	90
	20150128	259.2	259.35	259.85	260.6	259.85	260.2	260.1	.85	.75	8	208.11	88
	20150129	260.2	260.1				259.8	259.8	-.3	-.3	0	0.00	88
	20150130	259.8	259.8	257.65	257.65	253.95	254.85	255.75	-4.95	-4.05	22	562.68	84
	20150202	254.85	255.75				258.8	258.8	3.05	3.05	0	0.00	84
	20150203	258.8	258.8	258.1	259.2	258.1	259	258.6	.2	-.2	18	465.55	84
	20150204	259	258.6	255.6	256.05	255.6	256.05	255.85	-2.55	-2.75	6	153.53	82
	20150205	256.05	255.85	258.5	258.5	258.1	258.1	258.3	2.25	2.45	4	103.32	80
	20150206	258.1	258.3	257.2	257.2	256.9	256.9	257.05	-1.4	-1.25	6	154.25	80
	20150209	256.9	257.05	257.25	257.25	251.2	252.1	253.2	-4.95	-3.85	94	2,380.30	62
	20150210	252.1	253.2	252.1	252.75	252.1	252.75	252.4	-.45	-.8	4	100.97	62
	20150211	252.75	252.4	252.75	252.75	251	251	252	-1.4	-.4	22	554.40	60
	20150212	251	252	248.85	248.85	248.1	248.85	248.45	-3.15	-3.55	32	795.17	52
	20150213	248.85	248.45				248.75	248.75	.3	.3	0	0.00	52
	20150216	248.75	248.75	250.1	250.1	250.1	250.1	250.1	1.35	1.35	2	50.02	50
	20150217	250.1	250.1	250.95	251.15	250.2	250.2	250.7	.1	.6	22	551.54	48
	20150225	250.2	250.7				248.6	248.6	-2.1	-2.1	0	0.00	48
	20150226	248.6	248.6	246.35	246.7	246.35	246.7	246.5	-1.9	-2.1	4	98.61	46
	20150227	246.7	246.5	247.8	247.8	246.8	247.75	247.6	1.25	1.1	12	297.15	50
	20150302	247.75	247.6	247.4	250.2	247.4	250.2	249.1	2.6	1.5	10	249.13	48
	20150303	250.2	249.1	248.7	248.7	247.55	247.8	247.85	-1.3	-1.25	14	347.01	44
	20150304	247.8	247.85				247.85	247.85	0	0	0	0.00	44
	20150305	247.85	247.85				247.85	247.85	0	0	0	0.00	44
	20150306	247.85	247.85				247.85	247.85	0	0	0	0.00	44
	20150309	247.85	247.85				245	245	-2.85	-2.85	0	0.00	44
	20150310	245	245	240.4	240.4	238.65	238.65	239.55	-6.35	-5.45	220	5,271.04	238
	20150311	238.65	239.55				239.55	239.55	0	0	0	0.00	238
	20150312	239.55	239.55	237.45	239.45	237.25	239.45	237.75	-.1	-1.8	14	332.85	236
	20150313	239.45	237.75	238.15	238.95	238.15	238.9	238.6	1.15	.85	10	238.60	236
	20150316	238.9	238.6	238.5	238.65	238.5	238.65	238.55	.05	-.05	4	95.43	236
	20150317	238.65	238.55	238.45	238.65	237.7	238.3	238.2	-.25	-.35	64	1,524.52	242
	20150318	238.3	238.2	236.1	238.45	235.05	235.45	236.65	-2.75	-1.55	20	473.31	240
	20150319	235.45	236.65	236.25	240.8	235.55	239.65	238.3	3	1.65	86	2,049.55	266
	20150320	239.65	238.3	238.25	239.4	238.25	238.85	238.9	.55	.6	104	2,484.78	276
	20150323	238.85	238.9	241.15	241.95	241.15	241.75	241.3	2.85	2.4	32	772.26	278
	20150324	241.75	241.3	241.7	243.2	241	241.8	241.25	.5	-.05	320	7,720.20	206
	20150325	241.8	241.25	241.65	243	241.2	242.1	242.1	.85	.85	22	532.70	202
	20150326	242.1	242.1	243.1	244.05	243.1	244.05	243.6	1.95	1.5	42	1,023.24	168
	20150327	244.05	243.6	244.3	244.45	243.6	243.8	244.1	.2	.5	18	439.39	156
	20150330	243.8	244.1	243.1	243.1	241.55	241.55	242.05	-2.55	-2.05	8	193.66	156
	20150331	241.55	242.05	240.25	240.25	238.35	238.35	239.25	-3.7	-2.8	38	909.25	140
	20150401	238.35	239.25	239.7	240.35	238.9	239.75	239.55	.5	.3	54	1,293.60	144
	20150402	239.75	239.55	239.75	243.1	239.75	243.05	241.5	3.5	1.95	68	1,642.23	142
	20150403	243.05	241.5	242.7	242.7	240.85	241.8	241.8	.3	.3	16	386.95	134
	20150407	241.8	241.8	244	244	244	244	244	2.2	2.2	2	48.80	134
	20150408	244	244	244.15	244.15	243.3	243.3	243.7	-.7	-.3	14	341.18	138
	20150409	243.3	243.7	241.65	241.65	241.65	241.65	241.65	-2.05	-2.05	4	96.66	134
	20150410	241.65	241.65	240.85	241.25	240.85	241.25	241.1	-.4	-.55	6	144.67	134
	20150413	241.25	241.1	242.95	243.95	242.95	243	243.25	1.9	2.15	10	243.29	136
	20150414	243	243.25	242.85	242.85	240.25	240.25	241.65	-3	-1.6	20	483.32	134
	20150415	240.25	241.65	241.8	241.8	240.7	240.8	241.4	-.85	-.25	62	1,496.97	130
	20150416	240.8	241.4	242.1	242.1	242.1	242.1	242.1	.7	.7	6	145.26	134
	20150417	242.1	242.1	242.1	242.6	240.95	241.45	241.55	-.65	-.55	22	531.43	126
	20150420	241.45	241.55	241.45	242.85	241.45	242.85	242	1.3	.45	22	532.50	126
	20150421	242.85	242	241.1	241.1	240.45	240.8	240.85	-1.2	-1.15	16	385.38	126
	20150422	240.8	240.85	241.7	241.75	241.7	241.75	241.7	.9	.85	4	96.69	126
	20150423	241.75	241.7	239	239.55	238	238	238.85	-3.7	-2.85	164	3,917.18	138
	20150424	238	238.85	238.6	239.8	237.5	239.8	239	.95	.15	92	2,199.08	128
	20150427	239.8	239	237.45	238.25	236.4	237.7	237.1	-1.3	-1.9	142	3,366.91	190
	20150428	237.7	237.1	238.35	242.35	238.35	241.35	241.35	4.25	4.25	186	4,489.23	108
	20150429	241.35	241.35	243.85	243.85	243.1	243.65	243.55	2.3	2.2	118	2,873.99	150
	20150430	243.65	243.55	244	244	242.2	242.35	243.3	-1.2	-.25	110	2,676.34	122
au1510	20150105	243.25	243.85	241.65	242.65	241.6	242.65	241.85	-1.2	-2	18	435.41	62
	20150106	242.65	241.85	241.8	244.8	241.8	244.8	243.7	2.95	1.85	22	536.23	66
	20150107	244.8	243.7	245.6	248.65	245	246.15	247.3	2.45	3.6	54	1,335.54	56
	20150108	246.15	247.3	246	246.8	246	246.25	246.15	-1.05	-1.15	12	295.41	56
	20150109	246.25	246.15	246.15	246.15	245.65	245.85	245.85	-.3	-.3	12	295.02	46
	20150112	245.85	245.85	247.95	249.15	247.95	249.15	248.5	3.3	2.65	12	298.21	42
	20150113	249.15	248.5	249.9	250.2	249.5	249.5	249.8	1	1.3	10	249.82	42
	20150114	249.5	249.8	246.9	246.9	246.9	246.9	246.9	-2.9	-2.9	2	49.38	42
	20150115	246.9	246.9	248.75	248.75	247.35	247.35	247.8	.45	.9	14	346.98	44
	20150116	247.35	247.8	252.65	253.8	252	253.8	252.75	6	4.95	28	707.70	48
	20150119	253.8	252.75	258.45	258.55	257.15	257.95	258.05	5.2	5.3	28	722.62	48
	20150120	257.95	258.05	258.15	258.2	257.75	257.75	258.05	-.3	0	8	206.45	44
	20150121	257.75	258.05	261.8	263.3	260.45	263.15	262.1	5.1	4.05	16	419.43	40
	20150122	263.15	262.1	260	260.75	259.75	259.75	260.2	-2.35	-1.9	10	260.23	46
	20150123	259.75	260.2	262.1	263.5	261.25	262.8	262.55	2.6	2.35	20	525.15	50
	20150126	262.8	262.55	262.8	262.8	262.25	262.5	262.45	-.05	-.1	8	209.96	44
	20150127	262.5	262.45	259.5	259.9	259.2	259.2	259.5	-3.25	-2.95	18	467.12	50
	20150128	259.2	259.5	261.45	261.45	261.45	261.45	261.45	1.95	1.95	2	52.29	50
	20150129	261.45	261.45	261.55	261.55	259.6	259.6	261.2	-1.85	-.25	14	365.72	38
	20150130	259.6	261.2	256.35	256.35	254.4	255.7	255.2	-5.5	-6	12	306.29	40
	20150202	255.7	255.2	258.6	258.6	258.6	258.6	258.6	3.4	3.4	2	51.72	40
	20150203	258.6	258.6	258.95	259.2	258.7	259.2	259	.6	.4	18	466.25	46
	20150204	259.2	259	258	258	255.75	256.25	256.3	-2.75	-2.7	22	563.96	44
	20150205	256.25	256.3	258.2	258.6	257.25	258.05	258.1	1.75	1.8	14	361.34	40
	20150206	258.05	258.1	256.85	257.5	255.1	257.5	256.45	-.6	-1.65	12	307.79	50
	20150209	257.5	256.45	258.1	258.1	249.15	251.85	252.65	-4.6	-3.8	52	1,314.01	58
	20150210	251.85	252.65	251.95	253.3	251.75	252.9	252.65	.25	0	18	454.79	56
	20150211	252.9	252.65	251.35	251.35	251.3	251.3	251.3	-1.35	-1.35	4	100.53	54
	20150212	251.3	251.3	250.9	250.9	250	250	250.45	-1.3	-.85	4	100.18	52
	20150213	250	250.45	249.9	249.9	249.9	249.9	249.9	-.55	-.55	2	49.98	50
	20150216	249.9	249.9				249.9	249.9	0	0	0	0.00	50
	20150217	249.9	249.9	251.05	251.05	251.05	251.05	251.05	1.15	1.15	6	150.63	52
	20150225	251.05	251.05	247.05	247.05	247.05	247.05	247.05	-4	-4	4	98.82	52
	20150226	247.05	247.05	246.65	246.65	246.2	246.65	246.45	-.4	-.6	12	295.78	52
	20150227	246.65	246.45	247.5	247.5	247.5	247.5	247.5	1.05	1.05	2	49.50	54
	20150302	247.5	247.5	251.2	251.2	251.2	251.2	251.2	3.7	3.7	4	100.48	50
	20150303	251.2	251.2	246.2	249.65	246.2	248.3	247.7	-2.9	-3.5	8	198.17	50
	20150304	248.3	247.7	248.55	248.55	248.25	248.25	248.4	.55	.7	4	99.36	54
	20150305	248.25	248.4	246.7	247.2	246.45	247.2	246.75	-1.2	-1.65	6	148.07	52
	20150306	247.2	246.75	246.4	247.1	246.3	246.3	246.6	-.45	-.15	6	147.96	48
	20150309	246.3	246.6	245	245	240.25	241.1	241.2	-5.5	-5.4	36	868.40	58
	20150310	241.1	241.2	240.2	240.5	238.7	238.7	239.45	-2.5	-1.75	38	910.08	66
	20150311	238.7	239.45	240.2	240.2	239.1	239.1	239.8	-.35	.35	18	431.67	64
	20150312	239.1	239.8	237.65	239.4	237.55	239.4	237.95	-.4	-1.85	10	237.99	66
	20150313	239.4	237.95	240.2	240.2	240.2	240.2	240.2	2.25	2.25	2	48.04	64
	20150316	240.2	240.2	238.8	238.8	238.45	238.45	238.6	-1.75	-1.6	4	95.45	64
	20150317	238.45	238.6				238.6	238.6	0	0	0	0.00	64
	20150318	238.6	238.6				238.6	238.6	0	0	0	0.00	64
	20150319	238.6	238.6				238.6	238.6	0	0	0	0.00	64
	20150320	238.6	238.6	239.6	240.55	239.6	240.55	240.2	1.95	1.6	6	144.14	66
	20150323	240.55	240.2	240.9	242.75	240.85	242.25	241.7	2.05	1.5	18	435.06	72
	20150324	242.25	241.7				241.7	241.7	0	0	0	0.00	72
	20150325	241.7	241.7	243.55	243.55	242.2	242.3	242.75	.6	1.05	14	339.87	72
	20150326	242.3	242.75	243.6	243.6	243.4	243.45	243.45	.7	.7	20	486.92	72
	20150327	243.45	243.45	244.7	244.7	243.45	243.45	243.85	0	.4	6	146.32	72
	20150330	243.45	243.85				243.85	243.85	0	0	0	0.00	72
	20150331	243.85	243.85	239.4	239.4	239.4	239.4	239.4	-4.45	-4.45	2	47.88	70
	20150401	239.4	239.4	239.45	239.9	239.1	239.75	239.45	.35	.05	10	239.46	74
	20150402	239.75	239.45	240.9	243.8	240.8	243.8	242.55	4.35	3.1	32	776.21	70
	20150403	243.8	242.55	242.05	242.05	242.05	242.05	242.05	-.5	-.5	2	48.41	70
	20150407	242.05	242.05	245.05	245.1	244.75	244.75	244.95	2.7	2.9	6	146.98	66
	20150408	244.75	244.95	244.9	244.9	244.9	244.9	244.9	-.05	-.05	4	97.96	62
	20150409	244.9	244.9	242	244.75	239	241.95	241.45	-2.95	-3.45	1062	25,646.73	88
	20150410	241.95	241.45	241.05	241.05	241.05	241.05	241.05	-.4	-.4	6	144.63	82
	20150413	241.05	241.05				241.05	241.05	0	0	0	0.00	82
	20150414	241.05	241.05	241.8	244.2	241.2	241.2	242.85	.15	1.8	202	4,906.45	84
	20150415	241.2	242.85	242.35	242.35	241	241.1	242.05	-1.75	-.8	68	1,646.04	84
	20150416	241.1	242.05	241.35	243.7	241.15	242.55	242.4	.5	.35	30	727.25	78
	20150417	242.55	242.4	241.85	242.05	241.55	241.9	241.8	-.5	-.6	12	290.18	76
	20150420	241.9	241.8	243	243	242.3	242.3	242.65	.5	.85	4	97.06	72
	20150421	242.3	242.65				241.5	241.5	-1.15	-1.15	0	0.00	72
	20150422	241.5	241.5	241.75	241.9	241.7	241.9	241.8	.4	.3	20	483.64	74
	20150423	241.9	241.8	239	239.2	238.6	238.6	238.9	-3.2	-2.9	10	238.94	68
	20150424	238.6	238.9	239.7	241.15	239.6	241.15	240.4	2.25	1.5	52	1,250.17	92
	20150427	241.15	240.4	238.85	239.65	237.3	238.95	238.55	-1.45	-1.85	108	2,576.47	86
	20150428	238.95	238.55	241.8	244.35	241.35	242.8	242.5	4.25	3.95	46	1,115.61	86
	20150429	242.8	242.5	244.8	245.6	243.5	244.25	244.4	1.75	1.9	48	1,173.35	80
	20150430	244.25	244.4	244.25	244.25	243	243.45	243.75	-.95	-.65	34	828.86	82
au1512	20150116	247.8	247.8	254.1	254.85	253.85	254.85	254.2	7.05	6.4	52	1,321.88	42
	20150119	254.85	254.2	256	258.8	256	258.8	257.85	4.6	3.65	40	1,031.46	52
	20150120	258.8	257.85	258.85	259.7	257.5	258.5	258.65	.65	.8	106	2,742.04	112
	20150121	258.5	258.65	261.55	264.25	260.5	263.55	262.6	4.9	3.95	2076	54,522.45	1608
	20150122	263.55	262.6	260.75	264.3	260	260.55	263.1	-2.05	.5	2702	71,099.28	3278
	20150123	260.55	263.1	262.15	264.05	258.45	262.8	262.9	-.3	-.2	2456	64,570.14	4472
	20150126	262.8	262.9	263.1	264.1	261.25	263.35	263.65	.45	.75	1572	41,450.35	5524
	20150127	263.35	263.65	261.85	262.25	260.15	261.5	260.95	-2.15	-2.7	584	15,240.11	5596
	20150128	261.5	260.95	261.6	263.25	260.7	262.65	262.3	1.7	1.35	510	13,377.75	5794
	20150129	262.65	262.3	261.95	262.25	260.3	261	260.85	-1.3	-1.45	556	14,505.21	5958
	20150130	261	260.85	258.5	259.2	255.05	256.15	256.35	-4.7	-4.5	4618	118,400.37	5526
	20150202	256.15	256.35	256.15	261.4	255.1	260.7	258.95	4.35	2.6	1330	34,442.18	5936
	20150203	260.7	258.95	259.75	260.9	258.2	260.65	259.75	1.7	.8	1382	35,903.16	6536
	20150204	260.65	259.75	258.8	259.65	256.2	258.05	257.45	-1.7	-2.3	2240	57,671.83	7540
	20150205	258.05	257.45	258.8	259.7	257.2	258.9	258.6	1.45	1.15	1182	30,568.45	7610
	20150206	258.9	258.6	257.85	258.3	256.7	258.3	257.65	-.3	-.95	820	21,127.85	7666
	20150209	258.3	257.65	258.45	260.55	251.5	253.25	253.6	-4.4	-4.05	4200	106,532.88	9804
	20150210	253.25	253.6	253.15	254.1	252.7	253.85	253.65	.25	.05	1132	28,715.73	10102
	20150211	253.85	253.65	253.05	253.05	251.9	252.5	252.6	-1.15	-1.05	610	15,409.06	10234
	20150212	252.5	252.6	251.9	252.15	249.2	249.65	249.8	-2.95	-2.8	1742	43,519.91	11210
	20150213	249.65	249.8	250	251.45	249.45	251.4	250.5	1.6	.7	754	18,889.33	11392
	20150216	251.4	250.5	250.85	252.5	250.8	252	251.3	1.5	.8	2238	56,243.38	12328
	20150217	252	251.3	251.9	252.25	251	251.15	251.7	-.15	.4	1496	37,654.89	13142
	20150225	251.15	251.7	248.9	248.9	247.6	247.95	247.9	-3.75	-3.8	1128	27,965.13	13528
	20150226	247.95	247.9	247.7	248.4	246.4	248.1	247.5	.2	-.4	1982	49,057.05	14264
	20150227	248.1	247.5	249.3	249.55	247.3	248.6	248.45	1.1	.95	3604	89,546.03	16018
	20150302	248.6	248.45	248.55	251.5	248.3	251.15	250.5	2.7	2.05	1388	34,771.13	16084
	20150303	251.15	250.5	250.55	250.7	245.65	249.2	248.6	-1.3	-1.9	5986	148,832.25	16574
	20150304	249.2	248.6	249.45	250.2	247.8	248.6	248.7	0	.1	2476	61,583.14	16970
	20150305	248.6	248.7	248	248.7	247.05	247.75	248	-.95	-.7	1786	44,301.20	17374
	20150306	247.75	248	247.55	248.85	246.5	246.9	247.2	-1.1	-.8	3118	77,079.18	18136
	20150309	246.9	247.2	246.9	246.9	240.4	241.85	242.05	-5.35	-5.15	7436	179,998.13	21708
	20150310	241.85	242.05	241.75	242.1	239	239.5	240.55	-2.55	-1.5	5494	132,171.75	22732
	20150311	239.5	240.55	241.35	241.55	239.35	240.15	240.3	-.4	-.25	4622	111,083.72	24744
	20150312	240.15	240.3	239.6	240.85	236.6	240.65	238.8	.35	-1.5	6496	155,139.13	25988
	20150313	240.65	238.8	239.15	240	237.95	239.5	239.4	.7	.6	3866	92,556.49	27450
	20150316	239.5	239.4	239.5	240.4	238.15	240.1	239.4	.7	0	3624	86,768.73	28400
	20150317	240.1	239.4	238.6	239.4	237.85	238.5	238.35	-.9	-1.05	2518	60,026.99	29172
	20150318	238.5	238.35	236.95	248.2	235.05	235.9	236.85	-2.45	-1.5	6724	159,267.39	29412
	20150319	235.9	236.85	235.65	241.5	235.65	239.75	238.9	2.9	2.05	4244	101,406.29	29730
	20150320	239.75	238.9	238.1	240.05	237.55	239.45	238.85	.55	-.05	3726	89,007.36	30536
	20150323	239.45	238.85	239.15	243.1	239.15	242.3	241.8	3.45	2.95	5292	127,975.23	31898
	20150324	242.3	241.8	242.75	244.3	242.1	242.9	243.15	1.1	1.35	9998	243,115.23	31004
	20150325	242.9	243.15	243.7	244.35	242.55	243.2	243.25	.05	.1	3556	86,514.59	31370
	20150326	243.2	243.25	244.65	245.9	244	245.9	244.95	2.65	1.7	8334	204,169.06	30520
	20150327	245.9	244.95	245.55	246.2	244.7	244.9	245.25	-.05	.3	9982	244,822.61	29712
	20150330	244.9	245.25	244.5	244.75	241.95	242	243.3	-3.25	-1.95	6648	161,754.82	30190
	20150331	242	243.3	241.4	241.4	239.8	239.8	240.65	-3.5	-2.65	5190	124,917.25	30712
	20150401	239.8	240.65	240.5	241.75	239.75	240.5	240.75	-.15	.1	5518	132,869.50	31948
	20150402	240.5	240.75	241.5	245.4	241.5	245.2	243.75	4.45	3	10262	250,175.56	34154
	20150403	245.2	243.75	244.45	244.85	242.7	244.2	243.8	.45	.05	7232	176,326.92	36338
	20150407	244.2	243.8	246	246.55	245.75	246.3	246.2	2.5	2.4	5076	124,972.79	37552
	20150408	246.3	246.2	246.3	246.55	245.2	246.4	246	.2	-.2	6858	168,726.28	40272
	20150409	246.4	246	246.2	246.3	242.3	242.95	243.75	-3.05	-2.25	6674	162,694.94	40932
	20150410	242.95	243.75	242.2	243.6	242.05	242.4	242.55	-1.35	-1.2	6692	162,316.29	40468
	20150413	242.4	242.55	244.3	245.95	244.3	245.4	245.25	2.85	2.7	11008	269,993.66	41896
	20150414	245.4	245.25	245.5	245.55	241.65	242.55	243.8	-2.7	-1.45	10842	264,337.27	41998
	20150415	242.55	243.8	241.35	243.9	241.35	242.45	242.75	-1.35	-1.05	12742	309,317.95	42774
	20150416	242.45	242.75	242.45	244.95	242.2	244.4	243.95	1.65	1.2	12694	309,699.65	43682
	20150417	244.4	243.95	244.6	244.75	242.45	243.25	243.4	-.7	-.55	12368	301,060.43	45512
	20150420	243.25	243.4	243.55	245.4	243.5	245.3	244.3	1.9	.9	12482	304,956.07	46570
	20150421	245.3	244.3	243	243.65	242.05	242.4	242.65	-1.9	-1.65	10942	265,558.86	48070
	20150422	242.4	242.65	243.6	244.95	242.6	243.8	243.6	1.15	.95	10486	255,474.20	48116
	20150423	243.8	243.6	243	243.1	239.4	239.8	240.45	-3.8	-3.15	20800	500,188.59	51392
	20150424	239.8	240.45	239.65	242.05	239.65	241.5	241.1	1.05	.65	15428	372,005.86	54326
	20150427	241.5	241.1	240.4	240.8	238.35	239.5	239.4	-1.6	-1.7	24668	590,646.15	61740
	20150428	239.5	239.4	240.6	246.5	240.45	244.3	244.35	4.9	4.95	50506	1,234,264.41	64816
	20150429	244.3	244.35	245.25	247.1	244.35	245.5	245.95	1.15	1.6	34308	843,814.39	73664
	20150430	245.5	245.95	245.35	246.5	243.85	244.4	244.95	-1.55	-1	35392	867,100.18	83174
au1602	20150317	239.4	239.4				239.4	239.4	0	0	0	0.00	0
	20150318	239.4	239.4	235.85	235.85	235.85	235.85	235.85	-3.55	-3.55	2	47.17	2
	20150319	235.85	235.85				238.7	238.7	2.85	2.85	0	0.00	2
	20150320	238.7	238.7	239.55	240.65	238.05	239.85	239.95	1.15	1.25	16	383.95	14
	20150323	239.85	239.95	243.4	243.4	243.4	243.4	243.4	3.45	3.45	2	48.68	16
	20150324	243.4	243.4	244.35	244.35	243.9	243.9	244.1	.5	.7	4	97.65	16
	20150325	243.9	244.1				244.2	244.2	.1	.1	0	0.00	16
	20150326	244.2	244.2	246.95	246.95	244.9	246.05	245.95	1.85	1.75	6	147.58	16
	20150327	246.05	245.95				245.95	245.95	0	0	0	0.00	16
	20150330	245.95	245.95				244	244	-1.95	-1.95	0	0.00	16
	20150331	244	244	241.55	241.55	240.95	240.95	241.25	-3.05	-2.75	4	96.50	16
	20150401	240.95	241.25	242.35	242.35	242.35	242.35	242.35	1.1	1.1	2	48.47	18
	20150402	242.35	242.35	245	245	245	245	245	2.65	2.65	2	49.00	16
	20150403	245	245	243.05	243.05	243.05	243.05	243.05	-1.95	-1.95	2	48.61	18
	20150407	243.05	243.05	247.3	247.3	247.3	247.3	247.3	4.25	4.25	2	49.46	16
	20150408	247.3	247.3	247.35	247.35	247.35	247.35	247.35	.05	.05	4	98.94	16
	20150409	247.35	247.35	245.6	248.95	242.85	244.8	245.35	-2.55	-2	22	539.80	26
	20150410	244.8	245.35	244.05	245.65	244.05	244.55	245.05	-.8	-.3	58	1,421.39	62
	20150413	244.55	245.05	247.75	248.8	247.75	247.95	248.4	2.9	3.35	20	496.86	72
	20150414	247.95	248.4	246.95	246.95	244.25	244.8	245.5	-3.6	-2.9	40	982.12	44
	20150415	244.8	245.5	247.45	247.45	243.5	243.75	246.15	-1.75	.65	12	295.41	54
	20150416	243.75	246.15	244.4	247.4	244.4	245.2	245.8	-.95	-.35	12	295.00	52
	20150417	245.2	245.8	244.75	244.75	243.95	244.65	244.5	-1.15	-1.3	8	195.60	52
	20150420	244.65	244.5	246.15	246.15	246.15	246.15	246.15	1.65	1.65	4	98.46	56
	20150421	246.15	246.15	244.95	244.95	244.95	244.95	244.95	-1.2	-1.2	2	48.99	56
	20150422	244.95	244.95	246.3	246.3	244.4	244.45	245	-.5	.05	8	196.03	54
	20150423	244.45	245				241.85	241.85	-3.15	-3.15	0	0.00	54
	20150424	241.85	241.85	243.05	243.05	243.05	243.05	243.05	1.2	1.2	2	48.61	54
	20150427	243.05	243.05	241.85	241.85	241	241.75	241.5	-1.3	-1.55	20	483.08	66
	20150428	241.75	241.5	247.05	247.1	245.35	245.55	246.65	4.05	5.15	16	394.65	70
	20150429	245.55	246.65	246.05	247.5	246.05	246.85	247.2	.2	.55	32	791.11	60
	20150430	246.85	247.2	247.15	247.15	245.55	245.55	246.35	-1.65	-.85	6	147.81	58
au1604	20150416	246.15	246.15	243.7	243.7	243.7	243.7	243.7	-2.45	-2.45	16	389.92	16
	20150417	243.7	243.7	244.45	244.45	244.45	244.45	244.45	.75	.75	2	48.89	18
	20150420	244.45	244.45				246.05	246.05	1.6	1.6	0	0.00	18
	20150421	246.05	246.05	243.65	244.15	243.65	244.15	243.95	-1.9	-2.1	6	146.39	22
	20150422	244.15	243.95				243.95	243.95	0	0	0	0.00	22
	20150423	243.95	243.95	243.05	243.05	241.5	241.5	242.25	-2.45	-1.7	4	96.91	24
	20150424	241.5	242.25	242.6	242.7	242.6	242.7	242.65	.45	.4	4	97.06	24
	20150427	242.7	242.65	242.1	242.1	240.15	241.75	241	-.9	-1.65	14	337.44	34
	20150428	241.75	241	243.2	246	241.95	245	243.7	4	2.7	14	341.20	34
	20150429	245	243.7	245.8	249	245.8	246.8	247	3.1	3.3	24	592.86	34
	20150430	246.8	247	247.35	247.35	243.35	246.4	246.3	-.6	-.7	18	443.36	36
bu1501	20150105	3528	3528	3520	3520	3518	3518	3518	-10	-10	4	14.08	10
	20150106	3518	3518				3518	3518	0	0	0	0.00	10
	20150107	3518	3518				3518	3518	0	0	0	0.00	10
	20150108	3518	3518				3518	3518	0	0	0	0.00	10
	20150109	3518	3518	3478	3692	3478	3692	3584	174	66	4	14.34	8
	20150112	3692	3584	3692	3692	3692	3692	3692	108	108	8	29.54	0
	20150113	3692	3692				3692	3692	0	0	0	0.00	0
	20150114	3692	3692				3692	3692	0	0	0	0.00	0
	20150115	3692	3692				3692	3692	0	0	0	0.00	0
bu1502	20150105	3484	3484				3474	3474	-10	-10	0	0.00	0
	20150106	3474	3474				3474	3474	0	0	0	0.00	0
	20150107	3474	3474				3474	3474	0	0	0	0.00	0
	20150108	3474	3474				3474	3474	0	0	0	0.00	0
	20150109	3474	3474				3540	3540	66	66	0	0.00	0
	20150112	3540	3540				3646	3646	106	106	0	0.00	0
	20150113	3646	3646				3646	3646	0	0	0	0.00	0
	20150114	3646	3646				3646	3646	0	0	0	0.00	0
	20150115	3646	3646				3646	3646	0	0	0	0.00	0
	20150116	3646	3646				3646	3646	0	0	0	0.00	0
	20150119	3646	3646				3646	3646	0	0	0	0.00	0
	20150120	3646	3646				3646	3646	0	0	0	0.00	0
	20150121	3646	3646				3646	3646	0	0	0	0.00	0
	20150122	3646	3646				3646	3646	0	0	0	0.00	0
	20150123	3646	3646				3646	3646	0	0	0	0.00	0
	20150126	3646	3646				3646	3646	0	0	0	0.00	0
	20150127	3646	3646				3646	3646	0	0	0	0.00	0
	20150128	3646	3646				3646	3646	0	0	0	0.00	0
	20150129	3646	3646				3646	3646	0	0	0	0.00	0
	20150130	3646	3646				3646	3646	0	0	0	0.00	0
	20150202	3646	3646				3646	3646	0	0	0	0.00	0
	20150203	3646	3646				3646	3646	0	0	0	0.00	0
	20150204	3646	3646				3646	3646	0	0	0	0.00	0
	20150205	3646	3646				3646	3646	0	0	0	0.00	0
	20150206	3646	3646				3646	3646	0	0	0	0.00	0
	20150209	3646	3646				3646	3646	0	0	0	0.00	0
	20150210	3646	3646				3646	3646	0	0	0	0.00	0
bu1503	20150105	3450	3450				3450	3450	0	0	0	0.00	20
	20150106	3450	3450				3450	3450	0	0	0	0.00	20
	20150107	3450	3450				3450	3450	0	0	0	0.00	20
	20150108	3450	3450				3450	3450	0	0	0	0.00	20
	20150109	3450	3450				3450	3450	0	0	0	0.00	20
	20150112	3450	3450				3450	3450	0	0	0	0.00	20
	20150113	3450	3450				3450	3450	0	0	0	0.00	20
	20150114	3450	3450	3276	3276	3276	3276	3276	-174	-174	4	13.10	20
	20150115	3276	3276				3276	3276	0	0	0	0.00	20
	20150116	3276	3276	3150	3424	3112	3270	3256	-6	-20	14	45.60	20
	20150119	3270	3256	3358	3358	3100	3350	3282	94	26	14	45.96	20
	20150120	3350	3282				3282	3282	0	0	0	0.00	20
	20150121	3282	3282	3280	3280	3120	3120	3200	-162	-82	4	12.80	20
	20150122	3120	3200	3350	3350	3040	3040	3092	-160	-108	34	105.14	30
	20150123	3040	3092	2846	2948	2844	2870	2856	-222	-236	28	79.98	46
	20150126	2870	2856	2776	2840	2712	2712	2760	-144	-96	26	71.76	48
	20150127	2712	2760	2630	2716	2630	2716	2686	-44	-74	6	16.12	48
	20150128	2716	2686	2686	2708	2632	2632	2686	-54	0	24	64.46	34
	20150129	2632	2686				2680	2680	-6	-6	0	0.00	34
	20150130	2680	2680	2630	2630	2630	2630	2630	-50	-50	2	5.26	34
	20150202	2630	2630				2630	2630	0	0	0	0.00	34
	20150203	2630	2630	2738	2738	2738	2738	2738	108	108	2	5.48	32
	20150204	2738	2738	2738	2738	2738	2738	2738	0	0	2	5.48	30
	20150205	2738	2738	2738	2874	2738	2874	2828	136	90	32	90.55	12
	20150206	2874	2828				2830	2830	2	2	0	0.00	12
	20150209	2830	2830				2830	2830	0	0	0	0.00	12
	20150210	2830	2830				2830	2830	0	0	0	0.00	12
	20150211	2830	2830	2830	2830	2830	2830	2830	0	0	6	16.98	6
	20150212	2830	2830				2830	2830	0	0	0	0.00	6
	20150213	2830	2830	2830	2830	2830	2830	2830	0	0	2	5.66	4
	20150216	2830	2830	2830	2830	2830	2830	2830	0	0	2	5.66	2
	20150217	2830	2830	2700	2700	2638	2638	2668	-192	-162	4	10.68	2
	20150225	2638	2668				2668	2668	0	0	0	0.00	2
	20150226	2668	2668				2668	2668	0	0	0	0.00	2
	20150227	2668	2668	2550	2550	2550	2550	2550	-118	-118	2	5.10	0
	20150302	2550	2550				2550	2550	0	0	0	0.00	0
	20150303	2550	2550				2550	2550	0	0	0	0.00	0
	20150304	2550	2550				2550	2550	0	0	0	0.00	0
	20150305	2550	2550				2550	2550	0	0	0	0.00	0
	20150306	2550	2550				2550	2550	0	0	0	0.00	0
	20150309	2550	2550				2550	2550	0	0	0	0.00	0
	20150310	2550	2550				2550	2550	0	0	0	0.00	0
	20150311	2550	2550				2550	2550	0	0	0	0.00	0
	20150312	2550	2550				2550	2550	0	0	0	0.00	0
	20150313	2550	2550				2550	2550	0	0	0	0.00	0
	20150316	2550	2550				2550	2550	0	0	0	0.00	0
bu1504	20150105	3044	3044				3036	3036	-8	-8	0	0.00	0
	20150106	3036	3036				3036	3036	0	0	0	0.00	0
	20150107	3036	3036	3178	3178	3178	3178	3178	142	142	2	6.36	2
	20150108	3178	3178				3178	3178	0	0	0	0.00	2
	20150109	3178	3178				3238	3238	60	60	0	0.00	2
	20150112	3238	3238	3396	3396	3396	3396	3396	158	158	2	6.79	0
	20150113	3396	3396				3396	3396	0	0	0	0.00	0
	20150114	3396	3396				3226	3226	-170	-170	0	0.00	0
	20150115	3226	3226				3226	3226	0	0	0	0.00	0
	20150116	3226	3226				3206	3206	-20	-20	0	0.00	0
	20150119	3206	3206				3232	3232	26	26	0	0.00	0
	20150120	3232	3232				3232	3232	0	0	0	0.00	0
	20150121	3232	3232				3150	3150	-82	-82	0	0.00	0
	20150122	3150	3150				3044	3044	-106	-106	0	0.00	0
	20150123	3044	3044				2890	2890	-154	-154	0	0.00	0
	20150126	2890	2890				2792	2792	-98	-98	0	0.00	0
	20150127	2792	2792				2716	2716	-76	-76	0	0.00	0
	20150128	2716	2716				2716	2716	0	0	0	0.00	0
	20150129	2716	2716				2716	2716	0	0	0	0.00	0
	20150130	2716	2716				2664	2664	-52	-52	0	0.00	0
	20150202	2664	2664				2664	2664	0	0	0	0.00	0
	20150203	2664	2664				2772	2772	108	108	0	0.00	0
	20150204	2772	2772				2772	2772	0	0	0	0.00	0
	20150205	2772	2772				2864	2864	92	92	0	0.00	0
	20150206	2864	2864				2864	2864	0	0	0	0.00	0
	20150209	2864	2864				2864	2864	0	0	0	0.00	0
	20150210	2864	2864				2864	2864	0	0	0	0.00	0
	20150211	2864	2864				2864	2864	0	0	0	0.00	0
	20150212	2864	2864				2864	2864	0	0	0	0.00	0
	20150213	2864	2864				2864	2864	0	0	0	0.00	0
	20150216	2864	2864				2864	2864	0	0	0	0.00	0
	20150217	2864	2864				2700	2700	-164	-164	0	0.00	0
	20150225	2700	2700				2700	2700	0	0	0	0.00	0
	20150226	2700	2700				2700	2700	0	0	0	0.00	0
	20150227	2700	2700				2580	2580	-120	-120	0	0.00	0
	20150302	2580	2580				2580	2580	0	0	0	0.00	0
	20150303	2580	2580				2580	2580	0	0	0	0.00	0
	20150304	2580	2580				2580	2580	0	0	0	0.00	0
	20150305	2580	2580				2580	2580	0	0	0	0.00	0
	20150306	2580	2580				2580	2580	0	0	0	0.00	0
	20150309	2580	2580				2580	2580	0	0	0	0.00	0
	20150310	2580	2580				2580	2580	0	0	0	0.00	0
	20150311	2580	2580				2580	2580	0	0	0	0.00	0
	20150312	2580	2580				2580	2580	0	0	0	0.00	0
	20150313	2580	2580				2580	2580	0	0	0	0.00	0
	20150316	2580	2580				2580	2580	0	0	0	0.00	0
	20150317	2580	2580				2580	2580	0	0	0	0.00	0
	20150318	2580	2580				2580	2580	0	0	0	0.00	0
	20150319	2580	2580				2580	2580	0	0	0	0.00	0
	20150320	2580	2580				2580	2580	0	0	0	0.00	0
	20150323	2580	2580				2580	2580	0	0	0	0.00	0
	20150324	2580	2580				2580	2580	0	0	0	0.00	0
	20150325	2580	2580				2580	2580	0	0	0	0.00	0
	20150326	2580	2580				2580	2580	0	0	0	0.00	0
	20150327	2580	2580				2580	2580	0	0	0	0.00	0
	20150330	2580	2580				2580	2580	0	0	0	0.00	0
	20150331	2580	2580				2580	2580	0	0	0	0.00	0
	20150401	2580	2580				2580	2580	0	0	0	0.00	0
	20150402	2580	2580				2580	2580	0	0	0	0.00	0
	20150403	2580	2580				2580	2580	0	0	0	0.00	0
	20150407	2580	2580				2580	2580	0	0	0	0.00	0
	20150408	2580	2580				2580	2580	0	0	0	0.00	0
	20150409	2580	2580				2580	2580	0	0	0	0.00	0
	20150410	2580	2580	2592	2708	2592	2708	2650	128	70	4	10.60	2
	20150413	2708	2650	2782	2782	2782	2782	2782	132	132	2	5.56	0
	20150414	2782	2782				2782	2782	0	0	0	0.00	0
	20150415	2782	2782				2782	2782	0	0	0	0.00	0
bu1505	20150105	3044	3044				3036	3036	-8	-8	0	0.00	0
	20150106	3036	3036				3036	3036	0	0	0	0.00	0
	20150107	3036	3036				3178	3178	142	142	0	0.00	0
	20150108	3178	3178				3178	3178	0	0	0	0.00	0
	20150109	3178	3178				3238	3238	60	60	0	0.00	0
	20150112	3238	3238				3238	3238	0	0	0	0.00	0
	20150113	3238	3238				3238	3238	0	0	0	0.00	0
	20150114	3238	3238				3074	3074	-164	-164	0	0.00	0
	20150115	3074	3074				3074	3074	0	0	0	0.00	0
	20150116	3074	3074				3056	3056	-18	-18	0	0.00	0
	20150119	3056	3056	3360	3360	2822	2822	3090	-234	34	4	12.36	0
	20150120	2822	3090				3090	3090	0	0	0	0.00	0
	20150121	3090	3090				3012	3012	-78	-78	0	0.00	0
	20150122	3012	3012				2910	2910	-102	-102	0	0.00	0
	20150123	2910	2910				2764	2764	-146	-146	0	0.00	0
	20150126	2764	2764				2670	2670	-94	-94	0	0.00	0
	20150127	2670	2670	2536	2536	2536	2536	2536	-134	-134	2	5.07	2
	20150128	2536	2536				2662	2662	126	126	0	0.00	2
	20150129	2662	2662	2540	2790	2540	2790	2690	128	28	8	21.52	2
	20150130	2790	2690				2690	2690	0	0	0	0.00	2
	20150202	2690	2690	2680	2680	2680	2680	2680	-10	-10	2	5.36	0
	20150203	2680	2680				2790	2790	110	110	0	0.00	0
	20150204	2790	2790				2790	2790	0	0	0	0.00	0
	20150205	2790	2790	2680	2850	2680	2850	2764	60	-26	4	11.06	0
	20150206	2850	2764				2764	2764	0	0	0	0.00	0
	20150209	2764	2764				2764	2764	0	0	0	0.00	0
	20150210	2764	2764				2764	2764	0	0	0	0.00	0
	20150211	2764	2764				2764	2764	0	0	0	0.00	0
	20150212	2764	2764				2764	2764	0	0	0	0.00	0
	20150213	2764	2764				2764	2764	0	0	0	0.00	0
	20150216	2764	2764				2764	2764	0	0	0	0.00	0
	20150217	2764	2764				2606	2606	-158	-158	0	0.00	0
	20150225	2606	2606				2606	2606	0	0	0	0.00	0
	20150226	2606	2606	2608	2736	2608	2736	2646	130	40	8	21.18	6
	20150227	2736	2646				2730	2730	84	84	0	0.00	6
	20150302	2730	2730	2866	2866	2866	2866	2866	136	136	2	5.73	6
	20150303	2866	2866				2866	2866	0	0	0	0.00	6
	20150304	2866	2866	2848	3000	2848	3000	2932	134	66	14	41.05	8
	20150305	3000	2932	3060	3060	2832	3048	2958	116	26	22	65.08	6
	20150306	3048	2958	3040	3040	2860	2882	2926	-76	-32	6	17.56	6
	20150309	2882	2926	3050	3050	2856	2936	2932	10	6	10	29.32	4
	20150310	2936	2932	2866	3020	2854	3020	2890	88	-42	20	57.80	6
	20150311	3020	2890	2900	2900	2900	2900	2900	10	10	2	5.80	4
	20150312	2900	2900	2902	2998	2798	2946	2896	46	-4	34	98.48	8
	20150313	2946	2896	3028	3028	2990	2990	3018	94	122	18	54.35	22
	20150316	2990	3018	2930	2930	2866	2912	2918	-106	-100	22	64.22	10
	20150317	2912	2918				2880	2880	-38	-38	0	0.00	10
	20150318	2880	2880				2880	2880	0	0	0	0.00	10
	20150319	2880	2880				2880	2880	0	0	0	0.00	10
	20150320	2880	2880	2948	2948	2908	2914	2922	34	42	6	17.54	10
	20150323	2914	2922	2986	2986	2986	2986	2986	64	64	2	5.97	10
	20150324	2986	2986	3030	3030	3030	3030	3030	44	44	2	6.06	10
	20150325	3030	3030				3030	3030	0	0	0	0.00	10
	20150326	3030	3030	3178	3178	2950	3098	3080	68	50	26	80.09	14
	20150327	3098	3080	3074	3080	3074	3080	3078	0	-2	14	43.11	0
	20150330	3080	3078				3078	3078	0	0	0	0.00	0
	20150331	3078	3078				3078	3078	0	0	0	0.00	0
	20150401	3078	3078				3078	3078	0	0	0	0.00	0
	20150402	3078	3078				3078	3078	0	0	0	0.00	0
	20150403	3078	3078				3078	3078	0	0	0	0.00	0
	20150407	3078	3078				3078	3078	0	0	0	0.00	0
	20150408	3078	3078				3078	3078	0	0	0	0.00	0
	20150409	3078	3078				3078	3078	0	0	0	0.00	0
	20150410	3078	3078				3160	3160	82	82	0	0.00	0
	20150413	3160	3160	3118	3318	3118	3318	3308	158	148	168	555.89	4
	20150414	3318	3308	3302	3570	3302	3450	3414	142	106	28	95.64	6
	20150415	3450	3414	3548	3580	3452	3452	3490	38	76	14	48.88	2
	20150416	3452	3490	3646	3646	3450	3450	3548	-40	58	4	14.19	4
	20150417	3450	3548	3458	3558	3370	3436	3464	-112	-84	52	180.22	2
	20150420	3436	3464	3458	3458	3458	3458	3458	-6	-6	2	6.92	2
	20150421	3458	3458				3446	3446	-12	-12	0	0.00	2
	20150422	3446	3446				3446	3446	0	0	0	0.00	2
	20150423	3446	3446				3446	3446	0	0	0	0.00	2
	20150424	3446	3446	3590	3590	3278	3286	3432	-160	-14	44	151.09	2
	20150427	3286	3432	3260	3260	3260	3260	3260	-172	-172	2	6.52	2
	20150428	3260	3260				3260	3260	0	0	0	0.00	2
	20150429	3260	3260				3260	3260	0	0	0	0.00	2
	20150430	3260	3260				3260	3260	0	0	0	0.00	2
bu1506	20150105	3508	3516	3498	3500	3480	3480	3492	-36	-24	30	104.78	88
	20150106	3480	3492	3480	3666	3428	3472	3540	-20	48	318	1,126.06	284
	20150107	3472	3540	3472	3500	3430	3450	3484	-90	-56	118	411.26	370
	20150108	3450	3484	3486	3546	3370	3406	3414	-78	-70	304	1,038.46	548
	20150109	3406	3414	3390	3390	3242	3242	3266	-172	-148	466	1,522.30	578
	20150112	3242	3266	3222	3238	3044	3082	3108	-184	-158	1670	5,191.42	1182
	20150113	3082	3108	3000	3088	2952	2952	2988	-156	-120	2118	6,329.55	1598
	20150114	2952	2988	2952	3030	2822	2922	2910	-66	-78	8432	24,542.35	2448
	20150115	2922	2910	2930	3018	2844	2956	2924	46	14	10706	31,315.44	2884
	20150116	2956	2924	2986	3040	2936	2960	2980	36	56	6758	20,147.96	2970
	20150119	2960	2980	2960	2986	2880	2888	2924	-92	-56	7322	21,421.52	4148
	20150120	2888	2924	2890	2908	2868	2886	2888	-38	-36	5300	15,310.92	4320
	20150121	2886	2888	2902	2904	2832	2848	2862	-40	-26	7654	21,919.40	4738
	20150122	2848	2862	2850	2900	2848	2880	2878	18	16	6750	19,437.42	4946
	20150123	2880	2878	2890	2896	2856	2862	2872	-16	-6	4420	12,702.16	5352
	20150126	2862	2872	2862	2862	2742	2746	2806	-126	-66	8368	23,483.58	6318
	20150127	2746	2806	2768	2796	2750	2768	2774	-38	-32	7556	20,970.20	6268
	20150128	2768	2774	2770	2824	2768	2788	2786	14	12	5716	15,929.06	5864
	20150129	2788	2786	2788	2796	2768	2780	2778	-6	-8	3776	10,493.57	6320
	20150130	2780	2778	2796	2796	2744	2746	2772	-32	-6	4672	12,956.33	6658
	20150202	2746	2772	2758	2790	2710	2770	2754	-2	-18	9582	26,391.77	7156
	20150203	2770	2754	2782	2844	2766	2834	2794	80	40	11408	31,895.34	7740
	20150204	2834	2794	2858	2860	2790	2812	2826	18	32	14940	42,234.19	8918
	20150205	2812	2826	2820	2820	2772	2778	2788	-48	-38	9424	26,279.89	9828
	20150206	2778	2788	2796	2828	2788	2822	2810	34	22	10294	28,944.53	9612
	20150209	2822	2810	2818	2832	2804	2820	2816	10	6	6876	19,369.38	9710
	20150210	2820	2816	2822	2834	2808	2820	2820	4	4	4690	13,230.02	9592
	20150211	2820	2820	2820	2838	2814	2826	2824	6	4	5078	14,345.53	9648
	20150212	2826	2824	2822	2854	2816	2850	2830	26	6	5402	15,294.75	8840
	20150213	2850	2830	2854	2968	2852	2966	2922	136	92	15018	43,883.05	9598
	20150216	2966	2922	2960	3026	2952	2966	2984	44	62	13422	40,070.61	9184
	20150217	2966	2984	2962	2990	2914	2970	2952	-14	-32	9358	27,633.98	8452
	20150225	2970	2952	2930	2936	2778	2926	2896	-26	-56	5942	17,215.31	7564
	20150226	2926	2896	2906	3030	2906	3022	2986	126	90	15340	45,823.37	9372
	20150227	3022	2986	3018	3086	3006	3076	3054	90	68	26444	80,809.94	11328
	20150302	3076	3054	3098	3192	3080	3158	3142	104	88	35480	111,533.68	16664
	20150303	3158	3142	3148	3290	3144	3202	3222	60	80	73918	238,254.92	18068
	20150304	3202	3222	3210	3216	3138	3168	3172	-54	-50	43550	138,206.77	18336
	20150305	3168	3172	3182	3188	3022	3050	3074	-122	-98	65936	202,793.75	18648
	20150306	3050	3074	3054	3130	2994	3002	3076	-72	2	63340	194,939.68	19390
	20150309	3002	3076	3000	3056	2934	3022	2996	-54	-80	95074	285,024.43	19890
	20150310	3022	2996	3000	3048	2964	2982	3008	-14	12	50192	151,047.50	19116
	20150311	2982	3008	2966	2986	2932	2958	2966	-50	-42	34832	103,316.78	20156
	20150312	2958	2966	2960	3030	2960	3024	2996	58	30	40028	119,971.34	20462
	20150313	3024	2996	3030	3066	3014	3050	3040	54	44	46928	142,709.45	21272
	20150316	3050	3040	3032	3036	2946	2992	2994	-48	-46	43882	131,394.48	19096
	20150317	2992	2994	2988	3018	2972	2988	2990	-6	-4	31448	94,079.84	18728
	20150318	2988	2990	2978	3008	2952	2970	2984	-20	-6	26258	78,356.69	19172
	20150319	2970	2984	2958	3044	2948	2994	2992	10	8	34266	102,586.21	19002
	20150320	2994	2992	2980	3016	2980	2992	2996	0	4	21790	65,323.92	18616
	20150323	2992	2996	3004	3110	3004	3094	3048	98	52	52544	160,176.35	23392
	20150324	3094	3048	3116	3164	3068	3120	3124	72	76	66134	206,669.06	23588
	20150325	3120	3124	3140	3162	3072	3090	3116	-34	-8	37034	115,463.06	23936
	20150326	3090	3116	3110	3188	3102	3164	3148	48	32	80856	254,653.88	26804
	20150327	3164	3148	3140	3178	3082	3124	3140	-24	-8	65530	205,825.23	24904
	20150330	3124	3140	3132	3148	3068	3078	3102	-62	-38	46200	143,373.94	23284
	20150331	3078	3102	3090	3134	3074	3084	3106	-18	4	41100	127,702.12	22456
	20150401	3084	3106	3080	3110	3068	3104	3086	-2	-20	32254	99,567.00	21578
	20150402	3104	3086	3094	3240	3094	3240	3198	154	112	103154	329,994.14	30696
	20150403	3240	3198	3236	3358	3204	3278	3292	80	94	209592	690,087.57	31712
	20150407	3278	3292	3322	3398	3320	3366	3358	74	66	59556	199,990.01	32786
	20150408	3366	3358	3360	3392	3258	3328	3332	-30	-26	145332	484,478.49	29932
	20150409	3328	3332	3332	3338	3238	3296	3284	-36	-48	115724	380,125.16	32256
	20150410	3296	3284	3300	3436	3296	3370	3390	86	106	255384	865,849.28	43730
	20150413	3370	3390	3370	3458	3352	3386	3412	-4	22	196110	669,246.96	43760
	20150414	3386	3412	3408	3438	3328	3362	3384	-50	-28	135340	458,255.06	43384
	20150415	3362	3384	3364	3424	3350	3372	3390	-12	6	159762	541,827.08	44390
	20150416	3372	3390	3376	3474	3366	3450	3426	60	36	239586	821,030.99	53528
	20150417	3450	3426	3438	3466	3384	3406	3424	-20	-2	177322	607,283.36	49530
	20150420	3406	3424	3402	3422	3292	3308	3364	-116	-60	171280	576,468.41	51604
	20150421	3308	3364	3288	3304	3200	3218	3244	-146	-120	226852	736,049.39	50730
	20150422	3218	3244	3226	3300	3226	3254	3266	10	22	176018	575,082.62	50064
	20150423	3254	3266	3268	3296	3176	3210	3246	-56	-20	186900	606,905.59	57812
	20150424	3210	3246	3232	3282	3202	3256	3242	10	-4	182228	590,974.36	57850
	20150427	3256	3242	3264	3338	3246	3306	3288	64	46	210646	692,809.24	57812
	20150428	3306	3288	3316	3366	3292	3296	3330	8	42	181048	602,964.40	58128
	20150429	3296	3330	3320	3324	3220	3238	3280	-92	-50	139354	457,120.98	53810
	20150430	3238	3280	3238	3272	3222	3242	3250	-38	-30	123384	401,180.94	55378
bu1507	20150116	2924	2924				2980	2980	56	56	0	0.00	0
	20150119	2980	2980				2924	2924	-56	-56	0	0.00	0
	20150120	2924	2924				2888	2888	-36	-36	0	0.00	0
	20150121	2888	2888				2862	2862	-26	-26	0	0.00	0
	20150122	2862	2862				2878	2878	16	16	0	0.00	0
	20150123	2878	2878				2872	2872	-6	-6	0	0.00	0
	20150126	2872	2872				2806	2806	-66	-66	0	0.00	0
	20150127	2806	2806				2774	2774	-32	-32	0	0.00	0
	20150128	2774	2774				2786	2786	12	12	0	0.00	0
	20150129	2786	2786				2778	2778	-8	-8	0	0.00	0
	20150130	2778	2778				2772	2772	-6	-6	0	0.00	0
	20150202	2772	2772				2772	2772	0	0	0	0.00	0
	20150203	2772	2772				2814	2814	42	42	0	0.00	0
	20150204	2814	2814				2814	2814	0	0	0	0.00	0
	20150205	2814	2814				2814	2814	0	0	0	0.00	0
	20150206	2814	2814				2814	2814	0	0	0	0.00	0
	20150209	2814	2814				2820	2820	6	6	0	0.00	0
	20150210	2820	2820				2824	2824	4	4	0	0.00	0
	20150211	2824	2824				2824	2824	0	0	0	0.00	0
	20150212	2824	2824				2824	2824	0	0	0	0.00	0
	20150213	2824	2824	3098	3106	3060	3106	3090	282	266	8	24.72	2
	20150216	3106	3090				3090	3090	0	0	0	0.00	2
	20150217	3090	3090				3090	3090	0	0	0	0.00	2
	20150225	3090	3090				3090	3090	0	0	0	0.00	2
	20150226	3090	3090	3050	3218	3050	3218	3134	128	44	4	12.54	2
	20150227	3218	3134	3090	3090	3090	3090	3090	-44	-44	2	6.18	0
	20150302	3090	3090				3180	3180	90	90	0	0.00	0
	20150303	3180	3180				3262	3262	82	82	0	0.00	0
	20150304	3262	3262				3262	3262	0	0	0	0.00	0
	20150305	3262	3262				3162	3162	-100	-100	0	0.00	0
	20150306	3162	3162				3164	3164	2	2	0	0.00	0
	20150309	3164	3164				3082	3082	-82	-82	0	0.00	0
	20150310	3082	3082				3094	3094	12	12	0	0.00	0
	20150311	3094	3094				3050	3050	-44	-44	0	0.00	0
	20150312	3050	3050				3050	3050	0	0	0	0.00	0
	20150313	3050	3050				3050	3050	0	0	0	0.00	0
	20150316	3050	3050				3004	3004	-46	-46	0	0.00	0
	20150317	3004	3004				3000	3000	-4	-4	0	0.00	0
	20150318	3000	3000				3000	3000	0	0	0	0.00	0
	20150319	3000	3000				3008	3008	8	8	0	0.00	0
	20150320	3008	3008				3012	3012	4	4	0	0.00	0
	20150323	3012	3012				3064	3064	52	52	0	0.00	0
	20150324	3064	3064				3140	3140	76	76	0	0.00	0
	20150325	3140	3140				3132	3132	-8	-8	0	0.00	0
	20150326	3132	3132				3164	3164	32	32	0	0.00	0
	20150327	3164	3164				3164	3164	0	0	0	0.00	0
	20150330	3164	3164				3164	3164	0	0	0	0.00	0
	20150331	3164	3164				3168	3168	4	4	0	0.00	0
	20150401	3168	3168				3148	3148	-20	-20	0	0.00	0
	20150402	3148	3148	3136	3246	3136	3226	3200	78	52	8	25.61	0
	20150403	3226	3200				3294	3294	94	94	0	0.00	0
	20150407	3294	3294				3360	3360	66	66	0	0.00	0
	20150408	3360	3360				3360	3360	0	0	0	0.00	0
	20150409	3360	3360				3360	3360	0	0	0	0.00	0
	20150410	3360	3360	3500	3500	3346	3346	3422	-14	62	4	13.69	0
	20150413	3346	3422	3588	3588	3340	3576	3476	154	54	44	152.95	2
	20150414	3576	3476	3500	3550	3500	3502	3526	26	50	18	63.49	8
	20150415	3502	3526	3350	3350	3350	3350	3350	-176	-176	6	20.10	8
	20150416	3350	3350	3404	3404	3404	3404	3404	54	54	2	6.81	8
	20150417	3404	3404	3486	3490	3450	3450	3478	46	74	8	27.83	0
	20150420	3450	3478	3520	3520	3304	3304	3412	-174	-66	4	13.65	0
	20150421	3304	3412				3412	3412	0	0	0	0.00	0
	20150422	3412	3412				3412	3412	0	0	0	0.00	0
	20150423	3412	3412				3392	3392	-20	-20	0	0.00	0
	20150424	3392	3392				3392	3392	0	0	0	0.00	0
	20150427	3392	3392				3392	3392	0	0	0	0.00	0
	20150428	3392	3392				3392	3392	0	0	0	0.00	0
	20150429	3392	3392				3392	3392	0	0	0	0.00	0
	20150430	3392	3392				3392	3392	0	0	0	0.00	0
bu1508	20150216	3090	3090				3156	3156	66	66	0	0.00	0
	20150217	3156	3156				3122	3122	-34	-34	0	0.00	0
	20150225	3122	3122				3064	3064	-58	-58	0	0.00	0
	20150226	3064	3064				3106	3106	42	42	0	0.00	0
	20150227	3106	3106				3062	3062	-44	-44	0	0.00	0
	20150302	3062	3062				3150	3150	88	88	0	0.00	0
	20150303	3150	3150				3230	3230	80	80	0	0.00	0
	20150304	3230	3230	3230	3252	3230	3252	3240	22	10	4	12.96	2
	20150305	3252	3240				3240	3240	0	0	0	0.00	2
	20150306	3240	3240				3240	3240	0	0	0	0.00	2
	20150309	3240	3240				3156	3156	-84	-84	0	0.00	2
	20150310	3156	3156				3170	3170	14	14	0	0.00	2
	20150311	3170	3170				3124	3124	-46	-46	0	0.00	2
	20150312	3124	3124				3156	3156	32	32	0	0.00	2
	20150313	3156	3156				3202	3202	46	46	0	0.00	2
	20150316	3202	3202				3152	3152	-50	-50	0	0.00	2
	20150317	3152	3152				3148	3148	-4	-4	0	0.00	2
	20150318	3148	3148				3140	3140	-8	-8	0	0.00	2
	20150319	3140	3140				3150	3150	10	10	0	0.00	2
	20150320	3150	3150				3156	3156	6	6	0	0.00	2
	20150323	3156	3156				3210	3210	54	54	0	0.00	2
	20150324	3210	3210				3290	3290	80	80	0	0.00	2
	20150325	3290	3290				3282	3282	-8	-8	0	0.00	2
	20150326	3282	3282				3316	3316	34	34	0	0.00	2
	20150327	3316	3316				3308	3308	-8	-8	0	0.00	2
	20150330	3308	3308				3268	3268	-40	-40	0	0.00	2
	20150331	3268	3268				3268	3268	0	0	0	0.00	2
	20150401	3268	3268				3268	3268	0	0	0	0.00	2
	20150402	3268	3268				3322	3322	54	54	0	0.00	2
	20150403	3322	3322				3420	3420	98	98	0	0.00	2
	20150407	3420	3420				3420	3420	0	0	0	0.00	2
	20150408	3420	3420				3394	3394	-26	-26	0	0.00	2
	20150409	3394	3394				3394	3394	0	0	0	0.00	2
	20150410	3394	3394				3456	3456	62	62	0	0.00	2
	20150413	3456	3456				3510	3510	54	54	0	0.00	2
	20150414	3510	3510				3560	3560	50	50	0	0.00	2
	20150415	3560	3560				3560	3560	0	0	0	0.00	2
	20150416	3560	3560				3616	3616	56	56	0	0.00	2
	20150417	3616	3616				3694	3694	78	78	0	0.00	2
	20150420	3694	3694				3622	3622	-72	-72	0	0.00	2
	20150421	3622	3622				3496	3496	-126	-126	0	0.00	2
	20150422	3496	3496				3496	3496	0	0	0	0.00	2
	20150423	3496	3496				3486	3486	-10	-10	0	0.00	2
	20150424	3486	3486				3486	3486	0	0	0	0.00	2
	20150427	3486	3486				3486	3486	0	0	0	0.00	2
	20150428	3486	3486				3486	3486	0	0	0	0.00	2
	20150429	3486	3486				3486	3486	0	0	0	0.00	2
	20150430	3486	3486				3486	3486	0	0	0	0.00	2
bu1509	20150105	3594	3594				3594	3594	0	0	0	0.00	34
	20150106	3594	3594				3594	3594	0	0	0	0.00	34
	20150107	3594	3594				3594	3594	0	0	0	0.00	34
	20150108	3594	3594	3550	3550	3550	3550	3550	-44	-44	2	7.10	34
	20150109	3550	3550	3540	3540	3540	3540	3540	-10	-10	2	7.08	34
	20150112	3540	3540				3368	3368	-172	-172	0	0.00	34
	20150113	3368	3368	3530	3530	3200	3200	3362	-168	-6	14	47.08	38
	20150114	3200	3362	3192	3192	3192	3192	3192	-170	-170	14	44.69	48
	20150115	3192	3192				3158	3158	-34	-34	0	0.00	48
	20150116	3158	3158	3188	3188	3168	3168	3170	10	12	12	38.06	52
	20150119	3168	3170				3170	3170	0	0	0	0.00	52
	20150120	3170	3170				3170	3170	0	0	0	0.00	52
	20150121	3170	3170				3170	3170	0	0	0	0.00	52
	20150122	3170	3170				3170	3170	0	0	0	0.00	52
	20150123	3170	3170				3170	3170	0	0	0	0.00	52
	20150126	3170	3170	3016	3016	3010	3010	3012	-160	-158	4	12.05	56
	20150127	3010	3012	2782	3240	2782	3072	2970	60	-42	12	35.66	52
	20150128	3072	2970	2998	3000	2998	3000	2998	30	28	6	18.00	58
	20150129	3000	2998				2998	2998	0	0	0	0.00	58
	20150130	2998	2998	2928	2990	2912	2984	2952	-14	-46	16	47.26	62
	20150202	2984	2952	3000	3000	3000	3000	3000	48	48	6	18.00	66
	20150203	3000	3000	3144	3146	3056	3056	3100	56	100	8	24.81	68
	20150204	3056	3100	3250	3250	3080	3080	3154	-20	54	34	107.28	78
	20150205	3080	3154	3012	3012	2996	2996	3000	-158	-154	8	24.00	86
	20150206	2996	3000	3098	3126	3014	3028	3040	28	40	32	97.34	104
	20150209	3028	3040				3040	3040	0	0	0	0.00	104
	20150210	3040	3040	3020	3020	3020	3020	3020	-20	-20	2	6.04	104
	20150211	3020	3020	3040	3064	2994	3064	3032	44	12	6	18.20	100
	20150212	3064	3032				3032	3032	0	0	0	0.00	100
	20150213	3032	3032	3136	3136	3036	3132	3116	100	84	18	56.09	100
	20150216	3132	3116				3116	3116	0	0	0	0.00	100
	20150217	3116	3116	3050	3176	3050	3176	3140	60	24	8	25.12	104
	20150225	3176	3140				3140	3140	0	0	0	0.00	104
	20150226	3140	3140	3198	3240	3174	3240	3214	100	74	16	51.43	114
	20150227	3240	3214	3112	3288	3112	3270	3254	56	40	18	58.58	116
	20150302	3270	3254	3340	3360	3340	3360	3350	106	96	4	13.40	118
	20150303	3360	3350	3416	3416	3300	3300	3356	-50	6	16	53.72	114
	20150304	3300	3356	3354	3354	3330	3338	3340	-18	-16	6	20.04	118
	20150305	3338	3340	3300	3320	3222	3316	3274	-24	-66	18	58.93	116
	20150306	3316	3274	3150	3322	3150	3260	3286	-14	12	20	65.73	112
	20150309	3260	3286	3266	3300	3226	3300	3268	14	-18	36	117.68	112
	20150310	3300	3268	3256	3280	3182	3184	3234	-84	-34	40	129.44	122
	20150311	3184	3234	3228	3228	3160	3160	3198	-74	-36	12	38.38	128
	20150312	3160	3198	3210	3228	3210	3220	3220	22	22	8	25.76	134
	20150313	3220	3220	3256	3260	3256	3260	3256	40	36	12	39.08	136
	20150316	3260	3256	3178	3238	3168	3218	3192	-38	-64	18	57.48	134
	20150317	3218	3192	3166	3218	3166	3218	3192	26	0	4	12.77	134
	20150318	3218	3192	3210	3210	3168	3200	3192	8	0	6	19.16	132
	20150319	3200	3192	3228	3228	3194	3194	3204	2	12	6	19.23	134
	20150320	3194	3204				3240	3240	36	36	0	0.00	134
	20150323	3240	3240	3292	3294	3242	3294	3278	54	38	20	65.58	148
	20150324	3294	3278	3430	3430	3252	3338	3330	60	52	28	93.27	154
	20150325	3338	3330	3348	3348	3260	3300	3306	-30	-24	20	66.14	158
	20150326	3300	3306	3312	3350	3312	3320	3338	14	32	34	113.50	160
	20150327	3320	3338	3312	3376	3300	3326	3346	-12	8	138	461.76	158
	20150330	3326	3346	3306	3322	3282	3322	3304	-24	-42	30	99.14	168
	20150331	3322	3304	3312	3314	3252	3282	3298	-22	-6	30	99.00	170
	20150401	3282	3298	3298	3310	3286	3288	3290	-10	-8	24	78.97	168
	20150402	3288	3290	3334	3454	3294	3442	3404	152	114	122	415.35	172
	20150403	3442	3404	3472	3472	3386	3390	3434	-14	30	190	652.47	172
	20150407	3390	3434	3498	3498	3498	3498	3498	64	64	2	7.00	174
	20150408	3498	3498	3408	3522	3408	3454	3460	-44	-38	164	567.50	178
	20150409	3454	3460	3406	3438	3378	3392	3412	-68	-48	94	320.90	182
	20150410	3392	3412	3500	3536	3376	3460	3474	48	62	284	986.65	180
	20150413	3460	3474	3472	3514	3452	3470	3472	-4	-2	132	458.32	192
	20150414	3470	3472	3458	3508	3458	3486	3484	14	12	168	585.39	198
	20150415	3486	3484	3430	3520	3430	3498	3498	14	14	104	363.93	214
	20150416	3498	3498	3524	3528	3404	3492	3480	-6	-18	344	1,197.24	298
	20150417	3492	3480	3500	3500	3430	3466	3466	-14	-14	342	1,185.60	360
	20150420	3466	3466	3436	3494	3402	3472	3442	6	-24	1392	4,792.34	758
	20150421	3472	3442	3432	3472	3372	3410	3412	-32	-30	1024	3,494.60	636
	20150422	3410	3412	3436	3466	3394	3428	3432	16	20	676	2,320.78	802
	20150423	3428	3432	3428	3450	3352	3378	3410	-54	-22	1258	4,290.62	926
	20150424	3378	3410	3420	3428	3374	3410	3404	0	-6	698	2,376.34	988
	20150427	3410	3404	3412	3470	3404	3460	3442	56	38	1140	3,924.21	1490
	20150428	3460	3442	3462	3510	3462	3490	3494	48	52	2278	7,962.83	2404
	20150429	3490	3494	3510	3514	3420	3422	3462	-72	-32	1726	5,976.63	2668
	20150430	3422	3462	3410	3476	3406	3428	3440	-34	-22	1098	3,778.08	2758
bu1510	20150416	3498	3498				3498	3498	0	0	0	0.00	0
	20150417	3498	3498				3498	3498	0	0	0	0.00	0
	20150420	3498	3498				3498	3498	0	0	0	0.00	0
	20150421	3498	3498				3498	3498	0	0	0	0.00	0
	20150422	3498	3498				3498	3498	0	0	0	0.00	0
	20150423	3498	3498				3498	3498	0	0	0	0.00	0
	20150424	3498	3498				3498	3498	0	0	0	0.00	0
	20150427	3498	3498				3498	3498	0	0	0	0.00	0
	20150428	3498	3498				3498	3498	0	0	0	0.00	0
	20150429	3498	3498	3348	3558	3348	3490	3446	-8	-52	20	68.92	0
	20150430	3490	3446				3446	3446	0	0	0	0.00	0
bu1512	20150105	3380	3380				3356	3356	-24	-24	0	0.00	8
	20150106	3356	3356				3402	3402	46	46	0	0.00	8
	20150107	3402	3402				3348	3348	-54	-54	0	0.00	8
	20150108	3348	3348				3306	3306	-42	-42	0	0.00	8
	20150109	3306	3306				3296	3296	-10	-10	0	0.00	8
	20150112	3296	3296				3136	3136	-160	-160	0	0.00	8
	20150113	3136	3136				3130	3130	-6	-6	0	0.00	8
	20150114	3130	3130				3130	3130	0	0	0	0.00	8
	20150115	3130	3130				3146	3146	16	16	0	0.00	8
	20150116	3146	3146				3158	3158	12	12	0	0.00	8
	20150119	3158	3158				3100	3100	-58	-58	0	0.00	8
	20150120	3100	3100				3062	3062	-38	-38	0	0.00	8
	20150121	3062	3062				3036	3036	-26	-26	0	0.00	8
	20150122	3036	3036				3054	3054	18	18	0	0.00	8
	20150123	3054	3054				3048	3048	-6	-6	0	0.00	8
	20150126	3048	3048				2896	2896	-152	-152	0	0.00	8
	20150127	2896	2896				2856	2856	-40	-40	0	0.00	8
	20150128	2856	2856				2884	2884	28	28	0	0.00	8
	20150129	2884	2884				2876	2876	-8	-8	0	0.00	8
	20150130	2876	2876				2832	2832	-44	-44	0	0.00	8
	20150202	2832	2832				2972	2972	140	140	0	0.00	8
	20150203	2972	2972				3072	3072	100	100	0	0.00	8
	20150204	3072	3072				3072	3072	0	0	0	0.00	8
	20150205	3072	3072				3072	3072	0	0	0	0.00	8
	20150206	3072	3072				3072	3072	0	0	0	0.00	8
	20150209	3072	3072				3078	3078	6	6	0	0.00	8
	20150210	3078	3078				3056	3056	-22	-22	0	0.00	8
	20150211	3056	3056				3056	3056	0	0	0	0.00	8
	20150212	3056	3056				3056	3056	0	0	0	0.00	8
	20150213	3056	3056				3140	3140	84	84	0	0.00	8
	20150216	3140	3140				3140	3140	0	0	0	0.00	8
	20150217	3140	3140				3164	3164	24	24	0	0.00	8
	20150225	3164	3164				3164	3164	0	0	0	0.00	8
	20150226	3164	3164				3238	3238	74	74	0	0.00	8
	20150227	3238	3238	3398	3398	3398	3398	3398	160	160	20	67.96	20
	20150302	3398	3398				3398	3398	0	0	0	0.00	20
	20150303	3398	3398				3398	3398	0	0	0	0.00	20
	20150304	3398	3398				3398	3398	0	0	0	0.00	20
	20150305	3398	3398	3378	3378	3378	3378	3378	-20	-20	2	6.76	20
	20150306	3378	3378	3396	3398	3394	3394	3396	16	18	6	20.38	20
	20150309	3394	3396				3396	3396	0	0	0	0.00	20
	20150310	3396	3396				3396	3396	0	0	0	0.00	20
	20150311	3396	3396	3392	3392	3380	3380	3386	-16	-10	4	13.54	20
	20150312	3380	3386				3386	3386	0	0	0	0.00	20
	20150313	3386	3386				3386	3386	0	0	0	0.00	20
	20150316	3386	3386				3350	3350	-36	-36	0	0.00	20
	20150317	3350	3350				3350	3350	0	0	0	0.00	20
	20150318	3350	3350				3350	3350	0	0	0	0.00	20
	20150319	3350	3350				3350	3350	0	0	0	0.00	20
	20150320	3350	3350				3350	3350	0	0	0	0.00	20
	20150323	3350	3350				3354	3354	4	4	0	0.00	20
	20150324	3354	3354				3390	3390	36	36	0	0.00	20
	20150325	3390	3390				3390	3390	0	0	0	0.00	20
	20150326	3390	3390	3468	3498	3466	3490	3472	100	82	32	111.14	16
	20150327	3490	3472	3460	3460	3408	3408	3434	-64	-38	4	13.74	14
	20150330	3408	3434				3434	3434	0	0	0	0.00	14
	20150331	3434	3434				3410	3410	-24	-24	0	0.00	14
	20150401	3410	3410				3410	3410	0	0	0	0.00	14
	20150402	3410	3410				3488	3488	78	78	0	0.00	14
	20150403	3488	3488				3488	3488	0	0	0	0.00	14
	20150407	3488	3488				3488	3488	0	0	0	0.00	14
	20150408	3488	3488	3510	3578	3510	3578	3544	90	56	4	14.18	14
	20150409	3578	3544				3544	3544	0	0	0	0.00	14
	20150410	3544	3544	3558	3558	3558	3558	3558	14	14	4	14.23	12
	20150413	3558	3558				3558	3558	0	0	0	0.00	12
	20150414	3558	3558				3558	3558	0	0	0	0.00	12
	20150415	3558	3558				3558	3558	0	0	0	0.00	12
	20150416	3558	3558	3390	3558	3390	3558	3474	0	-84	4	13.90	12
	20150417	3558	3474				3474	3474	0	0	0	0.00	12
	20150420	3474	3474	3468	3468	3468	3468	3468	-6	-6	2	6.94	12
	20150421	3468	3468				3468	3468	0	0	0	0.00	12
	20150422	3468	3468				3468	3468	0	0	0	0.00	12
	20150423	3468	3468	3498	3498	3498	3498	3498	30	30	2	7.00	10
	20150424	3498	3498				3498	3498	0	0	0	0.00	10
	20150427	3498	3498				3500	3500	2	2	0	0.00	10
	20150428	3500	3500	3656	3656	3464	3632	3608	132	108	90	324.81	50
	20150429	3632	3608	3596	3596	3572	3572	3588	-36	-20	8	28.71	52
	20150430	3572	3588	3588	3588	3530	3574	3568	-14	-20	8	28.54	52
bu1603	20150105	3506	3506				3506	3506	0	0	0	0.00	6
	20150106	3506	3506				3506	3506	0	0	0	0.00	6
	20150107	3506	3506	3468	3468	3468	3468	3468	-38	-38	2	6.94	6
	20150108	3468	3468				3468	3468	0	0	0	0.00	6
	20150109	3468	3468	3468	3468	3432	3432	3444	-36	-24	6	20.67	2
	20150112	3432	3444				3278	3278	-166	-166	0	0.00	2
	20150113	3278	3278				3278	3278	0	0	0	0.00	2
	20150114	3278	3278				3278	3278	0	0	0	0.00	2
	20150115	3278	3278				3278	3278	0	0	0	0.00	2
	20150116	3278	3278				3278	3278	0	0	0	0.00	2
	20150119	3278	3278				3278	3278	0	0	0	0.00	2
	20150120	3278	3278				3278	3278	0	0	0	0.00	2
	20150121	3278	3278				3278	3278	0	0	0	0.00	2
	20150122	3278	3278				3278	3278	0	0	0	0.00	2
	20150123	3278	3278				3278	3278	0	0	0	0.00	2
	20150126	3278	3278				3278	3278	0	0	0	0.00	2
	20150127	3278	3278	3114	3172	3114	3172	3142	-106	-136	4	12.57	2
	20150128	3172	3142				3142	3142	0	0	0	0.00	2
	20150129	3142	3142				3142	3142	0	0	0	0.00	2
	20150130	3142	3142				3142	3142	0	0	0	0.00	2
	20150202	3142	3142				3142	3142	0	0	0	0.00	2
	20150203	3142	3142				3142	3142	0	0	0	0.00	2
	20150204	3142	3142				3142	3142	0	0	0	0.00	2
	20150205	3142	3142				3142	3142	0	0	0	0.00	2
	20150206	3142	3142				3142	3142	0	0	0	0.00	2
	20150209	3142	3142				3142	3142	0	0	0	0.00	2
	20150210	3142	3142				3142	3142	0	0	0	0.00	2
	20150211	3142	3142				3142	3142	0	0	0	0.00	2
	20150212	3142	3142				3142	3142	0	0	0	0.00	2
	20150213	3142	3142				3142	3142	0	0	0	0.00	2
	20150216	3142	3142				3142	3142	0	0	0	0.00	2
	20150217	3142	3142				3142	3142	0	0	0	0.00	2
	20150225	3142	3142	2922	2922	2922	2922	2922	-220	-220	4	11.69	4
	20150226	2922	2922				3068	3068	146	146	0	0.00	4
	20150227	3068	3068	3048	3210	3048	3210	3162	142	94	8	25.31	4
	20150302	3210	3162	3320	3320	3320	3320	3320	158	158	2	6.64	2
	20150303	3320	3320	3486	3486	3486	3486	3486	166	166	2	6.97	2
	20150304	3486	3486				3486	3486	0	0	0	0.00	2
	20150305	3486	3486	3650	3650	3410	3420	3492	-66	6	6	20.96	2
	20150306	3420	3492	3616	3616	3616	3616	3616	124	124	2	7.23	2
	20150309	3616	3616				3480	3480	-136	-136	0	0.00	2
	20150310	3480	3480	3326	3598	3326	3490	3470	10	-10	6	20.83	2
	20150311	3490	3470				3450	3450	-20	-20	0	0.00	2
	20150312	3450	3450				3400	3400	-50	-50	0	0.00	2
	20150313	3400	3400				3400	3400	0	0	0	0.00	2
	20150316	3400	3400				3400	3400	0	0	0	0.00	2
	20150317	3400	3400				3400	3400	0	0	0	0.00	2
	20150318	3400	3400				3400	3400	0	0	0	0.00	2
	20150319	3400	3400				3400	3400	0	0	0	0.00	2
	20150320	3400	3400				3400	3400	0	0	0	0.00	2
	20150323	3400	3400	3540	3570	3530	3558	3562	158	162	36	128.25	32
	20150324	3558	3562	3530	3560	3476	3482	3512	-80	-50	8	28.10	32
	20150325	3482	3512	3550	3550	3480	3530	3522	18	10	16	56.35	30
	20150326	3530	3522				3522	3522	0	0	0	0.00	30
	20150327	3522	3522	3450	3450	3450	3450	3450	-72	-72	2	6.90	30
	20150330	3450	3450				3430	3430	-20	-20	0	0.00	30
	20150331	3430	3430				3430	3430	0	0	0	0.00	30
	20150401	3430	3430				3422	3422	-8	-8	0	0.00	30
	20150402	3422	3422	3528	3530	3450	3450	3498	28	76	8	27.99	32
	20150403	3450	3498	3500	3502	3500	3502	3500	4	2	16	56.01	28
	20150407	3502	3500				3504	3504	4	4	0	0.00	28
	20150408	3504	3504				3504	3504	0	0	0	0.00	28
	20150409	3504	3504	3504	3650	3480	3560	3540	56	36	14	49.57	28
	20150410	3560	3540				3540	3540	0	0	0	0.00	28
	20150413	3540	3540				3540	3540	0	0	0	0.00	28
	20150414	3540	3540				3540	3540	0	0	0	0.00	28
	20150415	3540	3540				3546	3546	6	6	0	0.00	28
	20150416	3546	3546				3546	3546	0	0	0	0.00	28
	20150417	3546	3546				3546	3546	0	0	0	0.00	28
	20150420	3546	3546	3550	3550	3548	3548	3548	2	2	4	14.20	30
	20150421	3548	3548	3466	3498	3466	3498	3482	-50	-66	16	55.72	20
	20150422	3498	3482	3550	3550	3550	3550	3550	68	68	2	7.10	20
	20150423	3550	3550	3500	3500	3488	3488	3494	-62	-56	4	13.98	22
	20150424	3488	3494	3490	3584	3490	3554	3542	60	48	10	35.43	14
	20150427	3554	3542				3542	3542	0	0	0	0.00	14
	20150428	3542	3542				3566	3566	24	24	0	0.00	14
	20150429	3566	3566	3556	3556	3556	3556	3556	-10	-10	2	7.11	14
	20150430	3556	3556	3570	3570	3570	3570	3570	14	14	2	7.14	12
bu1606	20150105	3400	3400				3376	3376	-24	-24	0	0.00	0
	20150106	3376	3376				3422	3422	46	46	0	0.00	0
	20150107	3422	3422				3384	3384	-38	-38	0	0.00	0
	20150108	3384	3384				3342	3342	-42	-42	0	0.00	0
	20150109	3342	3342				3318	3318	-24	-24	0	0.00	0
	20150112	3318	3318				3158	3158	-160	-160	0	0.00	0
	20150113	3158	3158				3152	3152	-6	-6	0	0.00	0
	20150114	3152	3152				2994	2994	-158	-158	0	0.00	0
	20150115	2994	2994				3008	3008	14	14	0	0.00	0
	20150116	3008	3008				3020	3020	12	12	0	0.00	0
	20150119	3020	3020				2964	2964	-56	-56	0	0.00	0
	20150120	2964	2964				2928	2928	-36	-36	0	0.00	0
	20150121	2928	2928				2902	2902	-26	-26	0	0.00	0
	20150122	2902	2902				3046	3046	144	144	0	0.00	0
	20150123	3046	3046				3040	3040	-6	-6	0	0.00	0
	20150126	3040	3040				2888	2888	-152	-152	0	0.00	0
	20150127	2888	2888	3028	3028	3024	3024	3026	136	138	8	24.22	8
	20150128	3024	3026				3036	3036	10	10	0	0.00	8
	20150129	3036	3036				3050	3050	14	14	0	0.00	8
	20150130	3050	3050	3056	3056	3056	3056	3056	6	6	2	6.11	8
	20150202	3056	3056				3104	3104	48	48	0	0.00	8
	20150203	3104	3104				3208	3208	104	104	0	0.00	8
	20150204	3208	3208				3208	3208	0	0	0	0.00	8
	20150205	3208	3208	3366	3366	3366	3366	3366	158	158	2	6.73	8
	20150206	3366	3366				3412	3412	46	46	0	0.00	8
	20150209	3412	3412				3420	3420	8	8	0	0.00	8
	20150210	3420	3420				3396	3396	-24	-24	0	0.00	8
	20150211	3396	3396				3410	3410	14	14	0	0.00	8
	20150212	3410	3410				3418	3418	8	8	0	0.00	8
	20150213	3418	3418				3350	3350	-68	-68	0	0.00	8
	20150216	3350	3350				3422	3422	72	72	0	0.00	8
	20150217	3422	3422				3422	3422	0	0	0	0.00	8
	20150225	3422	3422	3422	3422	3422	3422	3422	0	0	2	6.84	8
	20150226	3422	3422	3250	3386	3250	3386	3296	-36	-126	6	19.78	8
	20150227	3386	3296				3296	3296	0	0	0	0.00	8
	20150302	3296	3296				3460	3460	164	164	0	0.00	8
	20150303	3460	3460	3626	3626	3344	3388	3492	-72	32	8	27.95	8
	20150304	3388	3492				3492	3492	0	0	0	0.00	8
	20150305	3492	3492				3492	3492	0	0	0	0.00	8
	20150306	3492	3492	3612	3658	3540	3540	3600	48	108	56	201.62	38
	20150309	3540	3600				3586	3586	-14	-14	0	0.00	38
	20150310	3586	3586	3522	3522	3490	3490	3500	-96	-86	6	21.01	36
	20150311	3490	3500	3324	3384	3324	3384	3334	-116	-166	12	40.01	32
	20150312	3384	3334	3402	3402	3402	3402	3402	68	68	2	6.80	30
	20150313	3402	3402	3470	3494	3406	3460	3458	58	56	16	55.34	26
	20150316	3460	3458	3444	3480	3430	3450	3456	-8	-2	22	76.07	34
	20150317	3450	3456	3404	3486	3400	3472	3438	16	-18	54	185.69	32
	20150318	3472	3438				3438	3438	0	0	0	0.00	32
	20150319	3438	3438	3410	3410	3410	3410	3410	-28	-28	2	6.82	32
	20150320	3410	3410	3366	3520	3366	3468	3450	58	40	12	41.41	32
	20150323	3468	3450	3548	3568	3546	3568	3554	118	104	12	42.65	34
	20150324	3568	3554	3600	3640	3546	3600	3604	46	50	20	72.11	32
	20150325	3600	3604	3588	3588	3588	3588	3588	-16	-16	2	7.18	32
	20150326	3588	3588	3630	3630	3546	3598	3584	10	-4	24	86.04	30
	20150327	3598	3584	3594	3608	3568	3570	3580	-14	-4	10	35.82	28
	20150330	3570	3580	3562	3562	3542	3542	3548	-38	-32	6	21.30	26
	20150331	3542	3548				3548	3548	0	0	0	0.00	26
	20150401	3548	3548	3456	3596	3456	3482	3528	-66	-20	8	28.23	26
	20150402	3482	3528	3618	3648	3618	3648	3628	120	100	26	94.35	26
	20150403	3648	3628	3670	3670	3566	3566	3636	-62	8	10	36.38	24
	20150407	3566	3636	3650	3666	3602	3666	3636	30	0	10	36.37	26
	20150408	3666	3636	3634	3696	3602	3602	3656	-34	20	32	117.04	26
	20150409	3602	3656	3622	3630	3590	3630	3614	-26	-42	10	36.16	26
	20150410	3630	3614	3688	3700	3502	3674	3640	60	26	184	669.82	32
	20150413	3674	3640	3718	3736	3640	3656	3686	16	46	34	125.38	28
	20150414	3656	3686	3668	3680	3658	3680	3668	-6	-18	6	22.01	30
	20150415	3680	3668	3708	3708	3658	3668	3682	0	14	12	44.20	32
	20150416	3668	3682	3668	3752	3668	3712	3708	30	26	36	133.50	42
	20150417	3712	3708	3722	3722	3700	3704	3708	-4	0	6	22.25	44
	20150420	3704	3708	3680	3728	3668	3668	3684	-40	-24	28	103.17	40
	20150421	3668	3684	3582	3638	3582	3600	3616	-84	-68	10	36.17	40
	20150422	3600	3616	3628	3650	3586	3650	3624	34	8	34	123.23	56
	20150423	3650	3624	3648	3678	3600	3600	3630	-24	6	34	123.45	52
	20150424	3600	3630	3630	3660	3578	3650	3620	20	-10	184	666.37	70
	20150427	3650	3620	3612	3744	3440	3710	3638	90	18	156	567.83	80
	20150428	3710	3638	3700	3766	3690	3698	3720	60	82	72	267.98	98
	20150429	3698	3720	3734	3734	3702	3702	3718	-18	-2	8	29.75	94
	20150430	3702	3718	3716	3718	3684	3708	3702	-10	-16	16	59.25	100
bu1609	20150105	3494	3494				3470	3470	-24	-24	0	0.00	0
	20150106	3470	3470				3470	3470	0	0	0	0.00	0
	20150107	3470	3470				3502	3502	32	32	0	0.00	0
	20150108	3502	3502				3502	3502	0	0	0	0.00	0
	20150109	3502	3502				3478	3478	-24	-24	0	0.00	0
	20150112	3478	3478				3310	3310	-168	-168	0	0.00	0
	20150113	3310	3310				3304	3304	-6	-6	0	0.00	0
	20150114	3304	3304				3138	3138	-166	-166	0	0.00	0
	20150115	3138	3138				3154	3154	16	16	0	0.00	0
	20150116	3154	3154				3166	3166	12	12	0	0.00	0
	20150119	3166	3166				3108	3108	-58	-58	0	0.00	0
	20150120	3108	3108				3070	3070	-38	-38	0	0.00	0
	20150121	3070	3070				3044	3044	-26	-26	0	0.00	0
	20150122	3044	3044				3062	3062	18	18	0	0.00	0
	20150123	3062	3062				3056	3056	-6	-6	0	0.00	0
	20150126	3056	3056	3200	3200	3180	3180	3184	124	128	8	25.48	6
	20150127	3180	3184	3342	3342	3190	3190	3244	6	60	6	19.46	10
	20150128	3190	3244	3296	3296	3238	3296	3276	52	32	6	19.66	10
	20150129	3296	3276	3416	3418	3258	3258	3336	-18	60	18	60.07	8
	20150130	3258	3336	3222	3222	3222	3222	3222	-114	-114	2	6.44	8
	20150202	3222	3222	3200	3380	3200	3380	3216	158	-6	22	70.76	28
	20150203	3380	3216				3324	3324	108	108	0	0.00	28
	20150204	3324	3324				3324	3324	0	0	0	0.00	28
	20150205	3324	3324	3256	3256	3160	3180	3206	-144	-118	10	32.07	34
	20150206	3180	3206				3206	3206	0	0	0	0.00	34
	20150209	3206	3206				3206	3206	0	0	0	0.00	34
	20150210	3206	3206				3206	3206	0	0	0	0.00	34
	20150211	3206	3206				3206	3206	0	0	0	0.00	34
	20150212	3206	3206	3200	3200	3050	3200	3150	-6	-56	6	18.90	36
	20150213	3200	3150	3190	3242	3190	3242	3212	92	62	10	32.13	40
	20150216	3242	3212				3242	3242	30	30	0	0.00	40
	20150217	3242	3242				3242	3242	0	0	0	0.00	40
	20150225	3242	3242	3242	3278	3242	3278	3260	36	18	4	13.04	40
	20150226	3278	3260	3300	3348	3300	3348	3316	88	56	6	19.90	36
	20150227	3348	3316				3316	3316	0	0	0	0.00	36
	20150302	3316	3316				3360	3360	44	44	0	0.00	36
	20150303	3360	3360				3360	3360	0	0	0	0.00	36
	20150304	3360	3360				3370	3370	10	10	0	0.00	36
	20150305	3370	3370	3370	3450	3360	3380	3384	10	14	10	33.84	34
	20150306	3380	3384	3552	3552	3426	3426	3482	42	98	8	27.86	38
	20150309	3426	3482	3500	3538	3420	3538	3486	56	4	6	20.92	40
	20150310	3538	3486	3480	3480	3480	3480	3480	-6	-6	2	6.96	42
	20150311	3480	3480	3412	3412	3412	3412	3412	-68	-68	2	6.82	40
	20150312	3412	3412				3412	3412	0	0	0	0.00	40
	20150313	3412	3412	3476	3476	3476	3476	3476	64	64	2	6.95	42
	20150316	3476	3476	3420	3480	3420	3480	3450	4	-26	4	13.80	42
	20150317	3480	3450				3450	3450	0	0	0	0.00	42
	20150318	3450	3450	3450	3450	3450	3450	3450	0	0	2	6.90	44
	20150319	3450	3450	3488	3500	3488	3500	3494	50	44	4	13.98	40
	20150320	3500	3494				3494	3494	0	0	0	0.00	40
	20150323	3494	3494	3508	3570	3508	3570	3528	76	34	6	21.18	42
	20150324	3570	3528	3528	3528	3528	3528	3528	0	0	4	14.11	42
	20150325	3528	3528	3650	3650	3518	3526	3552	-2	24	12	42.64	46
	20150326	3526	3552	3578	3636	3578	3636	3616	84	64	6	21.70	42
	20150327	3636	3616				3598	3598	-18	-18	0	0.00	42
	20150330	3598	3598				3598	3598	0	0	0	0.00	42
	20150331	3598	3598				3596	3596	-2	-2	0	0.00	42
	20150401	3596	3596				3596	3596	0	0	0	0.00	42
	20150402	3596	3596	3650	3650	3650	3650	3650	54	54	2	7.30	42
	20150403	3650	3650				3650	3650	0	0	0	0.00	42
	20150407	3650	3650				3650	3650	0	0	0	0.00	42
	20150408	3650	3650				3650	3650	0	0	0	0.00	42
	20150409	3650	3650				3628	3628	-22	-22	0	0.00	42
	20150410	3628	3628	3680	3680	3666	3666	3670	38	42	6	22.02	42
	20150413	3666	3670	3678	3678	3652	3654	3660	-16	-10	10	36.61	42
	20150414	3654	3660	3680	3698	3668	3692	3686	32	26	18	66.37	36
	20150415	3692	3686	3686	3700	3650	3700	3678	14	-8	6	22.07	36
	20150416	3700	3678	3652	3700	3652	3700	3682	22	4	8	29.46	36
	20150417	3700	3682	3684	3684	3680	3680	3682	-2	0	4	14.73	40
	20150420	3680	3682	3768	3768	3622	3638	3676	-44	-6	58	213.25	42
	20150421	3638	3676	3600	3600	3570	3570	3584	-106	-92	4	14.34	44
	20150422	3570	3584	3620	3648	3588	3588	3612	4	28	8	28.90	46
	20150423	3588	3612	3650	3650	3598	3598	3624	-14	12	36	130.52	52
	20150424	3598	3624	3566	3650	3566	3634	3626	10	2	30	108.78	52
	20150427	3634	3626	3654	3688	3568	3688	3638	62	12	100	363.81	68
	20150428	3688	3638	3708	3760	3708	3748	3744	110	106	40	149.83	92
	20150429	3748	3744	3810	3810	3720	3726	3756	-18	12	50	187.84	104
	20150430	3726	3756	3732	3752	3704	3704	3724	-52	-32	10	37.25	106
bu1612	20150105	3538	3538				3514	3514	-24	-24	0	0.00	0
	20150106	3514	3514				3562	3562	48	48	0	0.00	0
	20150107	3562	3562				3522	3522	-40	-40	0	0.00	0
	20150108	3522	3522				3478	3478	-44	-44	0	0.00	0
	20150109	3478	3478				3454	3454	-24	-24	0	0.00	0
	20150112	3454	3454				3286	3286	-168	-168	0	0.00	0
	20150113	3286	3286				3280	3280	-6	-6	0	0.00	0
	20150114	3280	3280				3116	3116	-164	-164	0	0.00	0
	20150115	3116	3116				3132	3132	16	16	0	0.00	0
	20150116	3132	3132				3144	3144	12	12	0	0.00	0
	20150119	3144	3144				3086	3086	-58	-58	0	0.00	0
	20150120	3086	3086	3240	3240	2932	3240	3162	154	76	8	25.30	2
	20150121	3240	3162				3134	3134	-28	-28	0	0.00	2
	20150122	3134	3134	3290	3290	3162	3162	3230	28	96	6	19.38	4
	20150123	3162	3230	3102	3238	3102	3238	3170	8	-60	4	12.68	4
	20150126	3238	3170	3320	3320	3030	3030	3174	-140	4	4	12.70	2
	20150127	3030	3174				3174	3174	0	0	0	0.00	2
	20150128	3174	3174				3204	3204	30	30	0	0.00	2
	20150129	3204	3204				3204	3204	0	0	0	0.00	2
	20150130	3204	3204				3204	3204	0	0	0	0.00	2
	20150202	3204	3204				3204	3204	0	0	0	0.00	2
	20150203	3204	3204				3310	3310	106	106	0	0.00	2
	20150204	3310	3310	3208	3208	3208	3208	3208	-102	-102	2	6.42	2
	20150205	3208	3208				3216	3216	8	8	0	0.00	2
	20150206	3216	3216				3218	3218	2	2	0	0.00	2
	20150209	3218	3218				3218	3218	0	0	0	0.00	2
	20150210	3218	3218				3218	3218	0	0	0	0.00	2
	20150211	3218	3218				3218	3218	0	0	0	0.00	2
	20150212	3218	3218				3218	3218	0	0	0	0.00	2
	20150213	3218	3218				3220	3220	2	2	0	0.00	2
	20150216	3220	3220	3222	3222	3222	3222	3222	2	2	2	6.44	4
	20150217	3222	3222	3440	3440	3202	3202	3320	-20	98	4	13.28	4
	20150225	3202	3320				3320	3320	0	0	0	0.00	4
	20150226	3320	3320				3320	3320	0	0	0	0.00	4
	20150227	3320	3320				3320	3320	0	0	0	0.00	4
	20150302	3320	3320				3320	3320	0	0	0	0.00	4
	20150303	3320	3320				3320	3320	0	0	0	0.00	4
	20150304	3320	3320				3320	3320	0	0	0	0.00	4
	20150305	3320	3320				3320	3320	0	0	0	0.00	4
	20150306	3320	3320	3448	3486	3408	3484	3454	164	134	12	41.45	6
	20150309	3484	3454	3306	3442	3306	3442	3374	-12	-80	4	13.50	4
	20150310	3442	3374	3396	3396	3396	3396	3396	22	22	2	6.79	4
	20150311	3396	3396	3240	3356	3240	3356	3298	-40	-98	4	13.19	4
	20150312	3356	3298				3306	3306	8	8	0	0.00	4
	20150313	3306	3306				3388	3388	82	82	0	0.00	4
	20150316	3388	3388				3388	3388	0	0	0	0.00	4
	20150317	3388	3388				3388	3388	0	0	0	0.00	4
	20150318	3388	3388				3388	3388	0	0	0	0.00	4
	20150319	3388	3388	3400	3400	3400	3400	3400	12	12	4	13.60	4
	20150320	3400	3400				3400	3400	0	0	0	0.00	4
	20150323	3400	3400	3494	3494	3492	3492	3492	92	92	4	13.97	4
	20150324	3492	3492	3568	3568	3362	3502	3448	10	-44	8	27.59	6
	20150325	3502	3448				3480	3480	32	32	0	0.00	6
	20150326	3480	3480	3580	3580	3580	3580	3580	100	100	2	7.16	8
	20150327	3580	3580	3516	3516	3516	3516	3516	-64	-64	2	7.03	8
	20150330	3516	3516	3484	3484	3484	3484	3484	-32	-32	2	6.97	8
	20150331	3484	3484				3554	3554	70	70	0	0.00	8
	20150401	3554	3554	3452	3572	3452	3480	3512	-74	-42	14	49.18	8
	20150402	3480	3512	3598	3598	3516	3572	3562	60	50	6	21.37	8
	20150403	3572	3562				3620	3620	58	58	0	0.00	8
	20150407	3620	3620	3680	3680	3680	3680	3680	60	60	2	7.36	10
	20150408	3680	3680	3570	3690	3570	3672	3646	-8	-34	10	36.46	10
	20150409	3672	3646	3628	3642	3552	3642	3596	-4	-50	12	43.16	6
	20150410	3642	3596	3610	3670	3610	3666	3652	70	56	8	29.23	6
	20150413	3666	3652	3654	3654	3654	3654	3654	2	2	2	7.31	8
	20150414	3654	3654	3648	3650	3612	3612	3638	-42	-16	8	29.10	6
	20150415	3612	3638	3608	3652	3608	3652	3634	14	-4	6	21.80	6
	20150416	3652	3634	3648	3686	3648	3686	3668	52	34	8	29.35	6
	20150417	3686	3668	3628	3666	3628	3666	3646	-2	-22	4	14.59	6
	20150420	3666	3646	3634	3634	3592	3592	3612	-54	-34	4	14.45	8
	20150421	3592	3612	3532	3612	3532	3590	3574	-22	-38	12	42.90	10
	20150422	3590	3574	3650	3650	3600	3600	3624	26	50	4	14.50	12
	20150423	3600	3624	3602	3602	3562	3562	3590	-62	-34	8	28.73	8
	20150424	3562	3590	3522	3650	3522	3604	3608	14	18	22	79.41	10
	20150427	3604	3608	3658	3698	3608	3660	3676	52	68	20	73.55	14
	20150428	3660	3676	3660	3780	3660	3738	3748	62	72	48	179.96	52
	20150429	3738	3748	3652	3792	3652	3732	3754	-16	6	20	75.09	56
	20150430	3732	3754	3702	3704	3702	3704	3702	-50	-52	4	14.81	58
bu1703	20150317	3388	3388				3388	3388	0	0	0	0.00	0
	20150318	3388	3388				3388	3388	0	0	0	0.00	0
	20150319	3388	3388				3388	3388	0	0	0	0.00	0
	20150320	3388	3388				3388	3388	0	0	0	0.00	0
	20150323	3388	3388				3388	3388	0	0	0	0.00	0
	20150324	3388	3388				3344	3344	-44	-44	0	0.00	0
	20150325	3344	3344				3368	3368	24	24	0	0.00	0
	20150326	3368	3368				3464	3464	96	96	0	0.00	0
	20150327	3464	3464				3464	3464	0	0	0	0.00	0
	20150330	3464	3464				3464	3464	0	0	0	0.00	0
	20150331	3464	3464				3464	3464	0	0	0	0.00	0
	20150401	3464	3464				3464	3464	0	0	0	0.00	0
	20150402	3464	3464				3464	3464	0	0	0	0.00	0
	20150403	3464	3464				3464	3464	0	0	0	0.00	0
	20150407	3464	3464				3520	3520	56	56	0	0.00	0
	20150408	3520	3520				3520	3520	0	0	0	0.00	0
	20150409	3520	3520				3520	3520	0	0	0	0.00	0
	20150410	3520	3520				3520	3520	0	0	0	0.00	0
	20150413	3520	3520				3520	3520	0	0	0	0.00	0
	20150414	3520	3520				3526	3526	6	6	0	0.00	0
	20150415	3526	3526				3526	3526	0	0	0	0.00	0
	20150416	3526	3526				3526	3526	0	0	0	0.00	0
	20150417	3526	3526				3526	3526	0	0	0	0.00	0
	20150420	3526	3526				3526	3526	0	0	0	0.00	0
	20150421	3526	3526				3526	3526	0	0	0	0.00	0
	20150422	3526	3526				3526	3526	0	0	0	0.00	0
	20150423	3526	3526				3526	3526	0	0	0	0.00	0
	20150424	3526	3526				3526	3526	0	0	0	0.00	0
	20150427	3526	3526				3526	3526	0	0	0	0.00	0
	20150428	3526	3526				3656	3656	130	130	0	0.00	0
	20150429	3656	3656				3750	3750	94	94	0	0.00	0
	20150430	3750	3750				3750	3750	0	0	0	0.00	0
cu1501	20150105	46500	46560	46340	46360	45910	45960	46100	-600	-460	21224	489,236.84	37210
	20150106	45960	46100	45960	45960	44950	45680	45560	-420	-540	17660	402,356.40	31940
	20150107	45680	45560	45620	45670	45300	45430	45530	-130	-30	16130	367,228.65	29270
	20150108	45430	45530	45650	45700	45430	45500	45580	-30	50	16410	374,034.20	26200
	20150109	45500	45580	45780	45800	45200	45200	45360	-380	-220	16660	377,869.35	24540
	20150112	45200	45360	45200	45300	44620	44750	44980	-610	-380	14520	326,558.60	20810
	20150113	44750	44980	45030	45030	43650	43700	44290	-1280	-690	9380	207,742.30	16360
	20150114	43700	44290	42420	43360	42070	42070	42540	-2220	-1750	2690	57,216.60	14200
	20150115	42070	42540	39130	41500	39130	41150	40870	-1390	-1670	14660	299,602.85	6260
cu1502	20150105	46250	46090	46040	46040	45470	45550	45730	-540	-360	42206	965,079.80	111238
	20150106	45550	45730	44750	45370	43710	45270	45090	-460	-640	66402	1,497,265.13	102798
	20150107	45270	45090	45180	45300	44880	45080	45110	-10	20	37274	840,759.03	101126
	20150108	45080	45110	45040	45320	45030	45080	45160	-30	50	29970	676,830.61	98628
	20150109	45080	45160	45320	45460	44700	44720	44930	-440	-230	45092	1,013,062.77	96072
	20150112	44720	44930	44590	44900	44220	44400	44530	-530	-400	46160	1,027,930.52	92124
	20150113	44400	44530	43890	44140	43330	43330	43790	-1200	-740	47098	1,031,334.88	91702
	20150114	43330	43790	42870	43140	41600	41600	42410	-2190	-1380	36432	772,689.88	89444
	20150115	41600	42410	40980	41540	40030	41300	40880	-1110	-1530	92318	1,887,126.07	86056
	20150116	41300	40880	42000	42020	40910	41320	41270	440	390	49570	1,022,939.18	79064
	20150119	41320	41270	41140	42170	41040	41980	41760	710	490	45202	943,937.89	76360
	20150120	41980	41760	41400	41810	41260	41450	41560	-310	-200	39000	810,575.57	73162
	20150121	41450	41560	41670	41790	41330	41450	41530	-110	-30	26598	552,401.23	69576
	20150122	41450	41530	41080	42310	41080	41760	41820	230	290	38258	800,065.11	64144
	20150123	41760	41820	41700	42000	41000	41240	41350	-580	-470	39214	810,849.90	60836
	20150126	41240	41350	41100	41100	39280	39680	40030	-1670	-1320	45504	910,957.24	56030
	20150127	39680	40030	40030	41150	40030	40690	40660	660	630	31720	644,880.15	49560
	20150128	40690	40660	40500	40650	39850	40190	40170	-470	-490	38010	763,562.09	39990
	20150129	40190	40170	40210	40440	39850	39870	40030	-300	-140	24400	488,376.20	36714
	20150130	39870	40030	39810	40010	39480	39570	39730	-460	-300	30696	609,906.38	29190
	20150202	39570	39730	40020	40630	39860	40570	40410	840	680	18870	381,316.55	26420
	20150203	40570	40410	40490	41000	40360	41000	40800	590	390	18170	370,673.55	19510
	20150204	41000	40800	41300	42090	41120	41330	41580	530	780	9890	205,626.80	16580
	20150205	41330	41580	41550	41610	41160	41260	41300	-320	-280	8480	175,135.05	14340
	20150206	41260	41300	41000	41800	41000	41790	41670	490	370	7530	156,904.65	11500
	20150209	41790	41670	41700	41700	41210	41370	41310	-300	-360	3590	74,160.55	10020
	20150210	41370	41310	41350	41500	41150	41300	41300	-10	-10	4020	83,028.40	9410
cu1503	20150105	45800	45620	45500	45570	44990	45080	45250	-540	-370	189194	4,281,292.33	325160
	20150106	45080	45250	44210	44910	43980	44800	44570	-450	-680	447986	9,984,125.32	310542
	20150107	44800	44570	44640	44840	44420	44650	44660	80	90	317816	7,097,905.19	301058
	20150108	44650	44660	44650	44890	44580	44680	44740	20	80	208524	4,665,708.20	297932
	20150109	44680	44740	45000	45050	44250	44250	44550	-490	-190	384066	8,556,984.88	308602
	20150112	44250	44550	44100	44450	43790	43960	44140	-590	-410	403724	8,911,880.75	307588
	20150113	43960	44140	43400	43720	42880	42890	43360	-1250	-780	404006	8,759,476.64	315628
	20150114	42890	43360	42300	42700	41190	41190	42150	-2170	-1210	408472	8,608,808.68	309766
	20150115	41190	42150	40600	41230	39820	40920	40520	-1230	-1630	1020638	20,681,356.34	312866
	20150116	40920	40520	41320	41710	40570	41040	41070	520	550	656280	13,478,902.41	303626
	20150119	41040	41070	40850	41910	40750	41770	41400	700	330	517860	10,721,865.17	287290
	20150120	41770	41400	41200	41590	41020	41250	41340	-150	-60	418760	8,656,379.43	276198
	20150121	41250	41340	41510	41590	41110	41260	41320	-80	-20	351830	7,270,012.29	268638
	20150122	41260	41320	41040	42180	40930	41560	41600	240	280	526812	10,959,265.46	253644
	20150123	41560	41600	41480	41800	40670	41010	41210	-590	-390	507322	10,454,898.69	243656
	20150126	41010	41210	40680	40800	39140	39470	39970	-1740	-1240	497198	9,937,135.03	219780
	20150127	39470	39970	39970	40950	39860	40520	40440	550	470	385612	7,797,304.27	199462
	20150128	40520	40440	40320	40450	39590	39970	39980	-470	-460	309462	6,187,377.27	182224
	20150129	39970	39980	40000	40190	39560	39640	39830	-340	-150	249496	4,969,106.13	171044
	20150130	39640	39830	39510	39820	39230	39450	39550	-380	-280	245102	4,847,863.20	159712
	20150202	39450	39550	39900	40660	39650	40530	40120	980	570	172556	3,462,205.05	144580
	20150203	40530	40120	40390	41000	40270	40920	40670	800	550	135792	2,761,594.16	134494
	20150204	40920	40670	41330	42110	41040	41310	41490	640	820	108632	2,253,576.11	125344
	20150205	41310	41490	41500	41690	41130	41240	41320	-250	-170	94156	1,945,542.74	120096
	20150206	41240	41320	41060	41880	41000	41830	41570	510	250	89362	1,857,585.38	113104
	20150209	41830	41570	41550	41740	41250	41470	41460	-100	-110	84300	1,747,780.08	109024
	20150210	41470	41460	41500	41700	41280	41470	41490	10	30	50996	1,057,993.17	105060
	20150211	41470	41490	41120	41360	41020	41240	41180	-250	-310	53456	1,100,791.79	100922
	20150212	41240	41180	41280	41340	41000	41210	41140	30	-40	39306	808,541.83	96570
	20150213	41210	41140	41580	42290	41330	42200	41880	1060	740	69138	1,447,756.94	88296
	20150216	42200	41880	42400	42400	41800	42300	41970	420	90	34560	725,341.64	87170
	20150217	42300	41970	42160	42330	42020	42240	42150	270	180	20220	426,225.58	84674
	20150225	42240	42150	42240	42380	42020	42150	42150	0	0	12426	261,895.82	82160
	20150226	42150	42150	42180	42770	42090	42690	42440	540	290	35366	750,498.26	69996
	20150227	42690	42440	43040	43070	42680	42880	42840	440	400	41178	882,084.48	55678
	20150302	42880	42840	42800	43400	42630	43350	43070	510	230	17278	372,155.39	52990
	20150303	43350	43070	43100	43370	42630	42700	42780	-370	-290	21080	450,988.00	47740
	20150304	42700	42780	42550	42680	42380	42610	42610	-170	-170	13390	285,315.95	44750
	20150305	42610	42610	42630	42630	42360	42560	42560	-50	-50	14210	302,441.70	40680
	20150306	42560	42560	42500	42740	42190	42260	42410	-300	-150	12670	268,713.45	37220
	20150309	42260	42410	42320	42430	41850	42410	42050	0	-360	17570	369,421.50	31050
	20150310	42410	42050	42370	42800	42300	42300	42520	250	470	12210	259,602.75	28100
	20150311	42300	42520	42100	42300	42000	42150	42210	-370	-310	11800	249,065.10	25040
	20150312	42150	42210	41290	42500	41290	42500	42090	290	-120	10260	215,967.55	20860
	20150313	42500	42090	42500	42800	42310	42670	42640	580	550	6820	145,429.15	18660
	20150316	42670	42640	42500	42700	41500	42700	42460	60	-180	4690	99,589.05	16160
cu1504	20150105	45470	45310	45120	45260	44660	44720	44940	-590	-370	73638	1,654,783.12	128618
	20150106	44720	44940	43800	44550	43610	44440	44250	-500	-690	179344	3,968,466.22	140898
	20150107	44440	44250	44280	44480	44050	44240	44300	-10	50	117592	2,604,875.92	146880
	20150108	44240	44300	44200	44520	44200	44340	44380	40	80	95434	2,117,914.12	145272
	20150109	44340	44380	44690	44690	43900	43900	44190	-480	-190	180492	3,988,312.02	161564
	20150112	43900	44190	43780	44100	43400	43590	43770	-600	-420	189136	4,139,669.58	178732
	20150113	43590	43770	43000	43340	42500	42520	42960	-1250	-810	214952	4,618,096.89	195202
	20150114	42520	42960	41950	42300	40810	40810	41740	-2150	-1220	217662	4,542,817.40	197350
	20150115	40810	41740	40350	41020	39640	40730	40350	-1010	-1390	414178	8,358,017.89	200092
	20150116	40730	40350	41080	41470	40330	40780	40800	430	450	323734	6,605,213.32	218520
	20150119	40780	40800	40630	41660	40510	41560	41190	760	390	298172	6,141,412.57	218328
	20150120	41560	41190	40970	41450	40860	41080	41170	-110	-20	259190	5,336,344.63	231348
	20150121	41080	41170	41310	41420	40970	41100	41180	-70	10	236348	4,866,962.75	243784
	20150122	41100	41180	40850	41990	40730	41390	41410	210	230	350340	7,255,391.20	253778
	20150123	41390	41410	41290	41620	40410	40750	40910	-660	-500	480318	9,827,207.51	302022
	20150126	40750	40910	40420	40540	38860	39250	39660	-1660	-1250	715356	14,188,606.70	338392
	20150127	39250	39660	39730	40730	39650	40260	40210	600	550	604476	12,154,952.33	352686
	20150128	40260	40210	40050	40210	39260	39690	39690	-520	-520	687248	13,641,591.65	372070
	20150129	39690	39690	39710	39960	39240	39320	39520	-370	-170	602624	11,909,556.45	388782
	20150130	39320	39520	39160	39520	38890	39090	39210	-430	-310	647928	12,703,851.81	414782
	20150202	39090	39210	39580	40370	39330	40290	39830	1080	620	586236	11,676,070.74	416396
	20150203	40290	39830	40110	40830	40050	40760	40440	930	610	543294	10,987,361.16	400826
	20150204	40760	40440	41150	41980	40840	41160	41260	720	820	616042	12,710,975.99	384294
	20150205	41160	41260	41360	41540	40930	41000	41190	-260	-70	573146	11,804,155.61	390944
	20150206	41000	41190	40870	41710	40790	41670	41320	480	130	522050	10,787,934.68	367218
	20150209	41670	41320	41400	41600	41040	41260	41310	-60	-10	442210	9,136,037.49	341890
	20150210	41260	41310	41280	41530	41080	41320	41320	10	10	300508	6,208,993.20	326612
	20150211	41320	41320	40990	41270	40860	41100	41040	-220	-280	358612	7,359,527.96	294416
	20150212	41100	41040	41200	41240	40840	41110	41040	70	0	280814	5,763,546.01	287330
	20150213	41110	41040	41330	42280	41240	42120	41730	1080	690	429840	8,970,212.89	270008
	20150216	42120	41730	41930	42250	41720	42220	41910	490	180	239460	5,018,683.35	252100
	20150217	42220	41910	42100	42290	41950	42200	42100	290	190	154340	3,249,499.99	236648
	20150225	42200	42100	42310	42370	41940	42080	42090	-20	-10	93516	1,968,335.85	226524
	20150226	42080	42090	42120	42770	42030	42680	42370	590	280	210814	4,466,513.46	196110
	20150227	42680	42370	43000	43080	42650	42910	42840	540	470	202076	4,329,282.17	171354
	20150302	42910	42840	42800	43430	42560	43310	42990	470	150	134754	2,896,899.42	161074
	20150303	43310	42990	42990	43360	42600	42690	42900	-300	-90	124360	2,667,915.13	152874
	20150304	42690	42900	42650	42700	42300	42610	42580	-290	-320	81116	1,727,007.22	149794
	20150305	42610	42580	42660	42760	42320	42630	42580	50	0	73876	1,572,918.61	146114
	20150306	42630	42580	42580	42860	42200	42330	42500	-250	-80	59764	1,270,206.97	143804
	20150309	42330	42500	42370	42470	41860	42450	42120	-50	-380	98300	2,070,210.10	139140
	20150310	42450	42120	42510	42870	42310	42320	42610	200	490	56438	1,202,461.99	138732
	20150311	42320	42610	42210	42390	42050	42160	42220	-450	-390	52356	1,105,399.16	136016
	20150312	42160	42220	42120	42620	41920	42570	42180	350	-40	65110	1,373,474.39	133182
	20150313	42570	42180	42820	42970	42420	42790	42740	610	560	62140	1,327,941.85	125468
	20150316	42790	42740	42680	42800	42420	42780	42630	40	-110	40366	860,513.33	121764
	20150317	42780	42630	42800	42940	42260	42410	42540	-220	-90	49800	1,059,292.98	113374
	20150318	42410	42540	42150	42400	41660	41660	42130	-880	-410	53174	1,120,252.94	107112
	20150319	41660	42130	41590	42080	41200	41750	41680	-380	-450	47568	991,471.53	98656
	20150320	41750	41680	42090	42490	41880	42040	42180	360	500	34508	727,884.90	95750
	20150323	42040	42180	42480	44050	42420	43650	43440	1470	1260	61192	1,329,102.12	85434
	20150324	43650	43440	43740	44620	43540	43880	43920	440	480	46394	1,018,822.87	79182
	20150325	43880	43920	43800	43960	43470	43730	43660	-190	-260	33710	735,987.25	74844
	20150326	43730	43660	43760	44040	43660	43990	43910	330	250	39602	869,549.08	65344
	20150327	43990	43910	44000	44370	43500	43870	43820	-40	-90	36280	794,910.02	58280
	20150330	43870	43820	43760	44000	43530	43900	43740	80	-80	33476	732,124.84	51712
	20150331	43900	43740	43920	44100	43320	43320	43760	-420	20	26826	586,999.25	45536
	20150401	43320	43760	43530	43680	43250	43330	43440	-430	-320	13446	292,077.62	43650
	20150402	43330	43440	43300	43650	43190	43620	43450	180	10	13050	283,531.60	42370
	20150403	43620	43450	43440	43550	43280	43390	43450	-60	0	12250	266,178.55	40100
	20150407	43390	43450	43480	43670	43480	43550	43550	100	100	12490	272,011.90	35540
	20150408	43550	43550	43630	43850	43470	43540	43570	-10	20	16720	364,256.20	30520
	20150409	43540	43570	43490	43600	43210	43420	43350	-150	-220	15030	325,795.25	27890
	20150410	43420	43350	43490	43700	43340	43620	43530	270	180	17850	388,531.65	23670
	20150413	43620	43530	43620	44000	43500	43750	43690	220	160	10490	229,197.15	19690
	20150414	43750	43690	43700	43700	42900	43010	43380	-680	-310	9400	203,917.50	16390
	20150415	43010	43380	43200	43920	42750	43090	43080	-290	-300	4570	98,443.55	15920
cu1505	20150105	45240	45080	44980	45050	44450	44580	44710	-500	-370	21854	488,580.24	50930
	20150106	44580	44710	43680	44300	43410	44250	44040	-460	-670	39180	862,807.85	57088
	20150107	44250	44040	44090	44240	43800	43980	44040	-60	0	20844	459,010.17	59612
	20150108	43980	44040	43880	44230	43880	44060	44080	20	40	18310	403,578.95	61138
	20150109	44060	44080	44360	44400	43640	43650	43920	-430	-160	30866	677,952.60	64892
	20150112	43650	43920	43460	43810	43120	43270	43480	-650	-440	36958	803,593.02	73866
	20150113	43270	43480	42670	43020	42200	42210	42650	-1270	-830	48186	1,027,789.08	85700
	20150114	42210	42650	41600	41960	40510	40510	41420	-2140	-1230	51142	1,059,310.84	90298
	20150115	40510	41420	39610	40900	39490	40610	40180	-810	-1240	132456	2,661,366.89	92810
	20150116	40610	40180	40910	41300	40150	40640	40630	460	450	86926	1,766,298.65	98506
	20150119	40640	40630	40500	41490	40340	41410	41060	780	430	91228	1,872,926.95	99118
	20150120	41410	41060	40880	41360	40740	40980	41070	-80	10	83282	1,710,284.12	101836
	20150121	40980	41070	41250	41300	40880	41000	41090	-70	20	54028	1,110,027.91	107232
	20150122	41000	41090	40760	41830	40650	41270	41320	180	230	90890	1,878,146.45	109340
	20150123	41270	41320	41150	41500	40280	40600	40770	-720	-550	118018	2,406,063.95	123838
	20150126	40600	40770	40250	40390	38730	39120	39530	-1650	-1240	180068	3,559,063.29	142734
	20150127	39120	39530	39690	40620	39540	40180	40090	650	560	153348	3,073,951.80	149844
	20150128	40180	40090	39930	40100	39130	39530	39540	-560	-550	156454	3,093,453.90	159686
	20150129	39530	39540	39600	39790	39000	39110	39330	-430	-210	155880	3,065,763.05	175272
	20150130	39110	39330	39000	39300	38690	38870	39000	-460	-330	176290	3,438,242.50	189546
	20150202	38870	39000	39410	40220	39130	40170	39700	1170	700	194134	3,853,644.19	185960
	20150203	40170	39700	39950	40740	39930	40650	40360	950	660	215952	4,358,243.83	186362
	20150204	40650	40360	41040	41890	40040	41020	41180	660	820	284154	5,850,792.28	178532
	20150205	41020	41180	41300	41410	40800	40850	41040	-330	-140	224582	4,608,694.10	191814
	20150206	40850	41040	40780	41600	40630	41530	41230	490	190	226056	4,660,667.95	191660
	20150209	41530	41230	41260	41460	40850	41100	41130	-130	-100	212198	4,364,437.04	207948
	20150210	41100	41130	41100	41360	40900	41160	41140	30	10	161450	3,321,277.81	219692
	20150211	41160	41140	40800	41090	40660	40930	40870	-210	-270	216186	4,418,102.16	239504
	20150212	40930	40870	41040	41060	40650	40930	40860	60	-10	182414	3,726,865.96	250358
	20150213	40930	40860	41170	42120	41070	41980	41590	1120	730	295288	6,141,970.26	249962
	20150216	41980	41590	41800	42080	41540	42060	41750	470	160	188022	3,925,308.53	246268
	20150217	42060	41750	41950	42100	41770	42000	41930	250	180	132284	2,773,518.71	250464
	20150225	42000	41930	42160	42190	41780	41900	41920	-30	-10	103964	2,179,400.28	270800
	20150226	41900	41920	41940	42610	41850	42510	42190	590	270	301590	6,362,466.89	313040
	20150227	42510	42190	42810	42930	42450	42730	42690	540	500	417708	8,916,620.95	334112
	20150302	42730	42690	42600	43280	42370	43200	42830	510	140	402994	8,630,981.78	320530
	20150303	43200	42830	42890	43220	42430	42540	42800	-290	-30	403956	8,646,647.95	324956
	20150304	42540	42800	42480	42560	42120	42460	42400	-340	-400	279060	5,916,290.16	328168
	20150305	42460	42400	42580	42620	42140	42500	42420	100	20	313682	6,653,417.66	333640
	20150306	42500	42420	42420	42720	42060	42200	42390	-220	-30	321600	6,817,213.29	339796
	20150309	42200	42390	42250	42350	41670	42300	42000	-90	-390	455574	9,568,976.74	322428
	20150310	42300	42000	42320	42760	42210	42230	42510	230	510	374268	7,955,278.04	319692
	20150311	42230	42510	42060	42320	41910	42080	42100	-430	-410	309400	6,513,830.79	315952
	20150312	42080	42100	42040	42610	41800	42560	42090	460	-10	456438	9,607,528.87	311016
	20150313	42560	42090	42710	43000	42400	42840	42690	750	600	415176	8,863,615.11	302458
	20150316	42840	42690	42700	42850	42440	42810	42620	120	-70	299488	6,383,463.71	300712
	20150317	42810	42620	42600	42960	42260	42430	42650	-190	30	363952	7,762,288.16	291280
	20150318	42430	42650	42040	42420	41590	41620	42120	-1030	-530	392596	8,269,810.77	289070
	20150319	41620	42120	41430	42790	41120	41720	41510	-400	-610	406544	8,438,930.30	275844
	20150320	41720	41510	42030	42500	41850	42040	42130	530	620	367510	7,741,951.20	270656
	20150323	42040	42130	42480	44050	42400	43690	43280	1560	1150	593582	12,845,511.81	231790
	20150324	43690	43280	43660	44760	43570	43910	43920	630	640	368804	8,100,754.79	206084
	20150325	43910	43920	43880	43990	43460	43740	43730	-180	-190	226328	4,948,673.11	193636
	20150326	43740	43730	43770	44100	43670	44040	43910	310	180	193132	4,240,551.26	175690
	20150327	44040	43910	44150	44440	43500	43910	43960	0	50	222244	4,885,355.10	157050
	20150330	43910	43960	43780	44050	43550	43900	43730	-60	-230	156164	3,414,653.40	148960
	20150331	43900	43730	43910	44140	43450	43460	43840	-270	110	118988	2,608,463.43	141514
	20150401	43460	43840	43540	43750	43210	43380	43480	-460	-360	91398	1,987,150.36	136628
	20150402	43380	43480	43180	43700	43150	43640	43450	160	-30	86428	1,877,738.18	133532
	20150403	43640	43450	43450	43540	43280	43390	43440	-60	-10	49672	1,078,941.02	132724
	20150407	43390	43440	43390	43640	43390	43570	43560	130	120	28690	624,868.41	131346
	20150408	43570	43560	43620	43900	43460	43560	43620	0	60	46924	1,023,645.63	127166
	20150409	43560	43620	43530	43630	43180	43430	43360	-190	-260	45392	984,149.77	125322
	20150410	43430	43360	43490	43650	43280	43600	43500	240	140	40576	882,542.63	124188
	20150413	43600	43500	43550	44060	43530	43750	43710	250	210	46358	1,013,219.09	123028
	20150414	43750	43710	43750	43770	42750	43020	43260	-690	-450	67696	1,464,459.86	116818
	20150415	43020	43260	42950	43280	42730	43130	43040	-130	-220	51462	1,107,531.86	112032
	20150416	43130	43040	42980	43590	42850	43480	43350	440	310	47440	1,028,472.93	105982
	20150417	43480	43350	43900	43990	43680	43750	43810	400	460	48230	1,056,667.67	99266
	20150420	43750	43810	43500	44100	43500	43910	43920	100	110	44162	969,808.01	94994
	20150421	43910	43920	43510	43570	43280	43470	43460	-450	-460	50310	1,093,383.22	87774
	20150422	43470	43460	43240	43490	43210	43400	43350	-60	-110	41466	898,871.37	83088
	20150423	43400	43350	43320	43470	42900	43180	43160	-170	-190	61916	1,336,291.15	81244
	20150424	43180	43160	43280	43570	43250	43410	43420	250	260	32946	715,346.62	76760
	20150427	43410	43420	43910	44090	43620	43950	43890	530	470	43222	948,610.21	71236
	20150428	43950	43890	44130	44340	43830	43970	44050	80	160	37062	816,390.54	64370
	20150429	43970	44050	44040	44270	43910	44000	44020	-50	-30	29366	646,420.35	58200
	20150430	44000	44020	44070	44550	44020	44440	44300	420	280	27650	612,482.87	52562
cu1506	20150105	45040	44940	44680	44870	44310	44400	44530	-540	-410	3198	71,205.55	25540
	20150106	44400	44530	43560	44110	43260	44040	43900	-490	-630	10984	241,101.37	27170
	20150107	44040	43900	43820	44040	43600	43720	43810	-180	-90	11210	245,558.33	29192
	20150108	43720	43810	43660	43980	43660	43800	43840	-10	30	10280	225,361.02	31618
	20150109	43800	43840	44110	44150	43390	43430	43660	-410	-180	11264	245,938.32	33918
	20150112	43430	43660	43380	43600	42900	43060	43250	-600	-410	9610	207,849.47	35466
	20150113	43060	43250	42400	42780	41960	41980	42450	-1270	-800	14276	303,046.51	38600
	20150114	41980	42450	41430	41700	40320	40320	41090	-2130	-1360	13730	282,147.69	41216
	20150115	40320	41090	39420	40800	39340	40480	40100	-610	-990	50820	1,019,120.76	43194
	20150116	40480	40100	40880	41180	40050	40520	40570	420	470	28040	568,875.46	46718
	20150119	40520	40570	40300	41390	40230	41390	41000	820	430	20786	426,132.35	47692
	20150120	41390	41000	40700	41280	40640	40920	41030	-80	30	31074	637,507.95	45486
	20150121	40920	41030	41150	41230	40840	40940	41050	-90	20	19716	404,705.00	47866
	20150122	40940	41050	40640	41750	40600	41250	41280	200	230	25320	522,635.05	46838
	20150123	41250	41280	41150	41460	40200	40520	40670	-760	-610	28988	589,609.76	52628
	20150126	40520	40670	40280	40340	38630	39080	39370	-1590	-1300	51826	1,020,351.28	60116
	20150127	39080	39370	39600	40550	39490	40110	40070	740	700	51664	1,035,344.97	64494
	20150128	40110	40070	39920	40040	39080	39440	39460	-630	-610	37076	731,655.89	67058
	20150129	39440	39460	39500	39680	38970	39000	39220	-460	-240	41852	820,726.76	70444
	20150130	39000	39220	38900	39200	38600	38780	38900	-440	-320	42760	831,893.15	77058
	20150202	38780	38900	39240	40140	39030	40040	39650	1140	750	49956	990,387.24	77146
	20150203	40040	39650	39850	40660	39850	40570	40300	920	650	54258	1,093,569.16	75522
	20150204	40570	40300	41000	41810	40620	40960	41140	660	840	60272	1,239,981.72	80912
	20150205	40960	41140	41140	41320	40710	40710	40930	-430	-210	45444	930,049.30	81784
	20150206	40710	40930	40570	41490	40530	41430	41160	500	230	41858	861,589.10	80104
	20150209	41430	41160	41230	41380	40760	41000	41010	-160	-150	36830	755,343.41	84952
	20150210	41000	41010	41070	41240	40810	41060	41040	50	30	27894	572,443.35	86800
	20150211	41060	41040	40760	40980	40540	40820	40760	-220	-280	44348	903,895.20	89172
	20150212	40820	40760	40980	40980	40560	40850	40730	90	-30	25010	509,416.81	91358
	20150213	40850	40730	41060	42000	40950	41890	41520	1160	790	51680	1,073,069.92	88828
	20150216	41890	41520	41720	41990	41440	41950	41650	430	130	30372	632,584.73	89868
	20150217	41950	41650	41770	42000	41660	41930	41820	280	170	32460	678,846.89	85216
	20150225	41930	41820	42080	42280	41690	41810	41820	-10	0	23102	483,135.78	88222
	20150226	41810	41820	41880	42510	41710	42380	42130	560	310	84884	1,788,430.35	106310
	20150227	42380	42130	42650	42820	42350	42620	42580	490	450	78206	1,665,159.19	109744
	20150302	42620	42580	42510	43140	42260	43000	42750	420	170	122786	2,624,999.65	119560
	20150303	43000	42750	42750	43110	42320	42420	42670	-330	-80	116090	2,476,916.53	128270
	20150304	42420	42670	42400	42440	42000	42360	42300	-310	-370	83770	1,771,867.12	134196
	20150305	42360	42300	42480	42510	42020	42380	42320	80	20	88078	1,863,777.58	138746
	20150306	42380	42320	42300	42610	41980	42130	42270	-190	-50	99958	2,112,720.41	140918
	20150309	42130	42270	42180	42230	41550	42170	41880	-100	-390	170050	3,561,418.37	145366
	20150310	42170	41880	42180	42670	42080	42100	42360	220	480	156524	3,315,258.20	159172
	20150311	42100	42360	41970	42220	41790	41970	41990	-390	-370	128850	2,705,549.53	161532
	20150312	41970	41990	41910	42550	41710	42500	42030	510	40	196664	4,133,225.85	161306
	20150313	42500	42030	42610	43040	42400	42860	42710	830	680	183550	3,920,627.63	167476
	20150316	42860	42710	42750	42880	42430	42850	42640	140	-70	157974	3,368,252.11	175122
	20150317	42850	42640	42620	43030	42300	42450	42670	-190	30	212744	4,539,148.86	197446
	20150318	42450	42670	42050	42460	41570	41600	42100	-1070	-570	273746	5,763,186.50	229072
	20150319	41600	42100	41430	41980	41080	41710	41540	-390	-560	291716	6,059,424.38	246774
	20150320	41710	41540	42060	42520	41820	42020	42130	480	590	351498	7,404,914.85	256722
	20150323	42020	42130	42500	44040	42400	43690	43300	1560	1170	571670	12,378,811.99	267430
	20150324	43690	43300	43650	44690	43530	43850	43910	550	610	459758	10,094,919.46	297482
	20150325	43850	43910	43810	43940	43390	43680	43670	-230	-240	413712	9,033,908.11	317368
	20150326	43680	43670	43700	44000	43610	43930	43820	260	150	419412	9,190,697.67	334338
	20150327	43930	43820	44050	44340	43360	43770	43870	-50	50	560376	12,294,434.48	361418
	20150330	43770	43870	43690	43990	43410	43830	43620	-40	-250	431488	9,411,883.79	370238
	20150331	43830	43620	43820	44070	43330	43350	43770	-270	150	421054	9,216,319.87	383528
	20150401	43350	43770	43430	43670	43080	43260	43380	-510	-390	407462	8,838,839.82	387568
	20150402	43260	43380	43120	43630	43030	43520	43350	140	-30	435988	9,450,731.56	378180
	20150403	43520	43350	43310	43450	43160	43280	43330	-70	-20	273380	5,923,167.18	371554
	20150407	43280	43330	43300	43560	43300	43480	43450	150	120	116826	2,538,524.21	375402
	20150408	43480	43450	43550	43820	43360	43460	43580	10	130	272338	5,935,146.72	372156
	20150409	43460	43580	43380	43540	43050	43310	43280	-270	-300	238872	5,169,659.71	379268
	20150410	43310	43280	43380	43600	43150	43530	43380	250	100	235236	5,102,355.40	375940
	20150413	43530	43380	43510	44000	43430	43680	43670	300	290	317282	6,928,593.05	377226
	20150414	43680	43670	43650	43710	42580	42860	43160	-810	-510	361446	7,800,742.09	387860
	20150415	42860	43160	42760	43180	42570	43000	42890	-160	-270	330834	7,096,218.28	381474
	20150416	43000	42890	42830	43510	42720	43340	43140	450	250	274218	5,916,163.72	361406
	20150417	43340	43140	43780	43950	43590	43690	43750	550	610	295034	6,455,181.43	336706
	20150420	43690	43750	43590	44200	43510	43870	43800	120	50	245716	5,382,227.97	325646
	20150421	43870	43800	43380	43500	43170	43370	43360	-430	-440	248810	5,394,635.04	307216
	20150422	43370	43360	43180	43430	43080	43310	43250	-50	-110	184900	3,999,357.52	296946
	20150423	43310	43250	43210	43390	42670	42990	43080	-260	-170	273026	5,881,219.61	282348
	20150424	42990	43080	43130	43440	43110	43310	43270	230	190	202648	4,384,342.33	256692
	20150427	43310	43270	43690	44050	43530	43880	43760	610	490	251608	5,505,840.07	229510
	20150428	43880	43760	43900	44280	43730	43910	44010	150	250	194158	4,272,757.01	201414
	20150429	43910	44010	43950	44180	43810	43930	43970	-80	-40	158298	3,480,582.56	182258
	20150430	43930	43970	43940	44430	43920	44390	44210	420	240	132608	2,931,775.69	162144
cu1507	20150105	45000	44930	44730	44770	44210	44280	44340	-650	-590	868	19,245.98	9280
	20150106	44280	44340	43380	43970	43200	43910	43750	-430	-590	2406	52,640.46	10362
	20150107	43910	43750	43850	43900	43460	43540	43660	-210	-90	4622	100,913.26	12578
	20150108	43540	43660	43630	43800	43570	43650	43690	-10	30	1736	37,924.55	12862
	20150109	43650	43690	43950	43980	43260	43300	43490	-390	-200	2900	63,071.21	13416
	20150112	43300	43490	43220	43500	42770	42880	43060	-610	-430	3034	65,330.01	14504
	20150113	42880	43060	42250	42600	41800	41800	42270	-1260	-790	5318	112,407.19	16596
	20150114	41800	42270	41220	41540	40150	40150	40930	-2120	-1340	4166	85,277.76	17970
	20150115	40150	40930	39250	40700	39240	40480	40120	-450	-810	13006	260,931.15	19342
	20150116	40480	40120	40910	41130	40020	40450	40400	330	280	7838	158,357.26	21358
	20150119	40450	40400	40280	41300	40180	41290	40910	890	510	4636	94,850.29	22318
	20150120	41290	40910	40700	41220	40580	40870	40990	-40	80	11328	232,207.07	22756
	20150121	40870	40990	41090	41180	40830	40890	40990	-100	0	3456	70,841.33	24094
	20150122	40890	40990	40670	41630	40540	41160	41170	170	180	3820	78,653.52	24764
	20150123	41160	41170	41160	41350	40150	40490	40560	-680	-610	6126	124,241.80	25562
	20150126	40490	40560	40220	40250	38550	39060	39340	-1500	-1220	12128	238,617.06	28998
	20150127	39060	39340	39470	40550	39470	40100	40030	760	690	8054	161,219.86	29982
	20150128	40100	40030	39750	39970	39000	39400	39400	-630	-630	7792	153,526.91	30854
	20150129	39400	39400	39440	39610	38930	38980	39160	-420	-240	9898	193,840.24	33536
	20150130	38980	39160	38720	39150	38530	38680	38800	-480	-360	9508	184,480.47	36068
	20150202	38680	38800	39000	40050	38950	40000	39550	1200	750	12330	243,855.26	36506
	20150203	40000	39550	39830	40570	39790	40480	40220	930	670	19254	387,232.65	36162
	20150204	40480	40220	40710	41720	40540	40890	41080	670	860	17570	360,936.26	39420
	20150205	40890	41080	41020	41230	40610	40630	40860	-450	-220	8726	178,281.53	40372
	20150206	40630	40860	40510	41400	40440	41400	41080	540	220	12730	261,498.23	40444
	20150209	41400	41080	41150	41280	40680	40900	40910	-180	-170	15094	308,792.64	43646
	20150210	40900	40910	40880	41110	40690	41010	40930	100	20	11260	230,441.04	46118
	20150211	41010	40930	40630	40880	40450	40800	40660	-130	-270	10878	221,174.84	46248
	20150212	40800	40660	40800	40830	40480	40740	40610	80	-50	8146	165,441.30	46616
	20150213	40740	40610	41060	41900	40880	41770	41410	1160	800	12922	267,559.93	46114
	20150216	41770	41410	41660	41850	41340	41850	41560	440	150	8032	166,941.29	45258
	20150217	41850	41560	41730	41910	41580	41830	41760	270	200	8562	178,779.88	43238
	20150225	41830	41760	42000	42000	41600	41720	41720	-40	-40	4398	91,753.28	44088
	20150226	41720	41720	41760	42390	41620	42270	41970	550	250	20934	439,330.38	49558
	20150227	42270	41970	42510	42700	42240	42530	42490	560	520	16170	343,533.46	51858
	20150302	42530	42490	42430	43050	42170	42990	42720	500	230	22490	480,413.03	54268
	20150303	42990	42720	42620	43010	42240	42310	42520	-410	-200	15698	333,740.78	55424
	20150304	42310	42520	42240	42350	41910	42260	42210	-260	-310	13556	286,160.84	57438
	20150305	42260	42210	42390	42400	41950	42290	42240	80	30	12780	269,968.34	58222
	20150306	42290	42240	42220	42540	41920	42050	42170	-190	-70	12208	257,430.31	58590
	20150309	42050	42170	42050	42140	41450	42060	41780	-110	-390	28442	594,238.27	63448
	20150310	42060	41780	42070	42560	41960	42000	42260	220	480	26004	549,519.23	66764
	20150311	42000	42260	41760	42110	41700	41890	41900	-370	-360	16976	355,672.07	66530
	20150312	41890	41900	41840	42500	41610	42420	42040	520	140	32670	686,846.44	66674
	20150313	42420	42040	42600	43050	42370	42860	42730	820	690	39436	842,599.13	68330
	20150316	42860	42730	42730	42910	42450	42900	42660	170	-70	25244	538,535.37	71464
	20150317	42900	42660	42650	43050	42360	42510	42680	-150	20	40652	867,684.14	75014
	20150318	42510	42680	42160	42500	41610	41610	42160	-1070	-520	58826	1,240,152.43	78194
	20150319	41610	42160	41450	42460	41100	41720	41640	-440	-520	57600	1,199,276.03	83316
	20150320	41720	41640	42050	42550	41860	42030	42190	390	550	72088	1,521,014.68	88632
	20150323	42030	42190	42480	44090	42450	43680	43400	1490	1210	165986	3,602,040.75	114852
	20150324	43680	43400	43750	44590	43550	43830	43930	430	530	111214	2,443,087.33	123650
	20150325	43830	43930	43810	43940	43400	43660	43650	-270	-280	75788	1,654,281.13	130052
	20150326	43660	43650	43660	43960	43590	43830	43790	180	140	82310	1,802,500.47	138830
	20150327	43830	43790	43930	44290	43310	43710	43780	-80	-10	129564	2,836,161.02	152966
	20150330	43710	43780	43600	43940	43350	43810	43580	30	-200	94596	2,061,418.81	155994
	20150331	43810	43580	43800	44030	43290	43310	43720	-270	140	104100	2,275,975.99	163542
	20150401	43310	43720	43440	43650	43090	43230	43360	-490	-360	108932	2,361,891.26	166278
	20150402	43230	43360	43120	43600	43030	43450	43340	90	-20	148424	3,216,623.45	162358
	20150403	43450	43340	43260	43410	43100	43210	43270	-130	-70	95210	2,060,293.72	164784
	20150407	43210	43270	43270	43500	43230	43430	43400	160	130	44732	970,693.40	165038
	20150408	43430	43400	43490	43750	43300	43410	43490	10	90	94760	2,060,861.90	168806
	20150409	43410	43490	43300	43490	43010	43260	43210	-230	-280	96092	2,076,319.62	175766
	20150410	43260	43210	43300	43500	43080	43450	43300	240	90	106498	2,305,747.15	181204
	20150413	43450	43300	43420	43900	43350	43620	43570	320	270	113530	2,473,761.74	182902
	20150414	43620	43570	43550	43640	42480	42770	43060	-800	-510	161982	3,487,518.64	197524
	20150415	42770	43060	42700	43100	42490	42910	42820	-150	-240	139966	2,997,077.11	203390
	20150416	42910	42820	42780	43420	42640	43250	43090	430	270	139508	3,005,725.79	206302
	20150417	43250	43090	43670	43840	43480	43600	43650	510	560	158680	3,463,437.70	213542
	20150420	43600	43650	43470	44050	43400	43760	43720	110	70	160708	3,513,638.63	226590
	20150421	43760	43720	43260	43390	43080	43240	43250	-480	-470	168176	3,637,587.60	234800
	20150422	43240	43250	43020	43320	42950	43200	43140	-50	-110	151950	3,277,955.50	245358
	20150423	43200	43140	43110	43280	42540	42850	42940	-290	-200	257064	5,519,199.87	269594
	20150424	42850	42940	43030	43310	42990	43190	43150	250	210	164886	3,557,624.51	270852
	20150427	43190	43150	43610	43970	43390	43730	43670	580	520	318420	6,952,701.87	284454
	20150428	43730	43670	43740	44140	43570	43740	43850	70	180	312606	6,855,286.32	311234
	20150429	43740	43850	43800	44050	43640	43730	43830	-120	-20	306368	6,714,098.82	345074
	20150430	43730	43830	43770	44300	43750	44240	44070	410	240	316342	6,971,883.99	351078
cu1508	20150105	44870	44760	44660	44660	44120	44250	44230	-510	-530	244	5,397.23	4320
	20150106	44250	44230	43380	43880	43100	43800	43750	-430	-480	1234	26,993.98	5068
	20150107	43800	43750	43670	43810	43330	43420	43560	-330	-190	2070	45,091.75	6456
	20150108	43420	43560	43500	43700	43430	43510	43570	-50	10	662	14,423.56	6668
	20150109	43510	43570	43730	43730	43170	43200	43330	-370	-240	1026	22,233.41	6794
	20150112	43200	43330	43240	43270	42650	42770	43080	-560	-250	1860	40,067.63	6722
	20150113	42770	43080	42100	42480	41670	41710	42150	-1370	-930	2056	43,335.50	7532
	20150114	41710	42150	40650	41400	40040	40040	40730	-2110	-1420	2820	57,437.38	9008
	20150115	40040	40730	39890	40600	39270	40410	39960	-320	-770	5610	112,111.42	9576
	20150116	40410	39960	40670	40980	39950	40360	40250	400	290	2514	50,603.57	10728
	20150119	40360	40250	40190	41230	40190	41190	40820	940	570	1288	26,289.61	10678
	20150120	41190	40820	40930	41180	40550	40800	40940	-20	120	2152	44,051.48	10890
	20150121	40800	40940	41000	41130	40820	40850	40980	-90	40	734	15,040.00	11068
	20150122	40850	40980	40720	41550	40530	41110	41130	130	150	1008	20,729.68	11158
	20150123	41110	41130	41070	41350	40140	40460	40480	-670	-650	2508	50,772.11	12360
	20150126	40460	40480	40210	40210	38520	39060	39370	-1420	-1110	4498	88,544.18	13938
	20150127	39060	39370	39590	40530	39510	40120	40050	750	680	1680	33,642.70	13706
	20150128	40120	40050	39900	39980	39030	39380	39360	-670	-690	2366	46,570.18	14278
	20150129	39380	39360	39450	39450	38920	38930	39110	-430	-250	2164	42,317.81	14692
	20150130	38930	39110	38810	39080	38520	38660	38750	-450	-360	2216	42,936.69	15794
	20150202	38660	38750	39140	40000	38920	39940	39530	1190	780	2020	39,928.92	15632
	20150203	39940	39530	39840	40530	39760	40470	40200	940	670	3788	76,150.98	14436
	20150204	40470	40200	40880	41660	40510	40830	41110	630	910	2614	53,737.77	14814
	20150205	40830	41110	41090	41170	40580	40580	40760	-530	-350	2072	42,234.52	14918
	20150206	40580	40760	40480	41350	40440	41290	41040	530	280	1192	24,460.35	15178
	20150209	41290	41040	41120	41210	40650	40850	40860	-190	-180	1288	26,317.31	15502
	20150210	40850	40860	40770	41060	40690	40920	40910	60	50	1268	25,942.44	15544
	20150211	40920	40910	40630	40810	40420	40640	40620	-270	-290	2998	60,894.41	15600
	20150212	40640	40620	40780	40790	40420	40680	40570	60	-50	1936	39,272.36	16056
	20150213	40680	40570	40820	41840	40820	41700	41510	1130	940	2144	44,505.87	15824
	20150216	41700	41510	41630	41830	41330	41830	41510	320	0	1620	33,624.61	16106
	20150217	41830	41510	41510	41870	41330	41770	41700	260	190	1346	28,064.36	16352
	20150225	41770	41700	41780	41910	41560	41670	41650	-30	-50	540	11,247.64	16420
	20150226	41670	41650	41790	42300	41570	42250	41830	600	180	3492	73,046.00	17346
	20150227	42250	41830	42500	42640	42200	42490	42430	660	600	2028	43,025.18	17818
	20150302	42490	42430	42380	43000	42130	42970	42670	540	240	3350	71,475.66	17710
	20150303	42970	42670	42700	42980	42200	42280	42470	-390	-200	3182	67,583.00	18542
	20150304	42280	42470	42210	42310	41890	42230	42200	-240	-270	2320	48,957.91	18672
	20150305	42230	42200	42380	42380	41910	42270	42210	70	10	2264	47,782.92	19150
	20150306	42270	42210	42180	42480	41890	42020	42150	-190	-60	3830	80,717.47	19862
	20150309	42020	42150	42100	42100	41420	42020	41660	-130	-490	8032	167,346.66	22314
	20150310	42020	41660	41930	42490	41900	41970	42190	310	530	3934	82,991.50	22856
	20150311	41970	42190	41860	42050	41660	41850	41820	-340	-370	3928	82,136.24	23878
	20150312	41850	41820	41760	42460	41560	42430	41970	610	150	5654	118,664.62	24110
	20150313	42430	41970	42500	43030	42380	42900	42670	930	700	6718	143,361.51	23566
	20150316	42900	42670	42770	42930	42480	42900	42680	230	10	4300	91,764.40	24062
	20150317	42900	42680	42710	43060	42410	42550	42750	-130	70	8448	180,576.44	25718
	20150318	42550	42750	42200	42540	41650	41680	42160	-1070	-590	15140	319,194.86	29006
	20150319	41680	42160	41500	42050	41120	41750	41660	-410	-500	12290	256,011.07	30670
	20150320	41750	41660	42230	42580	41880	42090	42210	430	550	9570	201,987.24	30890
	20150323	42090	42210	42510	44120	42490	43700	43380	1490	1170	28390	615,820.48	32380
	20150324	43700	43380	43740	44580	43600	43820	43950	440	570	23804	523,189.03	36124
	20150325	43820	43950	43910	43950	43400	43670	43660	-280	-290	14930	325,990.29	38514
	20150326	43670	43660	43740	43920	43600	43770	43760	110	100	12808	280,268.93	39050
	20150327	43770	43760	43920	44250	43280	43650	43730	-110	-30	20238	442,578.26	43786
	20150330	43650	43730	43650	43900	43310	43740	43560	10	-170	17222	375,158.68	44512
	20150331	43740	43560	43750	43980	43290	43290	43680	-270	120	16396	358,117.59	46402
	20150401	43290	43680	43350	43640	43110	43220	43360	-460	-320	18448	400,003.30	48794
	20150402	43220	43360	43090	43580	43020	43460	43340	100	-20	20010	433,633.33	48848
	20150403	43460	43340	43250	43360	43070	43160	43230	-180	-110	15958	344,962.35	50658
	20150407	43160	43230	43200	43460	43200	43390	43360	160	130	10812	234,409.15	51706
	20150408	43390	43360	43410	43690	43260	43370	43450	10	90	20734	450,544.72	54748
	20150409	43370	43450	43320	43460	42970	43220	43130	-230	-320	20276	437,349.32	57974
	20150410	43220	43130	43290	43450	43010	43380	43250	250	120	20848	450,879.12	60674
	20150413	43380	43250	43260	43850	43260	43560	43520	310	270	24232	527,336.65	61398
	20150414	43560	43520	43500	43580	42440	42710	42910	-810	-610	40412	867,175.19	67646
	20150415	42710	42910	42690	43030	42440	42840	42770	-70	-140	19694	421,226.69	68526
	20150416	42840	42770	42670	43370	42600	43200	43060	430	290	25582	550,797.65	68412
	20150417	43200	43060	43510	43780	43450	43640	43590	580	530	31532	687,337.39	69464
	20150420	43640	43590	43490	43920	43360	43700	43700	110	110	27640	604,039.63	74012
	20150421	43700	43700	43260	43300	43020	43190	43190	-510	-510	33434	722,040.59	77662
	20150422	43190	43190	42960	43230	42880	43140	43060	-50	-130	27358	589,036.15	80098
	20150423	43140	43060	43030	43190	42480	42790	42820	-270	-240	46418	994,032.70	86190
	20150424	42790	42820	42990	43240	42940	43130	43080	310	260	38248	823,989.40	85662
	20150427	43130	43080	43420	43890	43340	43650	43600	570	520	55538	1,210,806.15	90416
	20150428	43650	43600	43710	44020	43500	43680	43730	80	130	56134	1,227,576.58	97852
	20150429	43680	43730	43730	43970	43550	43650	43720	-80	-10	49700	1,086,682.90	99416
	20150430	43650	43720	43690	44200	43670	44180	43980	460	260	70076	1,541,039.47	103720
cu1509	20150105	44810	44700	44570	44570	44060	44180	44290	-520	-410	122	2,701.87	3454
	20150106	44180	44290	43300	43820	43230	43750	43690	-540	-600	444	9,700.10	3626
	20150107	43750	43690	43710	43710	43290	43320	43550	-370	-140	2008	43,728.16	4660
	20150108	43320	43550	43390	43620	43370	43440	43500	-110	-50	992	21,579.55	5100
	20150109	43440	43500	43530	43630	43110	43120	43280	-380	-220	656	14,197.73	5260
	20150112	43120	43280	43090	43160	42560	42650	42940	-630	-340	778	16,703.89	5416
	20150113	42650	42940	42140	42380	41640	41650	41970	-1290	-970	2568	53,898.33	6866
	20150114	41650	41970	41070	41330	39870	39870	40290	-2100	-1680	2582	52,022.28	7918
	20150115	39870	40290	39390	40580	39180	40370	39860	80	-430	3970	79,130.87	8794
	20150116	40370	39860	40800	40980	39880	40340	40250	480	390	1106	22,263.41	9156
	20150119	40340	40250	40140	41130	40030	41100	40820	850	570	582	11,879.25	9078
	20150120	41100	40820	40670	41120	40500	40790	40850	-30	30	2418	49,392.95	8630
	20150121	40790	40850	40920	41060	40800	40870	40900	20	50	1002	20,493.04	8574
	20150122	40870	40900	40740	41540	40520	41110	41080	210	180	814	16,723.49	8610
	20150123	41110	41080	41080	41260	40130	40450	40530	-630	-550	1236	25,051.82	8938
	20150126	40450	40530	40180	40190	38600	39100	39450	-1430	-1080	2938	57,962.17	10214
	20150127	39100	39450	39530	40530	39470	40100	40040	650	590	1304	26,108.46	10180
	20150128	40100	40040	39970	39980	39000	39350	39400	-690	-640	3036	59,814.74	10066
	20150129	39350	39400	39470	39500	38860	38910	39070	-490	-330	1806	35,285.27	9804
	20150130	38910	39070	38830	39080	38400	38660	38730	-410	-340	1136	22,000.50	9874
	20150202	38660	38730	39100	39940	38890	39940	39450	1210	720	1128	22,254.15	9490
	20150203	39940	39450	39890	40500	39750	40440	40240	990	790	1612	32,436.69	8876
	20150204	40440	40240	40880	41610	40490	40790	41040	550	800	1384	28,403.49	9198
	20150205	40790	41040	41070	41130	40580	40600	40780	-440	-260	1290	26,303.56	9132
	20150206	40600	40780	40480	41350	40470	41270	40940	490	160	756	15,477.25	9044
	20150209	41270	40940	41190	41230	40620	40880	40850	-60	-90	650	13,276.97	9100
	20150210	40880	40850	40710	41050	40640	40870	40860	20	10	1120	22,882.12	9600
	20150211	40870	40860	40550	40800	40410	40650	40600	-210	-260	820	16,649.24	9832
	20150212	40650	40600	40800	40800	40410	40690	40560	90	-40	598	12,128.56	9852
	20150213	40690	40560	40890	41830	40890	41720	41550	1160	990	1042	21,648.58	9892
	20150216	41720	41550	41620	41810	41320	41810	41520	260	-30	806	16,735.33	10128
	20150217	41810	41520	41610	41840	41560	41750	41710	230	190	1166	24,318.35	10368
	20150225	41750	41710	41750	41810	41560	41660	41640	-50	-70	1570	32,691.21	11006
	20150226	41660	41640	41700	42300	41560	42220	41910	580	270	1498	31,395.09	11176
	20150227	42220	41910	42560	42600	42180	42450	42390	540	480	1330	28,190.95	11518
	20150302	42450	42390	42370	42980	42120	42900	42530	510	140	3386	72,016.54	12084
	20150303	42900	42530	42650	42920	42180	42280	42430	-250	-100	1442	30,593.92	12178
	20150304	42280	42430	42210	42270	41860	42180	42090	-250	-340	1490	31,363.57	12260
	20150305	42180	42090	42280	42300	41900	42240	42180	150	90	752	15,862.04	12208
	20150306	42240	42180	42190	42480	41880	42000	42140	-180	-40	1338	28,193.49	12388
	20150309	42000	42140	42020	42070	41430	41990	41690	-150	-450	2112	44,029.95	12894
	20150310	41990	41690	42020	42470	41930	41980	42190	290	500	1634	34,475.56	13196
	20150311	41980	42190	41800	42060	41650	41810	41850	-380	-340	2528	52,907.10	13970
	20150312	41810	41850	41660	42420	41550	42400	41920	550	70	1070	22,430.30	13914
	20150313	42400	41920	42580	43060	42410	42900	42750	980	830	3888	83,119.18	14142
	20150316	42900	42750	42800	42960	42500	42960	42700	210	-50	2518	53,760.61	14268
	20150317	42960	42700	42760	43080	42460	42630	42770	-70	70	4684	100,175.57	15072
	20150318	42630	42770	42180	42640	41740	41740	42250	-1030	-520	5318	112,366.55	15856
	20150319	41740	42250	41500	42140	41170	41810	41730	-440	-520	3752	78,286.15	16106
	20150320	41810	41730	42100	42630	41950	42160	42250	430	520	2824	59,669.82	16040
	20150323	42160	42250	42590	44160	42530	43730	43350	1480	1100	14648	317,529.30	16790
	20150324	43730	43350	43720	44500	43630	43830	43940	480	590	9670	212,491.48	18900
	20150325	43830	43940	43830	43950	43410	43640	43690	-300	-250	3808	83,192.10	19714
	20150326	43640	43690	43690	43920	43610	43760	43750	70	60	4476	97,933.46	20156
	20150327	43760	43750	43940	44230	43270	43660	43770	-90	20	9094	199,052.64	22230
	20150330	43660	43770	43560	43890	43300	43760	43550	-10	-220	5254	114,412.42	22814
	20150331	43760	43550	43730	43980	43290	43290	43690	-260	140	5240	114,474.36	22956
	20150401	43290	43690	43330	43640	43140	43240	43360	-450	-330	8620	186,901.49	23878
	20150402	43240	43360	43000	43580	43000	43420	43360	60	0	10734	232,716.19	23776
	20150403	43420	43360	43230	43350	43070	43150	43230	-210	-130	6624	143,205.38	24744
	20150407	43150	43230	43280	43450	43230	43380	43350	150	120	2610	56,575.42	24764
	20150408	43380	43350	43440	43660	43250	43370	43430	20	80	6740	146,362.06	25948
	20150409	43370	43430	43300	43430	42960	43220	43130	-210	-300	5238	112,973.74	26978
	20150410	43220	43130	43270	43450	43020	43380	43260	250	130	5012	108,431.98	27750
	20150413	43380	43260	43370	43830	43300	43500	43500	240	240	11052	240,403.58	29486
	20150414	43500	43500	43600	43600	42440	42680	42890	-820	-610	15366	329,589.75	32886
	20150415	42680	42890	42680	42980	42400	42830	42740	-60	-150	7672	163,976.92	33932
	20150416	42830	42740	42660	43340	42590	43170	43080	430	340	8704	187,495.25	34130
	20150417	43170	43080	43650	43730	43410	43500	43550	420	470	16156	351,800.49	36442
	20150420	43500	43550	43410	43860	43350	43650	43670	100	120	13640	297,886.88	38096
	20150421	43650	43670	43240	43250	42980	43150	43160	-520	-510	17926	386,861.74	40984
	20150422	43150	43160	43050	43160	42850	43080	43010	-80	-150	12066	259,485.85	42814
	20150423	43080	43010	42990	43120	42430	42720	42780	-290	-230	19978	427,350.99	44848
	20150424	42720	42780	42900	43210	42880	43090	43070	310	290	19752	425,429.31	43342
	20150427	43090	43070	43550	43830	43280	43590	43540	520	470	23136	503,728.39	42686
	20150428	43590	43540	43620	43940	43440	43610	43660	70	120	15214	332,151.63	44290
	20150429	43610	43660	43630	43900	43490	43600	43670	-60	10	19708	430,401.00	45978
	20150430	43600	43670	43690	44110	43610	44080	43910	410	240	23578	517,665.55	48150
cu1510	20150105	44750	44540	44410	44410	43940	44030	44080	-510	-460	58	1,278.53	4092
	20150106	44030	44080	43060	43770	43030	43720	43550	-360	-530	170	3,701.92	4158
	20150107	43720	43550	43620	43620	43260	43300	43430	-250	-120	144	3,127.56	4216
	20150108	43300	43430	43400	43540	43250	43350	43430	-80	0	146	3,170.50	4248
	20150109	43350	43430	43450	43530	43060	43100	43230	-330	-200	380	8,215.29	4424
	20150112	43100	43230	43020	43140	42500	42600	42850	-630	-380	212	4,542.57	4500
	20150113	42600	42850	42150	42320	41600	41610	41970	-1240	-880	574	12,045.66	4590
	20150114	41610	41970	40420	41260	39870	39870	40240	-2100	-1730	742	14,932.03	5002
	20150115	39870	40240	39390	40510	39160	40300	40020	60	-220	2494	49,911.07	5814
	20150116	40300	40020	40550	40950	39880	40320	40210	300	190	814	16,368.57	6162
	20150119	40320	40210	40370	41080	40340	41080	40810	870	600	234	4,775.20	6134
	20150120	41080	40810	40600	41070	40500	40780	40830	-30	20	262	5,349.65	6142
	20150121	40780	40830	40960	41050	40760	40860	40890	30	60	180	3,680.60	6130
	20150122	40860	40890	40660	41500	40510	41100	41040	210	150	268	5,500.51	6172
	20150123	41100	41040	41150	41150	40130	40350	40500	-690	-540	552	11,180.52	6140
	20150126	40350	40500	40070	40130	38570	39150	39230	-1350	-1270	504	9,886.12	6280
	20150127	39150	39230	39780	40500	39780	40110	40080	880	850	354	7,094.90	6184
	20150128	40110	40080	39950	39950	39050	39310	39350	-770	-730	396	7,792.44	6324
	20150129	39310	39350	39300	39310	38860	38880	39090	-470	-260	1378	26,933.30	6724
	20150130	38880	39090	38850	39010	38480	38620	38700	-470	-390	370	7,160.90	6820
	20150202	38620	38700	38880	39900	38880	39880	39290	1180	590	278	5,462.21	6802
	20150203	39880	39290	39820	40460	39810	40420	40160	1130	870	588	11,808.96	6942
	20150204	40420	40160	40720	41560	40510	40770	40980	610	820	450	9,220.51	6860
	20150205	40770	40980	40930	41230	40570	40650	40750	-330	-230	254	5,175.59	6910
	20150206	40650	40750	40660	41280	40620	41280	41120	530	370	290	5,962.79	6878
	20150209	41280	41120	41210	41210	40670	40860	40850	-260	-270	420	8,580.39	7078
	20150210	40860	40850	40730	41000	40620	40890	40850	40	0	128	2,614.63	7096
	20150211	40890	40850	40660	40740	40450	40660	40600	-190	-250	186	3,776.17	7088
	20150212	40660	40600	40750	40770	40400	40640	40530	40	-70	140	2,837.43	7048
	20150213	40640	40530	40980	41820	40870	41700	41500	1170	970	420	8,715.38	7030
	20150216	41700	41500	41650	41810	41300	41810	41500	310	0	160	3,320.01	7072
	20150217	41810	41500	43070	43070	41600	41790	41720	290	220	446	9,303.58	7248
	20150225	41790	41720	41830	41830	41600	41660	41620	-60	-100	158	3,288.09	7254
	20150226	41660	41620	43040	43040	41550	42230	42030	610	410	378	7,943.91	7358
	20150227	42230	42030	42510	42630	42170	42460	42410	430	380	580	12,301.28	7346
	20150302	42460	42410	42300	42970	42130	42970	42590	560	180	1062	22,620.32	7204
	20150303	42970	42590	42620	42860	42200	42200	42460	-390	-130	454	9,640.57	7146
	20150304	42200	42460	42000	42280	42000	42200	42220	-260	-240	236	4,982.65	7292
	20150305	42200	42220	42340	42340	41900	42270	42200	50	-20	128	2,701.21	7280
	20150306	42270	42200	42450	42450	41890	42000	42130	-200	-70	1014	21,364.16	7298
	20150309	42000	42130	41970	42070	41460	42000	41760	-130	-370	1226	25,600.10	7458
	20150310	42000	41760	42000	42460	41980	42010	42170	250	410	722	15,225.12	7684
	20150311	42010	42170	41640	42020	41630	41870	41900	-300	-270	808	16,930.79	8042
	20150312	41870	41900	41680	42450	41630	42410	42010	510	110	626	13,151.22	7972
	20150313	42410	42010	42620	43080	42480	42950	42720	940	710	1668	35,631.57	7792
	20150316	42950	42720	42790	43000	42570	43000	42730	280	10	1778	37,987.70	7862
	20150317	43000	42730	42750	43130	42520	42710	42780	-20	50	2828	60,491.04	7868
	20150318	42710	42780	42500	42610	41800	41800	42310	-980	-470	2818	59,617.58	8082
	20150319	41800	42310	41640	42280	41240	41900	41830	-410	-480	1424	29,785.59	8096
	20150320	41900	41830	42250	42680	42010	42190	42370	360	540	1218	25,803.88	8082
	20150323	42190	42370	42630	44210	42600	43780	43410	1410	1040	2124	46,106.24	7754
	20150324	43780	43410	43730	44770	43700	43880	44000	470	590	1926	42,376.64	7110
	20150325	43880	44000	43830	43890	43500	43680	43700	-320	-300	674	14,728.57	6838
	20150326	43680	43700	43750	43910	43650	43780	43750	80	50	1432	31,328.23	6766
	20150327	43780	43750	43900	44200	43300	43650	43630	-100	-120	910	19,853.73	6890
	20150330	43650	43630	43620	43870	43320	43750	43590	120	-40	1050	22,887.80	7140
	20150331	43750	43590	43770	43930	43310	43340	43690	-250	100	866	18,921.16	7478
	20150401	43340	43690	43350	43590	43150	43230	43430	-460	-260	1480	32,144.79	7872
	20150402	43230	43430	43200	43600	43100	43460	43470	30	40	672	14,607.66	8230
	20150403	43460	43470	43360	43360	43090	43160	43270	-310	-200	552	11,943.46	8110
	20150407	43160	43270	43370	43480	43200	43420	43370	150	100	254	5,508.38	8092
	20150408	43420	43370	43510	43650	43260	43360	43460	-10	90	1108	24,077.04	8458
	20150409	43360	43460	43300	43440	42960	43220	43150	-240	-310	414	8,932.26	8512
	20150410	43220	43150	43260	43400	43030	43380	43240	230	90	474	10,248.63	8532
	20150413	43380	43240	43400	43820	43300	43520	43490	280	250	782	17,006.56	8778
	20150414	43520	43490	43480	43530	42460	42680	42760	-810	-730	3130	66,925.15	10206
	20150415	42680	42760	42560	42920	42420	42790	42730	30	-30	1300	27,780.97	10542
	20150416	42790	42730	42620	43320	42570	43140	43110	410	380	588	12,675.86	10520
	20150417	43140	43110	43590	43740	43440	43490	43560	380	450	816	17,772.91	10526
	20150420	43490	43560	43380	43860	43350	43680	43700	120	140	998	21,808.72	10808
	20150421	43680	43700	43090	43240	42810	43160	43130	-540	-570	1826	39,383.66	11560
	20150422	43160	43130	42940	43120	42860	43120	43020	-10	-110	1718	36,961.08	12064
	20150423	43120	43020	43050	43080	42410	42730	42710	-290	-310	6448	137,706.17	13842
	20150424	42730	42710	42820	43170	42820	43040	43030	330	320	2834	60,983.53	13560
	20150427	43040	43030	43420	43800	43260	43530	43500	500	470	4398	95,669.33	14660
	20150428	43530	43500	43630	43910	43390	43550	43600	50	100	4746	103,478.33	14836
	20150429	43550	43600	43640	43850	43450	43520	43580	-80	-20	5510	120,090.23	16314
	20150430	43520	43580	43650	44060	43600	44020	43850	440	270	4466	97,933.25	16130
cu1511	20150105	44640	44480	44190	44190	43950	43990	44040	-490	-440	42	924.93	3062
	20150106	43990	44040	43020	43800	43010	43670	43480	-370	-560	592	12,870.41	3352
	20150107	43670	43480	43550	43620	43200	43200	43470	-280	-10	364	7,912.60	3476
	20150108	43200	43470	43360	43500	43230	43350	43380	-120	-90	92	1,995.59	3494
	20150109	43350	43380	43530	43530	42980	43000	43170	-380	-210	382	8,245.87	3734
	20150112	43000	43170	42970	43030	42480	42550	42800	-620	-370	118	2,525.73	3782
	20150113	42550	42800	41900	42240	41520	41520	41890	-1280	-910	416	8,714.59	3878
	20150114	41520	41890	40950	41220	39790	39790	40230	-2100	-1660	760	15,288.36	4206
	20150115	39790	40230	39100	40430	39060	40280	39840	50	-390	1826	36,382.90	4196
	20150116	40280	39840	40540	40870	39810	40290	40130	450	290	290	5,820.27	4280
	20150119	40290	40130	40400	41030	40400	41030	40730	900	600	390	7,942.41	4288
	20150120	41030	40730	40720	40990	40460	40740	40860	10	130	354	7,233.18	4270
	20150121	40740	40860	40850	40980	40710	40840	40870	-20	10	188	3,842.06	4286
	20150122	40840	40870	40490	41540	40480	41050	41110	180	240	264	5,427.67	4238
	20150123	41050	41110	41020	41020	40090	40350	40510	-760	-600	406	8,224.93	4236
	20150126	40350	40510	40030	40060	38600	39160	39200	-1350	-1310	480	9,408.31	4260
	20150127	39160	39200	39600	40380	39600	40070	40050	870	850	466	9,331.74	4404
	20150128	40070	40050	39800	39800	39100	39310	39330	-740	-720	334	6,568.25	4460
	20150129	39310	39330	39310	39450	38880	38930	39090	-400	-240	214	4,183.52	4492
	20150130	38930	39090	38700	39040	38480	38620	38720	-470	-370	302	5,847.07	4528
	20150202	38620	38720	38770	39890	38770	39860	39390	1140	670	210	4,136.15	4492
	20150203	39860	39390	39750	40430	39750	40430	40160	1040	770	160	3,213.47	4478
	20150204	40430	40160	40590	41580	40470	40750	40870	590	710	178	3,637.88	4460
	20150205	40750	40870	40980	41030	40600	40620	40790	-250	-80	268	5,466.63	4422
	20150206	40620	40790	40670	41300	40670	41280	41090	490	300	110	2,260.37	4406
	20150209	41280	41090	41180	41180	40700	40820	40870	-270	-220	136	2,779.56	4426
	20150210	40820	40870	40710	41010	40710	40900	40880	30	10	160	3,270.89	4418
	20150211	40900	40880	40700	40730	40460	40690	40600	-190	-280	106	2,152.04	4426
	20150212	40690	40600	40700	40700	40440	40670	40550	70	-50	104	2,108.64	4432
	20150213	40670	40550	40860	41800	40790	41650	41350	1100	800	176	3,639.61	4400
	20150216	41650	41350	41650	41650	41330	41430	41460	80	110	52	1,077.96	4416
	20150217	41430	41460	41660	41790	41640	41770	41710	310	250	42	876.10	4420
	20150225	41770	41710	41620	41710	41590	41660	41620	-50	-90	52	1,082.37	4410
	20150226	41660	41620	41660	42300	41550	42270	41920	650	300	106	2,222.07	4416
	20150227	42270	41920	42510	42560	42230	42360	42430	440	510	170	3,607.34	4378
	20150302	42360	42430	42200	42950	42200	42950	42600	520	170	210	4,473.62	4394
	20150303	42950	42600	42650	42700	42200	42250	42360	-350	-240	130	2,753.52	4390
	20150304	42250	42360	42170	42260	41900	42210	42190	-150	-170	50	1,054.93	4404
	20150305	42210	42190	42380	42380	42200	42240	42240	50	50	36	760.36	4416
	20150306	42240	42240	42450	42450	41940	42000	42160	-240	-80	228	4,806.28	4420
	20150309	42000	42160	42040	42080	41520	42050	41740	-110	-420	150	3,131.20	4382
	20150310	42050	41740	41980	42480	41980	42080	42290	340	550	100	2,114.72	4380
	20150311	42080	42290	41790	41990	41440	41900	41900	-390	-390	180	3,771.37	4420
	20150312	41900	41900	41630	42450	41630	42410	42050	510	150	78	1,640.05	4414
	20150313	42410	42050	42600	43100	42500	42950	42780	900	730	1188	25,411.83	4312
	20150316	42950	42780	42750	43060	42680	43060	42780	280	0	2380	50,913.32	4082
	20150317	43060	42780	42780	43160	42580	42730	42880	-50	100	2384	51,124.68	4064
	20150318	42730	42880	42390	42710	41910	41930	42310	-950	-570	1784	37,743.96	4206
	20150319	41930	42310	41700	42410	41270	41970	41890	-340	-420	790	16,549.95	4396
	20150320	41970	41890	42190	42680	42090	42300	42300	410	410	700	14,808.05	4356
	20150323	42300	42300	42700	44220	42700	43800	43620	1500	1320	1352	29,492.75	4288
	20150324	43800	43620	44010	44350	43730	43890	44000	270	380	586	12,893.86	4440
	20150325	43890	44000	43820	43890	43480	43710	43680	-290	-320	418	9,130.27	4502
	20150326	43710	43680	43700	43880	43680	43740	43750	60	70	666	14,571.98	4536
	20150327	43740	43750	44030	44150	43370	43600	43630	-150	-120	1060	23,124.05	4972
	20150330	43600	43630	43550	43880	43330	43760	43610	130	-20	818	17,838.54	5184
	20150331	43760	43610	43780	43980	43430	43440	43700	-170	90	368	8,042.60	5206
	20150401	43440	43700	43270	43600	43200	43260	43370	-440	-330	236	5,117.94	5244
	20150402	43260	43370	43200	43610	43130	43500	43410	130	40	332	7,207.16	5350
	20150403	43500	43410	43220	43350	43150	43180	43250	-230	-160	56	1,211.21	5372
	20150407	43180	43250	43350	43390	43240	43390	43330	140	80	128	2,773.75	5320
	20150408	43390	43330	43560	43600	43300	43370	43480	40	150	434	9,436.69	5422
	20150409	43370	43480	43220	43220	43020	43020	43080	-460	-400	30	646.24	5418
	20150410	43020	43080	43100	43390	43060	43370	43210	290	130	66	1,425.93	5406
	20150413	43370	43210	43640	43800	43340	43530	43550	320	340	114	2,482.55	5404
	20150414	43530	43550	43390	43390	42520	42700	42740	-850	-810	496	10,600.65	5638
	20150415	42700	42740	42670	42940	42450	42790	42760	50	20	166	3,549.08	5594
	20150416	42790	42760	42610	43310	42610	43210	43170	450	410	308	6,648.32	5682
	20150417	43210	43170	43580	43750	43440	43500	43560	330	390	204	4,443.23	5668
	20150420	43500	43560	43500	43880	43460	43690	43730	130	170	232	5,073.66	5686
	20150421	43690	43730	43010	43250	43000	43190	43150	-540	-580	672	14,500.85	6038
	20150422	43190	43150	43030	43100	42880	43000	42990	-150	-160	940	20,209.89	6102
	20150423	43000	42990	42930	43050	42440	42750	42770	-240	-220	1068	22,842.75	6294
	20150424	42750	42770	42940	43100	42830	43040	42980	270	210	320	6,877.50	6318
	20150427	43040	42980	43290	43720	43270	43520	43500	540	520	428	9,309.48	6298
	20150428	43520	43500	43690	43890	43380	43480	43600	-20	100	478	10,422.37	6362
	20150429	43480	43600	43610	43760	43470	43530	43540	-70	-60	834	18,160.00	6914
	20150430	43530	43540	43600	44000	43600	44000	43880	460	340	558	12,243.91	6710
cu1512	20150105	44530	44400	44330	44330	43840	43860	43990	-540	-410	254	5,587.24	1188
	20150106	43860	43990	43010	43670	42900	43610	43440	-380	-550	574	12,467.84	1538
	20150107	43610	43440	43610	43610	43130	43160	43370	-280	-70	378	8,197.29	1762
	20150108	43160	43370	43310	43410	43200	43200	43270	-170	-100	200	4,327.02	1848
	20150109	43200	43270	43320	43360	42880	42960	43060	-310	-210	576	12,403.51	2160
	20150112	42960	43060	42820	42980	42360	42360	42800	-700	-260	958	20,505.88	2896
	20150113	42360	42800	42000	42130	41480	41480	41850	-1320	-950	1084	22,685.22	3630
	20150114	41480	41850	40910	41130	39750	39750	40290	-2100	-1560	1908	38,442.53	4914
	20150115	39750	40290	39150	40450	38800	40230	39990	-60	-300	2300	45,990.46	5756
	20150116	40230	39990	40550	40860	39800	40280	40160	290	170	1094	21,972.00	5970
	20150119	40280	40160	39990	41000	39990	41000	40630	840	470	736	14,952.19	6022
	20150120	41000	40630	40470	40990	40420	40710	40730	80	100	294	5,988.10	6036
	20150121	40710	40730	40910	40990	40730	40780	40820	50	90	242	4,939.45	6084
	20150122	40780	40820	40660	41460	40440	41030	41010	210	190	540	11,074.90	6202
	20150123	41030	41010	41010	41050	40070	40300	40600	-710	-410	776	15,755.05	6466
	20150126	40300	40600	40100	40100	38580	39150	39300	-1450	-1300	1198	23,544.64	6964
	20150127	39150	39300	39440	40500	39440	40060	40000	760	700	582	11,642.69	6940
	20150128	40060	40000	39970	39970	39030	39280	39330	-720	-670	534	10,502.88	7142
	20150129	39280	39330	39340	39360	38870	38870	39020	-460	-310	466	9,093.37	7330
	20150130	38870	39020	38650	39000	38450	38580	38690	-440	-330	628	12,150.48	7564
	20150202	38580	38690	38900	39890	38880	39850	39500	1160	810	806	15,921.67	7534
	20150203	39850	39500	39790	40430	39700	40400	40140	900	640	446	8,953.10	7462
	20150204	40400	40140	40880	41530	40500	40750	40930	610	790	622	12,729.67	7574
	20150205	40750	40930	41080	41080	40580	40630	40840	-300	-90	1044	21,322.05	8018
	20150206	40630	40840	40270	41300	40260	41230	41060	390	220	410	8,417.71	7900
	20150209	41230	41060	41140	41210	40630	40800	40880	-260	-180	480	9,811.81	7958
	20150210	40800	40880	40810	41020	40630	40870	40870	-10	-10	312	6,376.22	7934
	20150211	40870	40870	40710	40810	40390	40680	40610	-190	-260	394	8,002.01	7972
	20150212	40680	40610	40700	40760	40420	40650	40580	40	-30	216	4,383.16	7978
	20150213	40650	40580	40930	41800	40800	41610	41420	1030	840	630	13,048.85	7900
	20150216	41610	41420	41650	41820	41340	41820	41490	400	70	142	2,946.33	7896
	20150217	41820	41490	41630	41860	41620	41780	41710	290	220	174	3,629.34	7888
	20150225	41780	41710	41700	41760	41570	41650	41630	-60	-80	178	3,705.57	7920
	20150226	41650	41630	41650	42280	41560	42200	41880	570	250	302	6,324.37	7984
	20150227	42200	41880	42450	42560	42200	42470	42440	590	560	1116	23,685.86	8478
	20150302	42470	42440	42300	42960	42160	42950	42590	510	150	688	14,651.62	8316
	20150303	42950	42590	42710	42950	42240	42270	42440	-320	-150	210	4,456.48	8356
	20150304	42270	42440	42210	42300	41930	42220	42170	-220	-270	206	4,344.01	8376
	20150305	42220	42170	42320	42320	41950	42270	42130	100	-40	134	2,823.02	8348
	20150306	42270	42130	42410	42410	41950	42010	42140	-120	10	342	7,206.97	8432
	20150309	42010	42140	42060	42090	41500	42070	41740	-70	-400	200	4,174.51	8388
	20150310	42070	41740	42100	42500	42020	42050	42210	310	470	544	11,483.60	8590
	20150311	42050	42210	41780	42060	41720	41880	41880	-330	-330	256	5,361.70	8626
	20150312	41880	41880	41920	42420	41660	42410	42010	530	130	248	5,210.25	8624
	20150313	42410	42010	42580	43100	42500	42960	42840	950	830	1330	28,489.73	8326
	20150316	42960	42840	42780	43070	42700	43070	42840	230	0	718	15,382.47	8318
	20150317	43070	42840	42810	43210	42700	42800	42960	-40	120	1144	24,576.01	8282
	20150318	42800	42960	42510	42800	41960	41960	42550	-1000	-410	4440	94,473.81	8334
	20150319	41960	42550	41760	42400	41390	42010	41800	-540	-750	960	20,066.53	8168
	20150320	42010	41800	42320	42800	42150	42330	42420	530	620	1734	36,784.66	7664
	20150323	42330	42420	42750	44250	42750	43890	43610	1470	1190	1036	22,593.13	7576
	20150324	43890	43610	43990	44590	43800	43880	44050	270	440	784	17,270.65	7368
	20150325	43880	44050	43840	43930	43480	43700	43720	-350	-330	476	10,405.77	7264
	20150326	43700	43720	43870	43930	43700	43810	43770	90	50	334	7,311.22	7258
	20150327	43810	43770	43840	44200	43290	43660	43700	-110	-70	306	6,686.83	7236
	20150330	43660	43700	43490	43860	43250	43750	43490	50	-210	1332	28,970.13	6740
	20150331	43750	43490	43840	43930	43460	43480	43700	-10	210	564	12,325.05	6824
	20150401	43480	43700	43420	43620	43230	43300	43400	-400	-300	254	5,512.93	6842
	20150402	43300	43400	43250	43620	43160	43500	43430	100	30	766	16,634.50	6966
	20150403	43500	43430	43360	43400	43150	43230	43310	-200	-120	294	6,367.34	7034
	20150407	43230	43310	43320	43500	43320	43450	43430	140	120	182	3,952.13	6998
	20150408	43450	43430	43550	43760	43270	43390	43510	-40	80	860	18,713.40	7224
	20150409	43390	43510	43220	43250	43010	43230	43130	-280	-380	112	2,415.64	7238
	20150410	43230	43130	43250	43420	43080	43380	43280	250	150	198	4,285.06	7258
	20150413	43380	43280	43360	43820	43300	43530	43510	250	230	260	5,656.80	7224
	20150414	43530	43510	43480	43550	42480	42750	42950	-760	-560	774	16,624.09	7270
	20150415	42750	42950	42620	42970	42460	42800	42790	-150	-160	188	4,022.36	7276
	20150416	42800	42790	42580	43350	42580	43150	43140	360	350	452	9,751.00	7336
	20150417	43150	43140	43570	43750	43470	43490	43590	350	450	410	8,936.03	7314
	20150420	43490	43590	43330	43880	43330	43670	43640	80	50	460	10,039.05	7292
	20150421	43670	43640	43220	43340	43010	43190	43190	-450	-450	610	13,173.09	7478
	20150422	43190	43190	43000	43110	42900	43060	43030	-130	-160	244	5,249.79	7460
	20150423	43060	43030	43000	43080	42440	42740	42790	-290	-240	762	16,303.66	7454
	20150424	42740	42790	42960	43150	42870	43040	42980	250	190	352	7,564.65	7458
	20150427	43040	42980	43450	43700	43300	43510	43560	530	580	730	15,902.20	7410
	20150428	43510	43560	43670	43880	43300	43520	43690	-40	130	792	17,302.35	7478
	20150429	43520	43690	43600	43750	43430	43450	43590	-240	-100	708	15,432.75	7526
	20150430	43450	43590	43600	44040	43600	44040	43880	450	290	2172	47,664.13	8592
cu1601	20150116	39990	39990	40180	40180	39520	40170	40020	180	30	52	1,040.76	34
	20150119	40170	40020	39960	40890	39960	40840	40660	820	640	306	6,221.99	256
	20150120	40840	40660	40570	40890	40510	40670	40680	10	20	22	447.52	270
	20150121	40670	40680	40850	40870	40510	40700	40730	20	50	146	2,973.84	326
	20150122	40700	40730	40410	41170	40390	41170	40910	440	180	34	695.52	318
	20150123	41170	40910	40720	40980	40000	40250	40510	-660	-400	138	2,795.27	368
	20150126	40250	40510	39900	40000	38600	39060	39250	-1450	-1260	252	4,945.52	542
	20150127	39060	39250	39830	40300	39830	40020	40040	770	790	154	3,083.70	550
	20150128	40020	40040	39740	39740	39010	39370	39330	-670	-710	298	5,860.28	716
	20150129	39370	39330	39230	39250	38900	38900	39010	-430	-320	240	4,682.33	842
	20150130	38900	39010	38670	38890	38430	38640	38650	-370	-360	376	7,266.50	1082
	20150202	38640	38650	38950	39820	38810	39800	39420	1150	770	310	6,110.36	1084
	20150203	39800	39420	39800	40390	39550	40390	40060	970	640	318	6,371.03	1142
	20150204	40390	40060	40660	41540	40410	40690	40750	630	690	218	4,442.30	1142
	20150205	40690	40750	40600	41050	40510	40630	40730	-120	-20	844	17,192.04	1646
	20150206	40630	40730	40500	41280	40500	41220	40930	490	200	576	11,788.41	1926
	20150209	41220	40930	41100	41170	40670	40770	40830	-160	-100	80	1,633.35	1940
	20150210	40770	40830	40640	41010	40640	40870	40840	40	10	212	4,330.08	2000
	20150211	40870	40840	40620	40800	40400	40730	40600	-110	-240	470	9,543.26	2290
	20150212	40730	40600	40710	40800	40480	40700	40540	100	-60	224	4,541.27	2384
	20150213	40700	40540	40880	41810	40880	41640	41410	1100	870	134	2,775.04	2378
	20150216	41640	41410	41630	41780	41330	41780	41500	370	90	82	1,701.57	2388
	20150217	41780	41500	41620	41800	41620	41770	41740	270	240	44	918.40	2384
	20150225	41770	41740	41600	41770	41490	41690	41650	-50	-90	64	1,332.93	2390
	20150226	41690	41650	41630	42240	41620	42190	41990	540	340	156	3,275.50	2320
	20150227	42190	41990	42450	42560	42160	42450	42500	460	510	196	4,165.41	2216
	20150302	42450	42500	42380	42970	42220	42970	42720	470	220	64	1,367.10	2212
	20150303	42970	42720	42710	42900	42220	42380	42600	-340	-120	106	2,258.17	2264
	20150304	42380	42600	42100	42280	42040	42200	42150	-400	-450	20	421.50	2264
	20150305	42200	42150	42200	42310	42070	42260	42190	110	40	34	717.38	2254
	20150306	42260	42190	42290	42300	41950	41990	42230	-200	40	126	2,661.10	2260
	20150309	41990	42230	41760	42110	41540	42110	41740	-120	-490	70	1,460.95	2248
	20150310	42110	41740	42040	42530	42020	42030	42290	290	550	74	1,564.84	2264
	20150311	42030	42290	41780	42020	41710	41930	41810	-360	-480	108	2,257.81	2272
	20150312	41930	41810	41900	42420	41700	42420	42020	610	210	134	2,815.85	2346
	20150313	42420	42020	42600	43090	42500	42980	42800	960	780	324	6,934.61	2350
	20150316	42980	42800	42780	43120	42690	43120	42900	320	100	468	10,040.01	2402
	20150317	43120	42900	42910	43200	42720	42930	42970	30	70	262	5,629.32	2384
	20150318	42930	42970	42560	42810	42080	42080	42670	-890	-300	1028	21,933.00	2364
	20150319	42080	42670	41950	42350	41560	42170	41980	-500	-690	272	5,709.73	2384
	20150320	42170	41980	42290	42790	42210	42410	42330	430	350	366	7,747.01	2198
	20150323	42410	42330	42830	44320	42830	43930	43560	1600	1230	312	6,795.99	2246
	20150324	43930	43560	44050	44500	43850	44020	44100	460	540	314	6,924.03	2288
	20150325	44020	44100	43980	43980	43510	43720	43770	-380	-330	160	3,502.11	2256
	20150326	43720	43770	43900	44120	43660	43800	43820	30	50	342	7,493.22	2318
	20150327	43800	43820	43900	44220	43440	43620	43670	-200	-150	260	5,677.49	2362
	20150330	43620	43670	43500	43860	43330	43730	43610	60	-60	152	3,314.89	2344
	20150331	43730	43610	43940	43940	43490	43510	43660	-100	50	122	2,663.36	2346
	20150401	43510	43660	43450	43580	43350	43370	43430	-290	-230	196	4,256.91	2262
	20150402	43370	43430	43460	43700	43260	43540	43450	110	20	194	4,215.27	2256
	20150403	43540	43450	43400	43420	43200	43200	43320	-250	-130	92	1,993.06	2262
	20150407	43200	43320	43390	43510	43330	43500	43430	180	110	54	1,172.80	2260
	20150408	43500	43430	43580	43670	43340	43340	43530	-90	100	210	4,570.66	2286
	20150409	43340	43530	43250	43250	43080	43200	43130	-330	-400	42	905.76	2294
	20150410	43200	43130	43370	43430	43030	43420	43250	290	120	108	2,335.96	2288
	20150413	43420	43250	43400	43850	43320	43540	43480	290	230	194	4,218.49	2332
	20150414	43540	43480	43520	43540	42610	42790	43080	-690	-400	366	7,883.71	2306
	20150415	42790	43080	42740	43010	42500	42920	42750	-160	-330	220	4,703.23	2334
	20150416	42920	42750	42820	43520	42820	43220	43280	470	530	284	6,146.83	2368
	20150417	43220	43280	43630	43790	43540	43550	43630	270	350	184	4,014.31	2372
	20150420	43550	43630	43440	43930	43440	43720	43760	90	130	382	8,358.98	2368
	20150421	43720	43760	43310	43310	43130	43200	43230	-560	-530	374	8,084.70	2430
	20150422	43200	43230	43000	43120	42950	43110	43060	-120	-170	368	7,923.35	2458
	20150423	43110	43060	42960	43100	42460	42840	42840	-220	-220	510	10,926.08	2612
	20150424	42840	42840	43060	43200	42960	43100	43050	260	210	56	1,205.65	2606
	20150427	43100	43050	43340	43800	43340	43550	43640	500	590	384	8,379.73	2732
	20150428	43550	43640	43720	43920	43450	43510	43630	-130	-10	448	9,774.93	2694
	20150429	43510	43630	43570	43760	43460	43490	43590	-140	-40	346	7,542.37	2624
	20150430	43490	43590	43620	44110	43620	44100	43840	510	250	492	10,785.04	2706
cu1602	20150216	41410	41410	41350	41350	41350	41350	41350	-60	-60	8	165.40	8
	20150217	41350	41350	41670	41670	41640	41640	41650	290	300	8	166.62	16
	20150225	41640	41650	41570	41690	41240	41690	41580	40	-70	98	2,037.79	52
	20150226	41690	41580	41700	42260	41700	42240	41960	660	380	32	671.45	72
	20150227	42240	41960	42560	42560	42300	42440	42440	480	480	28	594.29	78
	20150302	42440	42440	42620	42950	42490	42950	42720	510	280	28	598.14	100
	20150303	42950	42720	42700	42810	42260	42290	42480	-430	-240	112	2,379.02	184
	20150304	42290	42480	42160	42270	41970	42270	42160	-210	-320	40	843.29	194
	20150305	42270	42160	41980	42370	41980	42300	42290	140	130	78	1,649.62	212
	20150306	42300	42290	42220	42300	42110	42150	42260	-140	-30	314	6,635.63	460
	20150309	42150	42260	41730	42130	41550	42090	41820	-170	-440	116	2,425.56	494
	20150310	42090	41820	42150	42540	42100	42100	42240	280	420	308	6,504.96	614
	20150311	42100	42240	41740	42090	41730	41900	41950	-340	-290	50	1,048.77	620
	20150312	41900	41950	41910	42480	41710	42390	42130	440	180	108	2,275.55	712
	20150313	42390	42130	42580	43110	42520	42960	42840	830	710	594	12,725.95	1016
	20150316	42960	42840	42760	43110	42760	43100	42970	260	130	286	6,144.71	1244
	20150317	43100	42970	42970	43240	42860	42890	43020	-80	50	424	9,121.85	1512
	20150318	42890	43020	42530	42870	42160	42160	42560	-860	-460	280	5,958.88	1512
	20150319	42160	42560	41980	42260	41890	42190	42090	-370	-470	92	1,936.33	1506
	20150320	42190	42090	42350	42830	42290	42480	42570	390	480	70	1,490.11	1516
	20150323	42480	42570	43110	44250	43080	43890	43890	1320	1320	150	3,292.22	1540
	20150324	43890	43890	44030	44410	43860	44020	44100	130	210	98	2,161.12	1540
	20150325	44020	44100	43950	43950	43640	43660	43800	-440	-300	94	2,058.78	1554
	20150326	43660	43800	43830	43870	43760	43870	43800	70	0	62	1,358.00	1536
	20150327	43870	43800	43930	44200	43480	43620	43750	-180	-50	128	2,800.23	1552
	20150330	43620	43750	43500	43880	43380	43700	43590	-50	-160	50	1,089.78	1550
	20150331	43700	43590	43750	43750	43520	43520	43650	-70	60	20	436.58	1558
	20150401	43520	43650	43460	43550	43300	43420	43440	-230	-210	26	564.75	1562
	20150402	43420	43440	43280	43720	43240	43610	43460	170	20	78	1,695.09	1572
	20150403	43610	43460	43420	43480	43220	43220	43350	-240	-110	34	737.03	1578
	20150407	43220	43350	43510	43510	43510	43510	43510	160	160	2	43.51	1576
	20150408	43510	43510	43610	43700	43370	43480	43500	-30	-10	106	2,305.87	1580
	20150409	43480	43500	43230	43300	43090	43280	43210	-220	-290	16	345.73	1580
	20150410	43280	43210	43310	43490	43150	43460	43350	250	140	30	650.26	1570
	20150413	43460	43350	43400	43790	43400	43590	43570	240	220	34	740.81	1572
	20150414	43590	43570	43170	43200	42660	42800	42890	-770	-680	110	2,359.21	1596
	20150415	42800	42890	42740	43030	42600	42890	42820	0	-70	50	1,070.53	1614
	20150416	42890	42820	42820	43370	42820	43330	43200	510	380	32	691.34	1622
	20150417	43330	43200	43590	43730	43590	43720	43640	520	440	34	742.01	1616
	20150420	43720	43640	43600	43890	43600	43750	43800	110	160	60	1,314.14	1658
	20150421	43750	43800	43200	43340	43140	43230	43260	-570	-540	96	2,076.66	1654
	20150422	43230	43260	43040	43190	42980	43110	43080	-150	-180	76	1,637.26	1634
	20150423	43110	43080	43100	43100	42540	42800	42900	-280	-180	350	7,508.17	1814
	20150424	42800	42900	43150	43200	43000	43090	43150	190	250	20	431.52	1818
	20150427	43090	43150	43420	43760	43390	43660	43630	510	480	50	1,090.99	1824
	20150428	43660	43630	43740	44020	43510	43590	43670	-40	40	98	2,140.21	1826
	20150429	43590	43670	43660	43750	43500	43500	43620	-170	-50	278	6,064.07	1926
	20150430	43500	43620	43880	44120	43740	44120	43890	500	270	138	3,028.99	1958
cu1603	20150317	42970	42970	42990	43320	42810	42810	43060	-160	90	12	258.36	6
	20150318	42810	43060	42830	42890	42200	42200	42690	-860	-370	654	13,961.10	442
	20150319	42200	42690	42130	42320	41800	42200	42240	-490	-450	426	8,997.15	776
	20150320	42200	42240	42880	42890	42530	42660	42660	420	420	54	1,152.05	820
	20150323	42660	42660	42990	44150	42990	43900	43890	1240	1230	130	2,853.02	862
	20150324	43900	43890	44090	44600	43960	44040	44270	150	380	206	4,560.27	976
	20150325	44040	44270	44020	44060	43710	43850	43870	-420	-400	126	2,764.26	998
	20150326	43850	43870	43850	44040	43780	43860	43830	-10	-40	64	1,402.62	1016
	20150327	43860	43830	43940	43950	43500	43700	43690	-130	-140	38	830.28	1010
	20150330	43700	43690	43670	43910	43370	43850	43580	160	-110	88	1,917.85	1038
	20150331	43850	43580	43970	43970	43510	43510	43680	-70	100	48	1,048.38	1054
	20150401	43510	43680	43390	43630	43340	43490	43510	-190	-170	78	1,697.14	1072
	20150402	43490	43510	43360	43720	43260	43700	43520	190	10	56	1,218.75	1088
	20150403	43700	43520	43480	43530	43230	43330	43390	-190	-130	116	2,516.86	1092
	20150407	43330	43390	43590	43590	43510	43520	43530	130	140	18	391.81	1098
	20150408	43520	43530	43660	43720	43380	43480	43530	-50	0	102	2,220.15	1124
	20150409	43480	43530	43340	43340	43250	43300	43290	-230	-240	20	432.99	1124
	20150410	43300	43290	43330	43550	43320	43410	43410	120	120	102	2,214.26	1166
	20150413	43410	43410	43430	43800	43430	43480	43630	70	220	22	479.97	1160
	20150414	43480	43630	43620	43620	42600	42850	43120	-780	-510	108	2,328.83	1184
	20150415	42850	43120	42650	42950	42550	42940	42800	-180	-320	34	727.69	1182
	20150416	42940	42800	42490	43720	42480	43310	43090	510	290	108	2,327.05	1214
	20150417	43310	43090	43640	43810	43550	43630	43640	540	550	144	3,142.76	1248
	20150420	43630	43640	43500	43890	43500	43770	43790	130	150	160	3,503.97	1250
	20150421	43770	43790	43370	43440	43150	43320	43300	-470	-490	188	4,070.43	1258
	20150422	43320	43300	43150	43220	43030	43220	43160	-80	-140	44	949.72	1264
	20150423	43220	43160	43170	43170	42550	42880	42970	-280	-190	292	6,273.96	1466
	20150424	42880	42970	43110	43310	43080	43190	43140	220	170	84	1,811.93	1460
	20150427	43190	43140	43480	43880	43430	43690	43630	550	490	72	1,570.87	1468
	20150428	43690	43630	43510	44040	43490	43580	43710	-50	80	134	2,929.01	1432
	20150429	43580	43710	43490	43790	43490	43610	43660	-100	-50	56	1,222.52	1426
	20150430	43610	43660	43900	44070	43850	44070	43960	410	300	48	1,055.25	1416
cu1604	20150416	42800	42800	42840	43440	42840	43400	43300	600	500	10	216.50	6
	20150417	43400	43300	43800	43800	43790	43790	43790	490	490	28	613.16	26
	20150420	43790	43790	43890	43890	43800	43810	43850	20	60	78	1,710.33	102
	20150421	43810	43850	43350	43500	43310	43310	43410	-540	-440	48	1,041.94	126
	20150422	43310	43410	43190	43250	43120	43190	43200	-220	-210	28	604.83	134
	20150423	43190	43200	43200	43200	42680	42910	43020	-290	-180	242	5,206.35	312
	20150424	42910	43020	43150	43290	43000	43150	43130	130	110	42	905.84	296
	20150427	43150	43130	43360	43790	43360	43750	43660	620	530	20	436.68	302
	20150428	43750	43660	43780	43980	43530	43540	43700	-120	40	100	2,185.43	332
	20150429	43540	43700	43710	43850	43530	43560	43710	-140	10	70	1,530.07	356
	20150430	43560	43710	43720	44100	43720	44090	43960	380	250	128	2,813.89	350
fu1503	20150105	2979	2979	2979	2979	2979	2979	2979	0	0	2	29.79	24
	20150106	2979	2979				2979	2979	0	0	0	0.00	24
	20150107	2979	2979				2979	2979	0	0	0	0.00	24
	20150108	2979	2979				2979	2979	0	0	0	0.00	24
	20150109	2979	2979				2979	2979	0	0	0	0.00	24
	20150112	2979	2979				2979	2979	0	0	0	0.00	24
	20150113	2979	2979				2979	2979	0	0	0	0.00	24
	20150114	2979	2979				2979	2979	0	0	0	0.00	24
	20150115	2979	2979	3000	3000	2833	2980	2937	1	-42	6	88.13	24
	20150116	2980	2937				2937	2937	0	0	0	0.00	24
	20150119	2937	2937	2790	3035	2790	2978	2934	41	-3	6	88.03	24
	20150120	2978	2934				2934	2934	0	0	0	0.00	24
	20150121	2934	2934	2788	2949	2788	2798	2871	-136	-63	8	114.84	30
	20150122	2798	2871	2727	3014	2727	2952	2904	81	33	64	929.32	30
	20150123	2952	2904	2780	3046	2780	2851	2930	-53	26	8	117.23	28
	20150126	2851	2930	2792	2796	2792	2796	2794	-134	-136	4	55.88	26
	20150127	2796	2794	2869	2869	2869	2869	2869	75	75	2	28.69	24
	20150128	2869	2869				2869	2869	0	0	0	0.00	24
	20150129	2869	2869				2869	2869	0	0	0	0.00	24
	20150130	2869	2869				2869	2869	0	0	0	0.00	24
	20150202	2869	2869	2800	2960	2725	2960	2828	91	-41	6	84.85	18
	20150203	2960	2828				2828	2828	0	0	0	0.00	18
	20150204	2828	2828				2828	2828	0	0	0	0.00	18
	20150205	2828	2828				2828	2828	0	0	0	0.00	18
	20150206	2828	2828				2828	2828	0	0	0	0.00	18
	20150209	2828	2828				2828	2828	0	0	0	0.00	18
	20150210	2828	2828				2828	2828	0	0	0	0.00	18
	20150211	2828	2828	2969	2969	2969	2969	2969	141	141	4	59.38	14
	20150212	2969	2969	2969	2969	2969	2969	2969	0	0	2	29.69	12
	20150213	2969	2969	2969	3117	2969	3117	3043	148	74	4	60.86	10
	20150216	3117	3043	3195	3195	3195	3195	3195	152	152	4	63.90	6
	20150217	3195	3195	3418	3418	3418	3418	3418	223	223	8	136.72	0
	20150225	3418	3418				3418	3418	0	0	0	0.00	0
	20150226	3418	3418				3418	3418	0	0	0	0.00	0
	20150227	3418	3418				3418	3418	0	0	0	0.00	0
fu1504	20150105	3159	3159				3159	3159	0	0	0	0.00	4
	20150106	3159	3159				3159	3159	0	0	0	0.00	4
	20150107	3159	3159				3159	3159	0	0	0	0.00	4
	20150108	3159	3159				3159	3159	0	0	0	0.00	4
	20150109	3159	3159				3159	3159	0	0	0	0.00	4
	20150112	3159	3159				3159	3159	0	0	0	0.00	4
	20150113	3159	3159				3159	3159	0	0	0	0.00	4
	20150114	3159	3159	3001	3304	3001	3299	3106	140	-53	28	434.91	8
	20150115	3299	3106	2950	3000	2950	3000	2975	-106	-131	4	59.50	6
	20150116	3000	2975	2990	2990	2990	2990	2990	15	15	2	29.90	4
	20150119	2990	2990				2990	2990	0	0	0	0.00	4
	20150120	2990	2990				2990	2990	0	0	0	0.00	4
	20150121	2990	2990				2990	2990	0	0	0	0.00	4
	20150122	2990	2990	3138	3138	3138	3138	3138	148	148	2	31.38	6
	20150123	3138	3138				3138	3138	0	0	0	0.00	6
	20150126	3138	3138				3138	3138	0	0	0	0.00	6
	20150127	3138	3138				3138	3138	0	0	0	0.00	6
	20150128	3138	3138				3138	3138	0	0	0	0.00	6
	20150129	3138	3138				3138	3138	0	0	0	0.00	6
	20150130	3138	3138				3138	3138	0	0	0	0.00	6
	20150202	3138	3138	3099	3099	3099	3099	3099	-39	-39	2	30.99	4
	20150203	3099	3099				3099	3099	0	0	0	0.00	4
	20150204	3099	3099				3099	3099	0	0	0	0.00	4
	20150205	3099	3099				3099	3099	0	0	0	0.00	4
	20150206	3099	3099				3099	3099	0	0	0	0.00	4
	20150209	3099	3099				3099	3099	0	0	0	0.00	4
	20150210	3099	3099				3099	3099	0	0	0	0.00	4
	20150211	3099	3099	2949	3099	2949	3099	3016	0	-83	6	90.48	2
	20150212	3099	3016				3016	3016	0	0	0	0.00	2
	20150213	3016	3016				3016	3016	0	0	0	0.00	2
	20150216	3016	3016				3016	3016	0	0	0	0.00	2
	20150217	3016	3016				3016	3016	0	0	0	0.00	2
	20150225	3016	3016				3016	3016	0	0	0	0.00	2
	20150226	3016	3016				3016	3016	0	0	0	0.00	2
	20150227	3016	3016				3016	3016	0	0	0	0.00	2
	20150302	3016	3016	2900	2900	2900	2900	2900	-116	-116	2	29.00	2
	20150303	2900	2900				2900	2900	0	0	0	0.00	2
	20150304	2900	2900				3045	3045	145	145	0	0.00	2
	20150305	3045	3045	2900	2900	2900	2900	2900	-145	-145	2	29.00	2
	20150306	2900	2900				3045	3045	145	145	0	0.00	2
	20150309	3045	3045	2892	2893	2892	2893	2892	-152	-153	4	57.85	0
	20150310	2893	2892				2892	2892	0	0	0	0.00	0
	20150311	2892	2892				2892	2892	0	0	0	0.00	0
	20150312	2892	2892				2892	2892	0	0	0	0.00	0
	20150313	2892	2892				2892	2892	0	0	0	0.00	0
	20150316	2892	2892				2892	2892	0	0	0	0.00	0
	20150317	2892	2892				2892	2892	0	0	0	0.00	0
	20150318	2892	2892				2892	2892	0	0	0	0.00	0
	20150319	2892	2892				2892	2892	0	0	0	0.00	0
	20150320	2892	2892				2892	2892	0	0	0	0.00	0
	20150323	2892	2892				2892	2892	0	0	0	0.00	0
	20150324	2892	2892				2892	2892	0	0	0	0.00	0
	20150325	2892	2892				2892	2892	0	0	0	0.00	0
	20150326	2892	2892				2892	2892	0	0	0	0.00	0
	20150327	2892	2892				2892	2892	0	0	0	0.00	0
	20150330	2892	2892				2892	2892	0	0	0	0.00	0
	20150331	2892	2892				2892	2892	0	0	0	0.00	0
fu1505	20150105	3094	3094				3094	3094	0	0	0	0.00	10
	20150106	3094	3094				3094	3094	0	0	0	0.00	10
	20150107	3094	3094				3094	3094	0	0	0	0.00	10
	20150108	3094	3094				3094	3094	0	0	0	0.00	10
	20150109	3094	3094				3094	3094	0	0	0	0.00	10
	20150112	3094	3094	2939	3247	2939	3094	3087	0	-7	20	308.76	10
	20150113	3094	3087				3087	3087	0	0	0	0.00	10
	20150114	3087	3087				3087	3087	0	0	0	0.00	10
	20150115	3087	3087				3087	3087	0	0	0	0.00	10
	20150116	3087	3087				3087	3087	0	0	0	0.00	10
	20150119	3087	3087	3000	3237	3000	3237	3040	150	-47	12	182.41	10
	20150120	3237	3040				3040	3040	0	0	0	0.00	10
	20150121	3040	3040				3040	3040	0	0	0	0.00	10
	20150122	3040	3040	3192	3192	3192	3192	3192	152	152	4	63.84	10
	20150123	3192	3192				3192	3192	0	0	0	0.00	10
	20150126	3192	3192				3192	3192	0	0	0	0.00	10
	20150127	3192	3192				3192	3192	0	0	0	0.00	10
	20150128	3192	3192				3192	3192	0	0	0	0.00	10
	20150129	3192	3192				3192	3192	0	0	0	0.00	10
	20150130	3192	3192	3041	3041	3040	3040	3040	-152	-152	10	152.01	2
	20150202	3040	3040	3192	3192	3189	3192	3191	152	151	8	127.65	10
	20150203	3192	3191				3191	3191	0	0	0	0.00	10
	20150204	3191	3191				3191	3191	0	0	0	0.00	10
	20150205	3191	3191	3350	3350	3042	3042	3144	-149	-47	6	94.34	12
	20150206	3042	3144	2992	3298	2992	3298	3145	154	1	4	62.90	12
	20150209	3298	3145				3145	3145	0	0	0	0.00	12
	20150210	3145	3145	3011	3011	3011	3011	3011	-134	-134	2	30.11	10
	20150211	3011	3011				2930	2930	-81	-81	0	0.00	10
	20150212	2930	2930				3076	3076	146	146	0	0.00	10
	20150213	3076	3076				3151	3151	75	75	0	0.00	10
	20150216	3151	3151				3151	3151	0	0	0	0.00	10
	20150217	3151	3151	3103	3300	3103	3300	3152	149	1	8	126.09	4
	20150225	3300	3152	3260	3260	3260	3260	3260	108	108	2	32.60	4
	20150226	3260	3260	3300	3300	3201	3201	3250	-59	-10	4	65.01	0
	20150227	3201	3250				3250	3250	0	0	0	0.00	0
	20150302	3250	3250				3250	3250	0	0	0	0.00	0
	20150303	3250	3250				3250	3250	0	0	0	0.00	0
	20150304	3250	3250				3250	3250	0	0	0	0.00	0
	20150305	3250	3250				3095	3095	-155	-155	0	0.00	0
	20150306	3095	3095				3249	3249	154	154	0	0.00	0
	20150309	3249	3249				3086	3086	-163	-163	0	0.00	0
	20150310	3086	3086				3086	3086	0	0	0	0.00	0
	20150311	3086	3086				3086	3086	0	0	0	0.00	0
	20150312	3086	3086				3086	3086	0	0	0	0.00	0
	20150313	3086	3086				3086	3086	0	0	0	0.00	0
	20150316	3086	3086				3086	3086	0	0	0	0.00	0
	20150317	3086	3086				3086	3086	0	0	0	0.00	0
	20150318	3086	3086				3086	3086	0	0	0	0.00	0
	20150319	3086	3086				3086	3086	0	0	0	0.00	0
	20150320	3086	3086				3086	3086	0	0	0	0.00	0
	20150323	3086	3086				3086	3086	0	0	0	0.00	0
	20150324	3086	3086				3086	3086	0	0	0	0.00	0
	20150325	3086	3086				3086	3086	0	0	0	0.00	0
	20150326	3086	3086				3086	3086	0	0	0	0.00	0
	20150327	3086	3086				3086	3086	0	0	0	0.00	0
	20150330	3086	3086				3086	3086	0	0	0	0.00	0
	20150331	3086	3086				3086	3086	0	0	0	0.00	0
	20150401	3086	3086				3086	3086	0	0	0	0.00	0
	20150402	3086	3086				3086	3086	0	0	0	0.00	0
	20150403	3086	3086				3086	3086	0	0	0	0.00	0
	20150407	3086	3086				3086	3086	0	0	0	0.00	0
	20150408	3086	3086				3086	3086	0	0	0	0.00	0
	20150409	3086	3086				3086	3086	0	0	0	0.00	0
	20150410	3086	3086				3086	3086	0	0	0	0.00	0
	20150413	3086	3086				3086	3086	0	0	0	0.00	0
	20150414	3086	3086				3086	3086	0	0	0	0.00	0
	20150415	3086	3086				3086	3086	0	0	0	0.00	0
	20150416	3086	3086				3086	3086	0	0	0	0.00	0
	20150417	3086	3086				3086	3086	0	0	0	0.00	0
	20150420	3086	3086				3086	3086	0	0	0	0.00	0
	20150421	3086	3086				3086	3086	0	0	0	0.00	0
	20150422	3086	3086				3086	3086	0	0	0	0.00	0
	20150423	3086	3086				3086	3086	0	0	0	0.00	0
	20150424	3086	3086				3086	3086	0	0	0	0.00	0
	20150427	3086	3086				3086	3086	0	0	0	0.00	0
	20150428	3086	3086				3086	3086	0	0	0	0.00	0
	20150429	3086	3086				3086	3086	0	0	0	0.00	0
	20150430	3086	3086				3086	3086	0	0	0	0.00	0
fu1506	20150105	3131	3131	3276	3276	3138	3138	3201	7	70	10	160.09	6
	20150106	3138	3201	3265	3360	3169	3221	3228	20	27	48	774.91	10
	20150107	3221	3228	3169	3237	3169	3237	3191	9	-37	6	95.75	12
	20150108	3237	3191				3191	3191	0	0	0	0.00	12
	20150109	3191	3191				3191	3191	0	0	0	0.00	12
	20150112	3191	3191				3191	3191	0	0	0	0.00	12
	20150113	3191	3191				3191	3191	0	0	0	0.00	12
	20150114	3191	3191				3191	3191	0	0	0	0.00	12
	20150115	3191	3191	3161	3161	3161	3161	3161	-30	-30	2	31.61	12
	20150116	3161	3161				3163	3163	2	2	0	0.00	12
	20150119	3163	3163	3319	3319	3166	3166	3278	3	115	8	131.15	14
	20150120	3166	3278				3278	3278	0	0	0	0.00	14
	20150121	3278	3278				3278	3278	0	0	0	0.00	14
	20150122	3278	3278				3278	3278	0	0	0	0.00	14
	20150123	3278	3278				3278	3278	0	0	0	0.00	14
	20150126	3278	3278				3278	3278	0	0	0	0.00	14
	20150127	3278	3278				3261	3261	-17	-17	0	0.00	14
	20150128	3261	3261				3261	3261	0	0	0	0.00	14
	20150129	3261	3261	3168	3168	3168	3168	3168	-93	-93	2	31.68	14
	20150130	3168	3168				3170	3170	2	2	0	0.00	14
	20150202	3170	3170				3181	3181	11	11	0	0.00	14
	20150203	3181	3181	3188	3315	3186	3293	3245	112	64	8	129.82	20
	20150204	3293	3245	3086	3309	3086	3200	3258	-45	13	14	228.09	20
	20150205	3200	3258	3101	3370	3101	3333	3279	75	21	38	623.12	22
	20150206	3333	3279	3155	3348	3155	3270	3266	-9	-13	14	228.62	20
	20150209	3270	3266	3120	3347	3120	3328	3246	62	-20	18	292.21	18
	20150210	3328	3246	3151	3183	3151	3183	3167	-63	-79	4	63.34	16
	20150211	3183	3167	3020	3293	3020	3212	3234	45	67	26	420.46	18
	20150212	3212	3234	3206	3324	3206	3242	3252	8	18	10	162.61	14
	20150213	3242	3252	3162	3388	3162	3376	3317	124	65	40	663.54	26
	20150216	3376	3317	3330	3340	3330	3340	3335	23	18	4	66.70	26
	20150217	3340	3335	3120	3460	3120	3460	3350	125	15	14	234.51	30
	20150225	3460	3350	3351	3351	3251	3347	3314	-3	-36	22	364.59	30
	20150226	3347	3314	3350	3459	3348	3400	3404	86	90	14	238.31	34
	20150227	3400	3404	3321	3396	3321	3395	3370	-9	-34	6	101.12	32
	20150302	3395	3370	3449	3498	3395	3497	3452	127	82	14	241.69	36
	20150303	3497	3452	3407	3599	3407	3569	3541	117	89	40	708.32	42
	20150304	3569	3541	3414	3621	3414	3581	3544	40	3	28	496.23	28
	20150305	3581	3544	3540	3718	3540	3706	3646	162	102	68	1,239.72	38
	20150306	3706	3646	3647	3828	3647	3828	3799	182	153	32	607.89	38
	20150309	3828	3799	3865	3988	3865	3988	3982	189	183	46	916.01	64
	20150310	3988	3982	3876	4089	3836	3836	3883	-146	-99	16	310.71	60
	20150311	3836	3883	3991	3991	3690	3864	3784	-19	-99	40	756.92	70
	20150312	3864	3784	3783	3842	3610	3610	3692	-174	-92	32	590.78	76
	20150313	3610	3692	3513	3515	3507	3507	3509	-185	-183	16	280.78	72
	20150316	3507	3509	3506	3506	3228	3268	3254	-241	-255	68	1,106.68	82
	20150317	3268	3254	3096	3398	3096	3196	3190	-58	-64	130	2,074.12	102
	20150318	3196	3190	3150	3233	3150	3181	3193	-9	3	56	894.31	112
	20150319	3181	3193	3280	3308	3202	3280	3262	87	69	144	2,348.73	136
	20150320	3280	3262	3281	3281	3221	3221	3256	-41	-6	18	293.09	134
	20150323	3221	3256	3266	3356	3202	3290	3287	34	31	144	2,366.81	166
	20150324	3290	3287	3322	3322	3216	3265	3253	-22	-34	78	1,268.90	162
	20150325	3265	3253	3217	3280	3217	3266	3248	13	-5	36	584.67	168
	20150326	3266	3248	3296	3408	3263	3370	3343	122	95	156	2,607.88	182
	20150327	3370	3343	3343	3344	3250	3313	3302	-30	-41	40	660.51	178
	20150330	3313	3302	3310	3310	3200	3215	3239	-87	-63	26	421.10	176
	20150331	3215	3239	3310	3310	3203	3230	3243	-9	4	16	259.47	174
	20150401	3230	3243	3200	3279	3180	3203	3220	-40	-23	24	386.50	180
	20150402	3203	3220	3250	3310	3234	3244	3263	24	43	44	717.98	188
	20150403	3244	3263	3221	3235	3182	3235	3212	-28	-51	10	160.60	188
	20150407	3235	3212	3127	3337	3126	3306	3271	94	59	128	2,093.89	198
	20150408	3306	3271	3297	3345	3297	3310	3328	39	57	76	1,264.86	206
	20150409	3310	3328	3251	3308	3251	3275	3283	-53	-45	30	492.46	198
	20150410	3275	3283	3276	3281	3213	3258	3256	-25	-27	38	618.78	194
	20150413	3258	3256	3272	3317	3272	3281	3283	25	27	24	393.99	188
	20150414	3281	3283	3281	3281	3234	3277	3269	-6	-14	10	163.45	188
	20150415	3277	3269	3280	3280	3226	3279	3264	10	-5	18	293.81	192
	20150416	3279	3264	3312	3312	3260	3288	3299	24	35	50	824.93	190
	20150417	3288	3299	3313	3380	3313	3359	3354	60	55	90	1,509.51	204
	20150420	3359	3354	3367	3376	3317	3349	3341	-5	-13	70	1,169.35	194
	20150421	3349	3341	3321	3357	3321	3343	3343	2	2	48	802.37	180
	20150422	3343	3343	3327	3350	3326	3333	3339	-10	-4	32	534.28	178
	20150423	3333	3339	3337	3352	3331	3346	3342	7	3	56	935.90	170
	20150424	3346	3342	3346	3375	3344	3352	3355	10	13	50	838.86	168
	20150427	3352	3355	3357	3387	3357	3382	3376	27	21	24	405.12	176
	20150428	3382	3376	3389	3506	3389	3423	3456	47	80	50	864.22	176
	20150429	3423	3456	3421	3444	3367	3422	3423	-34	-33	44	753.20	174
	20150430	3422	3423	3425	3525	3425	3431	3465	8	42	56	970.23	170
fu1507	20150105	3259	3259				3259	3259	0	0	0	0.00	0
	20150106	3259	3259				3259	3259	0	0	0	0.00	0
	20150107	3259	3259				3259	3259	0	0	0	0.00	0
	20150108	3259	3259				3259	3259	0	0	0	0.00	0
	20150109	3259	3259				3259	3259	0	0	0	0.00	0
	20150112	3259	3259				3259	3259	0	0	0	0.00	0
	20150113	3259	3259				3259	3259	0	0	0	0.00	0
	20150114	3259	3259				3259	3259	0	0	0	0.00	0
	20150115	3259	3259				3259	3259	0	0	0	0.00	0
	20150116	3259	3259				3259	3259	0	0	0	0.00	0
	20150119	3259	3259				3378	3378	119	119	0	0.00	0
	20150120	3378	3378				3378	3378	0	0	0	0.00	0
	20150121	3378	3378				3305	3305	-73	-73	0	0.00	0
	20150122	3305	3305				3470	3470	165	165	0	0.00	0
	20150123	3470	3470				3501	3501	31	31	0	0.00	0
	20150126	3501	3501				3338	3338	-163	-163	0	0.00	0
	20150127	3338	3338				3427	3427	89	89	0	0.00	0
	20150128	3427	3427				3427	3427	0	0	0	0.00	0
	20150129	3427	3427				3329	3329	-98	-98	0	0.00	0
	20150130	3329	3329				3170	3170	-159	-159	0	0.00	0
	20150202	3170	3170				3327	3327	157	157	0	0.00	0
	20150203	3327	3327	3327	3327	3209	3209	3268	-118	-59	4	65.36	4
	20150204	3209	3268	3209	3209	3208	3208	3208	-60	-60	4	64.17	2
	20150205	3208	3208				3208	3208	0	0	0	0.00	2
	20150206	3208	3208				3208	3208	0	0	0	0.00	2
	20150209	3208	3208				3208	3208	0	0	0	0.00	2
	20150210	3208	3208				3208	3208	0	0	0	0.00	2
	20150211	3208	3208				3208	3208	0	0	0	0.00	2
	20150212	3208	3208				3208	3208	0	0	0	0.00	2
	20150213	3208	3208				3208	3208	0	0	0	0.00	2
	20150216	3208	3208				3208	3208	0	0	0	0.00	2
	20150217	3208	3208				3222	3222	14	14	0	0.00	2
	20150225	3222	3222				3222	3222	0	0	0	0.00	2
	20150226	3222	3222				3309	3309	87	87	0	0.00	2
	20150227	3309	3309				3309	3309	0	0	0	0.00	2
	20150302	3309	3309				3390	3390	81	81	0	0.00	2
	20150303	3390	3390				3390	3390	0	0	0	0.00	2
	20150304	3390	3390				3390	3390	0	0	0	0.00	2
	20150305	3390	3390				3487	3487	97	97	0	0.00	2
	20150306	3487	3487				3633	3633	146	146	0	0.00	2
	20150309	3633	3633				3808	3808	175	175	0	0.00	2
	20150310	3808	3808				3808	3808	0	0	0	0.00	2
	20150311	3808	3808	3617	3617	3617	3617	3617	-191	-191	2	36.17	2
	20150312	3617	3617				3529	3529	-88	-88	0	0.00	2
	20150313	3529	3529				3480	3480	-49	-49	0	0.00	2
	20150316	3480	3480	3339	3339	3339	3339	3339	-141	-141	2	33.39	2
	20150317	3339	3339				3274	3274	-65	-65	0	0.00	2
	20150318	3274	3274				3274	3274	0	0	0	0.00	2
	20150319	3274	3274	3111	3111	3111	3111	3111	-163	-163	2	31.11	4
	20150320	3111	3111				3105	3105	-6	-6	0	0.00	4
	20150323	3105	3105				3134	3134	29	29	0	0.00	4
	20150324	3134	3134	3002	3002	3002	3002	3002	-132	-132	2	30.02	2
	20150325	3002	3002				3152	3152	150	150	0	0.00	2
	20150326	3152	3152				3244	3244	92	92	0	0.00	2
	20150327	3244	3244	3406	3406	3162	3162	3324	-82	80	6	99.74	6
	20150330	3162	3324				3324	3324	0	0	0	0.00	6
	20150331	3324	3324				3324	3324	0	0	0	0.00	6
	20150401	3324	3324				3324	3324	0	0	0	0.00	6
	20150402	3324	3324				3324	3324	0	0	0	0.00	6
	20150403	3324	3324				3324	3324	0	0	0	0.00	6
	20150407	3324	3324				3324	3324	0	0	0	0.00	6
	20150408	3324	3324	3158	3158	3158	3158	3158	-166	-166	2	31.58	6
	20150409	3158	3158				3115	3115	-43	-43	0	0.00	6
	20150410	3115	3115				3270	3270	155	155	0	0.00	6
	20150413	3270	3270				3297	3297	27	27	0	0.00	6
	20150414	3297	3297	3134	3134	3134	3134	3134	-163	-163	2	31.34	6
	20150415	3134	3134				3129	3129	-5	-5	0	0.00	6
	20150416	3129	3129				3285	3285	156	156	0	0.00	6
	20150417	3285	3285	3157	3427	3157	3173	3263	-112	-22	12	195.80	6
	20150420	3173	3263	3190	3190	3190	3190	3190	-73	-73	4	63.80	6
	20150421	3190	3190	3349	3349	3349	3349	3349	159	159	2	33.49	4
	20150422	3349	3349	3204	3204	3204	3204	3204	-145	-145	2	32.04	4
	20150423	3204	3204				3207	3207	3	3	0	0.00	4
	20150424	3207	3207				3219	3219	12	12	0	0.00	4
	20150427	3219	3219	3061	3379	3061	3379	3252	160	33	6	97.57	6
	20150428	3379	3252	3259	3259	3259	3259	3259	7	7	2	32.59	4
	20150429	3259	3259				3228	3228	-31	-31	0	0.00	4
	20150430	3228	3228				3267	3267	39	39	0	0.00	4
fu1508	20150105	3150	3150				3150	3150	0	0	0	0.00	0
	20150106	3150	3150				3150	3150	0	0	0	0.00	0
	20150107	3150	3150				3150	3150	0	0	0	0.00	0
	20150108	3150	3150				3150	3150	0	0	0	0.00	0
	20150109	3150	3150				3150	3150	0	0	0	0.00	0
	20150112	3150	3150				3150	3150	0	0	0	0.00	0
	20150113	3150	3150				3150	3150	0	0	0	0.00	0
	20150114	3150	3150				3150	3150	0	0	0	0.00	0
	20150115	3150	3150				3150	3150	0	0	0	0.00	0
	20150116	3150	3150				3150	3150	0	0	0	0.00	0
	20150119	3150	3150				3150	3150	0	0	0	0.00	0
	20150120	3150	3150				3150	3150	0	0	0	0.00	0
	20150121	3150	3150				3150	3150	0	0	0	0.00	0
	20150122	3150	3150				3150	3150	0	0	0	0.00	0
	20150123	3150	3150				3150	3150	0	0	0	0.00	0
	20150126	3150	3150				3150	3150	0	0	0	0.00	0
	20150127	3150	3150				3150	3150	0	0	0	0.00	0
	20150128	3150	3150				3150	3150	0	0	0	0.00	0
	20150129	3150	3150				3150	3150	0	0	0	0.00	0
	20150130	3150	3150				3150	3150	0	0	0	0.00	0
	20150202	3150	3150				3150	3150	0	0	0	0.00	0
	20150203	3150	3150				3150	3150	0	0	0	0.00	0
	20150204	3150	3150				3150	3150	0	0	0	0.00	0
	20150205	3150	3150				3150	3150	0	0	0	0.00	0
	20150206	3150	3150				3150	3150	0	0	0	0.00	0
	20150209	3150	3150				3150	3150	0	0	0	0.00	0
	20150210	3150	3150				3150	3150	0	0	0	0.00	0
	20150211	3150	3150				3150	3150	0	0	0	0.00	0
	20150212	3150	3150				3150	3150	0	0	0	0.00	0
	20150213	3150	3150	3307	3307	2992	3160	3153	10	3	6	94.59	0
	20150216	3160	3153				3153	3153	0	0	0	0.00	0
	20150217	3153	3153	3373	3373	3373	3373	3373	220	220	2	33.73	2
	20150225	3373	3373	3136	3136	3136	3136	3136	-237	-237	2	31.36	0
	20150226	3136	3136				3221	3221	85	85	0	0.00	0
	20150227	3221	3221				3221	3221	0	0	0	0.00	0
	20150302	3221	3221				3300	3300	79	79	0	0.00	0
	20150303	3300	3300				3385	3385	85	85	0	0.00	0
	20150304	3385	3385				3385	3385	0	0	0	0.00	0
	20150305	3385	3385				3482	3482	97	97	0	0.00	0
	20150306	3482	3482	3347	3347	3347	3347	3347	-135	-135	2	33.47	2
	20150309	3347	3347				3508	3508	161	161	0	0.00	2
	20150310	3508	3508				3421	3421	-87	-87	0	0.00	2
	20150311	3421	3421				3249	3249	-172	-172	0	0.00	2
	20150312	3249	3249				3170	3170	-79	-79	0	0.00	2
	20150313	3170	3170				3013	3013	-157	-157	0	0.00	2
	20150316	3013	3013				2890	2890	-123	-123	0	0.00	2
	20150317	2890	2890				3034	3034	144	144	0	0.00	2
	20150318	3034	3034				3037	3037	3	3	0	0.00	2
	20150319	3037	3037				2885	2885	-152	-152	0	0.00	2
	20150320	2885	2885				2880	2880	-5	-5	0	0.00	2
	20150323	2880	2880				2907	2907	27	27	0	0.00	2
	20150324	2907	2907				3052	3052	145	145	0	0.00	2
	20150325	3052	3052				3047	3047	-5	-5	0	0.00	2
	20150326	3047	3047				3199	3199	152	152	0	0.00	2
	20150327	3199	3199				3278	3278	79	79	0	0.00	2
	20150330	3278	3278				3278	3278	0	0	0	0.00	2
	20150331	3278	3278				3278	3278	0	0	0	0.00	2
	20150401	3278	3278				3278	3278	0	0	0	0.00	2
	20150402	3278	3278				3278	3278	0	0	0	0.00	2
	20150403	3278	3278				3278	3278	0	0	0	0.00	2
	20150407	3278	3278				3278	3278	0	0	0	0.00	2
	20150408	3278	3278				3114	3114	-164	-164	0	0.00	2
	20150409	3114	3114				3071	3071	-43	-43	0	0.00	2
	20150410	3071	3071				3224	3224	153	153	0	0.00	2
	20150413	3224	3224				3250	3250	26	26	0	0.00	2
	20150414	3250	3250				3089	3089	-161	-161	0	0.00	2
	20150415	3089	3089				3243	3243	154	154	0	0.00	2
	20150416	3243	3243				3278	3278	35	35	0	0.00	2
	20150417	3278	3278				3256	3256	-22	-22	0	0.00	2
	20150420	3256	3256				3183	3183	-73	-73	0	0.00	2
	20150421	3183	3183				3341	3341	158	158	0	0.00	2
	20150422	3341	3341				3341	3341	0	0	0	0.00	2
	20150423	3341	3341				3341	3341	0	0	0	0.00	2
	20150424	3341	3341				3341	3341	0	0	0	0.00	2
	20150427	3341	3341				3341	3341	0	0	0	0.00	2
	20150428	3341	3341				3348	3348	7	7	0	0.00	2
	20150429	3348	3348				3348	3348	0	0	0	0.00	2
	20150430	3348	3348				3398	3398	50	50	0	0.00	2
fu1509	20150105	3124	3124				3124	3124	0	0	0	0.00	4
	20150106	3124	3124	3280	3280	2967	3124	3123	0	-1	6	93.71	6
	20150107	3124	3123				3123	3123	0	0	0	0.00	6
	20150108	3123	3123				3123	3123	0	0	0	0.00	6
	20150109	3123	3123				3123	3123	0	0	0	0.00	6
	20150112	3123	3123				3123	3123	0	0	0	0.00	6
	20150113	3123	3123				3123	3123	0	0	0	0.00	6
	20150114	3123	3123				3123	3123	0	0	0	0.00	6
	20150115	3123	3123				3123	3123	0	0	0	0.00	6
	20150116	3123	3123				3123	3123	0	0	0	0.00	6
	20150119	3123	3123				3123	3123	0	0	0	0.00	6
	20150120	3123	3123				3123	3123	0	0	0	0.00	6
	20150121	3123	3123				3123	3123	0	0	0	0.00	6
	20150122	3123	3123				3123	3123	0	0	0	0.00	6
	20150123	3123	3123				3123	3123	0	0	0	0.00	6
	20150126	3123	3123				3123	3123	0	0	0	0.00	6
	20150127	3123	3123	3278	3278	2975	2975	3126	-148	3	4	62.53	8
	20150128	2975	3126	3282	3282	3282	3282	3282	156	156	2	32.82	10
	20150129	3282	3282				3188	3188	-94	-94	0	0.00	10
	20150130	3188	3188	3158	3158	3158	3158	3158	-30	-30	2	31.58	8
	20150202	3158	3158	3315	3315	3315	3315	3315	157	157	2	33.15	10
	20150203	3315	3315				3256	3256	-59	-59	0	0.00	10
	20150204	3256	3256				3256	3256	0	0	0	0.00	10
	20150205	3256	3256				3256	3256	0	0	0	0.00	10
	20150206	3256	3256				3243	3243	-13	-13	0	0.00	10
	20150209	3243	3243				3223	3223	-20	-20	0	0.00	10
	20150210	3223	3223				3144	3144	-79	-79	0	0.00	10
	20150211	3144	3144				3144	3144	0	0	0	0.00	10
	20150212	3144	3144				3144	3144	0	0	0	0.00	10
	20150213	3144	3144	3301	3301	3300	3300	3300	156	156	4	66.01	14
	20150216	3300	3300				3300	3300	0	0	0	0.00	14
	20150217	3300	3300				3300	3300	0	0	0	0.00	14
	20150225	3300	3300				3300	3300	0	0	0	0.00	14
	20150226	3300	3300				3300	3300	0	0	0	0.00	14
	20150227	3300	3300				3267	3267	-33	-33	0	0.00	14
	20150302	3267	3267				3290	3290	23	23	0	0.00	14
	20150303	3290	3290				3290	3290	0	0	0	0.00	14
	20150304	3290	3290	3454	3454	3454	3454	3454	164	164	2	34.54	14
	20150305	3454	3454				3454	3454	0	0	0	0.00	14
	20150306	3454	3454				3320	3320	-134	-134	0	0.00	14
	20150309	3320	3320	3156	3156	3156	3156	3156	-164	-164	2	31.56	14
	20150310	3156	3156				3313	3313	157	157	0	0.00	14
	20150311	3313	3313	3150	3150	3150	3150	3150	-163	-163	2	31.50	14
	20150312	3150	3150				3073	3073	-77	-77	0	0.00	14
	20150313	3073	3073				3226	3226	153	153	0	0.00	14
	20150316	3226	3226	3066	3066	3066	3066	3066	-160	-160	2	30.66	14
	20150317	3066	3066	3219	3219	3219	3219	3219	153	153	6	96.57	18
	20150318	3219	3219				3219	3219	0	0	0	0.00	18
	20150319	3219	3219				3219	3219	0	0	0	0.00	18
	20150320	3219	3219	3349	3350	3349	3350	3349	131	130	8	133.97	24
	20150323	3350	3349	3350	3380	3343	3380	3357	31	8	6	100.73	26
	20150324	3380	3357				3357	3357	0	0	0	0.00	26
	20150325	3357	3357	3221	3336	3221	3336	3278	-21	-79	4	65.57	24
	20150326	3336	3278				3306	3306	28	28	0	0.00	24
	20150327	3306	3306				3306	3306	0	0	0	0.00	24
	20150330	3306	3306	3465	3465	3465	3465	3465	159	159	2	34.65	26
	20150331	3465	3465	3301	3495	3301	3495	3398	30	-67	4	67.96	28
	20150401	3495	3398	3290	3290	3290	3290	3290	-108	-108	2	32.90	28
	20150402	3290	3290				3290	3290	0	0	0	0.00	28
	20150403	3290	3290				3290	3290	0	0	0	0.00	28
	20150407	3290	3290				3291	3291	1	1	0	0.00	28
	20150408	3291	3291				3291	3291	0	0	0	0.00	28
	20150409	3291	3291	3157	3157	3157	3157	3157	-134	-134	2	31.57	28
	20150410	3157	3157	3314	3314	3314	3314	3314	157	157	2	33.14	30
	20150413	3314	3314	3269	3269	3269	3269	3269	-45	-45	2	32.69	28
	20150414	3269	3269				3107	3107	-162	-162	0	0.00	28
	20150415	3107	3107				3262	3262	155	155	0	0.00	28
	20150416	3262	3262				3297	3297	35	35	0	0.00	28
	20150417	3297	3297				3328	3328	31	31	0	0.00	28
	20150420	3328	3328	3492	3492	3492	3492	3492	164	164	2	34.92	28
	20150421	3492	3492	3352	3352	3352	3352	3352	-140	-140	2	33.52	28
	20150422	3352	3352				3354	3354	2	2	0	0.00	28
	20150423	3354	3354				3354	3354	0	0	0	0.00	28
	20150424	3354	3354				3354	3354	0	0	0	0.00	28
	20150427	3354	3354				3354	3354	0	0	0	0.00	28
	20150428	3354	3354				3354	3354	0	0	0	0.00	28
	20150429	3354	3354				3354	3354	0	0	0	0.00	28
	20150430	3354	3354	3499	3520	3482	3482	3501	128	147	8	140.04	32
fu1510	20150105	3123	3123				3123	3123	0	0	0	0.00	6
	20150106	3123	3123				3123	3123	0	0	0	0.00	6
	20150107	3123	3123				3123	3123	0	0	0	0.00	6
	20150108	3123	3123				3123	3123	0	0	0	0.00	6
	20150109	3123	3123				3123	3123	0	0	0	0.00	6
	20150112	3123	3123				3123	3123	0	0	0	0.00	6
	20150113	3123	3123				3123	3123	0	0	0	0.00	6
	20150114	3123	3123				3123	3123	0	0	0	0.00	6
	20150115	3123	3123				3123	3123	0	0	0	0.00	6
	20150116	3123	3123				3123	3123	0	0	0	0.00	6
	20150119	3123	3123				3123	3123	0	0	0	0.00	6
	20150120	3123	3123				3123	3123	0	0	0	0.00	6
	20150121	3123	3123				3123	3123	0	0	0	0.00	6
	20150122	3123	3123				3123	3123	0	0	0	0.00	6
	20150123	3123	3123	3277	3277	3277	3277	3277	154	154	2	32.77	8
	20150126	3277	3277				3277	3277	0	0	0	0.00	8
	20150127	3277	3277				3277	3277	0	0	0	0.00	8
	20150128	3277	3277				3276	3276	-1	-1	0	0.00	8
	20150129	3276	3276				3182	3182	-94	-94	0	0.00	8
	20150130	3182	3182				3152	3152	-30	-30	0	0.00	8
	20150202	3152	3152				3152	3152	0	0	0	0.00	8
	20150203	3152	3152				3152	3152	0	0	0	0.00	8
	20150204	3152	3152				3152	3152	0	0	0	0.00	8
	20150205	3152	3152				3152	3152	0	0	0	0.00	8
	20150206	3152	3152				3139	3139	-13	-13	0	0.00	8
	20150209	3139	3139				3139	3139	0	0	0	0.00	8
	20150210	3139	3139				3139	3139	0	0	0	0.00	8
	20150211	3139	3139				3139	3139	0	0	0	0.00	8
	20150212	3139	3139				3139	3139	0	0	0	0.00	8
	20150213	3139	3139				3295	3295	156	156	0	0.00	8
	20150216	3295	3295				3295	3295	0	0	0	0.00	8
	20150217	3295	3295				3295	3295	0	0	0	0.00	8
	20150225	3295	3295				3295	3295	0	0	0	0.00	8
	20150226	3295	3295	3288	3288	3288	3288	3288	-7	-7	2	32.88	8
	20150227	3288	3288				3255	3255	-33	-33	0	0.00	8
	20150302	3255	3255				3255	3255	0	0	0	0.00	8
	20150303	3255	3255	3345	3345	3345	3345	3345	90	90	2	33.45	8
	20150304	3345	3345				3450	3450	105	105	0	0.00	8
	20150305	3450	3450				3550	3550	100	100	0	0.00	8
	20150306	3550	3550				3550	3550	0	0	0	0.00	8
	20150309	3550	3550	3374	3374	3374	3374	3374	-176	-176	2	33.74	8
	20150310	3374	3374	3382	3382	3382	3382	3382	8	8	2	33.82	6
	20150311	3382	3382				3382	3382	0	0	0	0.00	6
	20150312	3382	3382	3301	3364	3223	3364	3276	-18	-106	14	229.36	10
	20150313	3364	3276				3114	3114	-162	-162	0	0.00	10
	20150316	3114	3114				2959	2959	-155	-155	0	0.00	10
	20150317	2959	2959	3001	3001	3001	3001	3001	42	42	4	60.02	6
	20150318	3001	3001				3004	3004	3	3	0	0.00	6
	20150319	3004	3004				2854	2854	-150	-150	0	0.00	6
	20150320	2854	2854				2996	2996	142	142	0	0.00	6
	20150323	2996	2996				3145	3145	149	149	0	0.00	6
	20150324	3145	3145				3012	3012	-133	-133	0	0.00	6
	20150325	3012	3012				3162	3162	150	150	0	0.00	6
	20150326	3162	3162				3254	3254	92	92	0	0.00	6
	20150327	3254	3254	3095	3095	3095	3095	3095	-159	-159	2	30.95	4
	20150330	3095	3095				3243	3243	148	148	0	0.00	4
	20150331	3243	3243				3180	3180	-63	-63	0	0.00	4
	20150401	3180	3180				3078	3078	-102	-102	0	0.00	4
	20150402	3078	3078	3231	3231	3231	3231	3231	153	153	2	32.31	2
	20150403	3231	3231				3231	3231	0	0	0	0.00	2
	20150407	3231	3231				3291	3291	60	60	0	0.00	2
	20150408	3291	3291				3126	3126	-165	-165	0	0.00	2
	20150409	3126	3126				2998	2998	-128	-128	0	0.00	2
	20150410	2998	2998				3147	3147	149	149	0	0.00	2
	20150413	3147	3147				3104	3104	-43	-43	0	0.00	2
	20150414	3104	3104				2950	2950	-154	-154	0	0.00	2
	20150415	2950	2950				3097	3097	147	147	0	0.00	2
	20150416	3097	3097				3251	3251	154	154	0	0.00	2
	20150417	3251	3251				3301	3301	50	50	0	0.00	2
	20150420	3301	3301	3289	3289	3289	3289	3289	-12	-12	2	32.89	2
	20150421	3289	3289				3301	3301	12	12	0	0.00	2
	20150422	3301	3301				3303	3303	2	2	0	0.00	2
	20150423	3303	3303				3304	3304	1	1	0	0.00	2
	20150424	3304	3304	3141	3468	3141	3468	3304	164	0	4	66.09	4
	20150427	3468	3304	3302	3302	3302	3302	3302	-2	-2	2	33.02	2
	20150428	3302	3302				3302	3302	0	0	0	0.00	2
	20150429	3302	3302				3310	3310	8	8	0	0.00	2
	20150430	3310	3310	3475	3475	3289	3289	3382	-21	72	4	67.64	4
fu1511	20150105	3230	3230				3230	3230	0	0	0	0.00	2
	20150106	3230	3230				3230	3230	0	0	0	0.00	2
	20150107	3230	3230				3230	3230	0	0	0	0.00	2
	20150108	3230	3230				3230	3230	0	0	0	0.00	2
	20150109	3230	3230				3230	3230	0	0	0	0.00	2
	20150112	3230	3230				3230	3230	0	0	0	0.00	2
	20150113	3230	3230				3230	3230	0	0	0	0.00	2
	20150114	3230	3230				3230	3230	0	0	0	0.00	2
	20150115	3230	3230				3230	3230	0	0	0	0.00	2
	20150116	3230	3230				3230	3230	0	0	0	0.00	2
	20150119	3230	3230				3230	3230	0	0	0	0.00	2
	20150120	3230	3230				3230	3230	0	0	0	0.00	2
	20150121	3230	3230				3230	3230	0	0	0	0.00	2
	20150122	3230	3230				3230	3230	0	0	0	0.00	2
	20150123	3230	3230				3230	3230	0	0	0	0.00	2
	20150126	3230	3230				3230	3230	0	0	0	0.00	2
	20150127	3230	3230				3230	3230	0	0	0	0.00	2
	20150128	3230	3230				3230	3230	0	0	0	0.00	2
	20150129	3230	3230				3230	3230	0	0	0	0.00	2
	20150130	3230	3230				3230	3230	0	0	0	0.00	2
	20150202	3230	3230				3390	3390	160	160	0	0.00	2
	20150203	3390	3390	3559	3559	3399	3399	3479	9	89	4	69.58	2
	20150204	3399	3479				3415	3415	-64	-64	0	0.00	2
	20150205	3415	3415				3437	3437	22	22	0	0.00	2
	20150206	3437	3437				3423	3423	-14	-14	0	0.00	2
	20150209	3423	3423				3402	3402	-21	-21	0	0.00	2
	20150210	3402	3402				3319	3319	-83	-83	0	0.00	2
	20150211	3319	3319				3389	3389	70	70	0	0.00	2
	20150212	3389	3389				3408	3408	19	19	0	0.00	2
	20150213	3408	3408				3577	3577	169	169	0	0.00	2
	20150216	3577	3577				3596	3596	19	19	0	0.00	2
	20150217	3596	3596				3846	3846	250	250	0	0.00	2
	20150225	3846	3846				3576	3576	-270	-270	0	0.00	2
	20150226	3576	3576	3397	3397	3397	3397	3397	-179	-179	2	33.97	2
	20150227	3397	3397				3363	3363	-34	-34	0	0.00	2
	20150302	3363	3363				3363	3363	0	0	0	0.00	2
	20150303	3363	3363				3363	3363	0	0	0	0.00	2
	20150304	3363	3363				3363	3363	0	0	0	0.00	2
	20150305	3363	3363				3460	3460	97	97	0	0.00	2
	20150306	3460	3460				3325	3325	-135	-135	0	0.00	2
	20150309	3325	3325				3160	3160	-165	-165	0	0.00	2
	20150310	3160	3160				3167	3167	7	7	0	0.00	2
	20150311	3167	3167				3011	3011	-156	-156	0	0.00	2
	20150312	3011	3011				3161	3161	150	150	0	0.00	2
	20150313	3161	3161				3004	3004	-157	-157	0	0.00	2
	20150316	3004	3004				2855	2855	-149	-149	0	0.00	2
	20150317	2855	2855	2855	2855	2855	2855	2855	0	0	2	28.55	0
	20150318	2855	2855				2997	2997	142	142	0	0.00	0
	20150319	2997	2997				2847	2847	-150	-150	0	0.00	0
	20150320	2847	2847				2962	2962	115	115	0	0.00	0
	20150323	2962	2962				3110	3110	148	148	0	0.00	0
	20150324	3110	3110				2979	2979	-131	-131	0	0.00	0
	20150325	2979	2979				3127	3127	148	148	0	0.00	0
	20150326	3127	3127				3218	3218	91	91	0	0.00	0
	20150327	3218	3218				3060	3060	-158	-158	0	0.00	0
	20150330	3060	3060				3207	3207	147	147	0	0.00	0
	20150331	3207	3207				3144	3144	-63	-63	0	0.00	0
	20150401	3144	3144	2986	2986	2986	2986	2986	-158	-158	2	29.86	2
	20150402	2986	2986				3135	3135	149	149	0	0.00	2
	20150403	3135	3135				3291	3291	156	156	0	0.00	2
	20150407	3291	3291	3455	3455	3445	3445	3450	154	159	4	69.00	2
	20150408	3445	3450				3277	3277	-173	-173	0	0.00	2
	20150409	3277	3277	3284	3284	3284	3284	3284	7	7	2	32.84	0
	20150410	3284	3284				3284	3284	0	0	0	0.00	0
	20150413	3284	3284				3284	3284	0	0	0	0.00	0
	20150414	3284	3284				3284	3284	0	0	0	0.00	0
	20150415	3284	3284				3284	3284	0	0	0	0.00	0
	20150416	3284	3284				3284	3284	0	0	0	0.00	0
	20150417	3284	3284				3284	3284	0	0	0	0.00	0
	20150420	3284	3284				3284	3284	0	0	0	0.00	0
	20150421	3284	3284				3284	3284	0	0	0	0.00	0
	20150422	3284	3284				3284	3284	0	0	0	0.00	0
	20150423	3284	3284				3284	3284	0	0	0	0.00	0
	20150424	3284	3284				3284	3284	0	0	0	0.00	0
	20150427	3284	3284				3284	3284	0	0	0	0.00	0
	20150428	3284	3284				3291	3291	7	7	0	0.00	0
	20150429	3291	3291				3260	3260	-31	-31	0	0.00	0
	20150430	3260	3260				3330	3330	70	70	0	0.00	0
fu1512	20150105	3177	3177				3177	3177	0	0	0	0.00	0
	20150106	3177	3177				3177	3177	0	0	0	0.00	0
	20150107	3177	3177				3177	3177	0	0	0	0.00	0
	20150108	3177	3177				3177	3177	0	0	0	0.00	0
	20150109	3177	3177				3177	3177	0	0	0	0.00	0
	20150112	3177	3177				3177	3177	0	0	0	0.00	0
	20150113	3177	3177				3177	3177	0	0	0	0.00	0
	20150114	3177	3177				3177	3177	0	0	0	0.00	0
	20150115	3177	3177				3177	3177	0	0	0	0.00	0
	20150116	3177	3177				3177	3177	0	0	0	0.00	0
	20150119	3177	3177				3177	3177	0	0	0	0.00	0
	20150120	3177	3177				3177	3177	0	0	0	0.00	0
	20150121	3177	3177				3177	3177	0	0	0	0.00	0
	20150122	3177	3177				3177	3177	0	0	0	0.00	0
	20150123	3177	3177				3177	3177	0	0	0	0.00	0
	20150126	3177	3177				3177	3177	0	0	0	0.00	0
	20150127	3177	3177				3177	3177	0	0	0	0.00	0
	20150128	3177	3177				3177	3177	0	0	0	0.00	0
	20150129	3177	3177				3177	3177	0	0	0	0.00	0
	20150130	3177	3177				3177	3177	0	0	0	0.00	0
	20150202	3177	3177				3177	3177	0	0	0	0.00	0
	20150203	3177	3177				3177	3177	0	0	0	0.00	0
	20150204	3177	3177				3177	3177	0	0	0	0.00	0
	20150205	3177	3177				3177	3177	0	0	0	0.00	0
	20150206	3177	3177				3177	3177	0	0	0	0.00	0
	20150209	3177	3177				3177	3177	0	0	0	0.00	0
	20150210	3177	3177				3177	3177	0	0	0	0.00	0
	20150211	3177	3177				3177	3177	0	0	0	0.00	0
	20150212	3177	3177				3177	3177	0	0	0	0.00	0
	20150213	3177	3177				3177	3177	0	0	0	0.00	0
	20150216	3177	3177	3335	3335	3335	3335	3335	158	158	4	66.70	4
	20150217	3335	3335				3335	3335	0	0	0	0.00	4
	20150225	3335	3335				3101	3101	-234	-234	0	0.00	4
	20150226	3101	3101				2945	2945	-156	-156	0	0.00	4
	20150227	2945	2945				3092	3092	147	147	0	0.00	4
	20150302	3092	3092				3246	3246	154	154	0	0.00	4
	20150303	3246	3246				3335	3335	89	89	0	0.00	4
	20150304	3335	3335	3501	3501	3501	3501	3501	166	166	2	35.01	6
	20150305	3501	3501				3501	3501	0	0	0	0.00	6
	20150306	3501	3501				3365	3365	-136	-136	0	0.00	6
	20150309	3365	3365				3198	3198	-167	-167	0	0.00	6
	20150310	3198	3198				3205	3205	7	7	0	0.00	6
	20150311	3205	3205				3047	3047	-158	-158	0	0.00	6
	20150312	3047	3047	3047	3047	3047	3047	3047	0	0	2	30.47	4
	20150313	3047	3047				3199	3199	152	152	0	0.00	4
	20150316	3199	3199	3041	3041	3041	3041	3041	-158	-158	2	30.41	4
	20150317	3041	3041				3041	3041	0	0	0	0.00	4
	20150318	3041	3041				3044	3044	3	3	0	0.00	4
	20150319	3044	3044				2892	2892	-152	-152	0	0.00	4
	20150320	2892	2892				3036	3036	144	144	0	0.00	4
	20150323	3036	3036				3187	3187	151	151	0	0.00	4
	20150324	3187	3187				3052	3052	-135	-135	0	0.00	4
	20150325	3052	3052				3204	3204	152	152	0	0.00	4
	20150326	3204	3204	3364	3364	3067	3113	3181	-91	-23	6	95.44	6
	20150327	3113	3181				3025	3025	-156	-156	0	0.00	6
	20150330	3025	3025				3176	3176	151	151	0	0.00	6
	20150331	3176	3176				3334	3334	158	158	0	0.00	6
	20150401	3334	3334				3167	3167	-167	-167	0	0.00	6
	20150402	3167	3167				3325	3325	158	158	0	0.00	6
	20150403	3325	3325				3325	3325	0	0	0	0.00	6
	20150407	3325	3325				3325	3325	0	0	0	0.00	6
	20150408	3325	3325				3158	3158	-167	-167	0	0.00	6
	20150409	3158	3158				3315	3315	157	157	0	0.00	6
	20150410	3315	3315				3315	3315	0	0	0	0.00	6
	20150413	3315	3315				3269	3269	-46	-46	0	0.00	6
	20150414	3269	3269				3107	3107	-162	-162	0	0.00	6
	20150415	3107	3107				3262	3262	155	155	0	0.00	6
	20150416	3262	3262				3297	3297	35	35	0	0.00	6
	20150417	3297	3297				3312	3312	15	15	0	0.00	6
	20150420	3312	3312				3312	3312	0	0	0	0.00	6
	20150421	3312	3312				3312	3312	0	0	0	0.00	6
	20150422	3312	3312				3312	3312	0	0	0	0.00	6
	20150423	3312	3312				3312	3312	0	0	0	0.00	6
	20150424	3312	3312				3320	3320	8	8	0	0.00	6
	20150427	3320	3320	3486	3486	3323	3323	3404	3	84	4	68.09	6
	20150428	3323	3404				3404	3404	0	0	0	0.00	6
	20150429	3404	3404	3233	3233	3233	3233	3233	-171	-171	2	32.33	6
	20150430	3233	3233				3394	3394	161	161	0	0.00	6
fu1601	20150105	3177	3177				3177	3177	0	0	0	0.00	0
	20150106	3177	3177				3177	3177	0	0	0	0.00	0
	20150107	3177	3177				3177	3177	0	0	0	0.00	0
	20150108	3177	3177	3494	3494	2957	2957	3225	-220	48	12	193.53	0
	20150109	2957	3225				3225	3225	0	0	0	0.00	0
	20150112	3225	3225				3225	3225	0	0	0	0.00	0
	20150113	3225	3225				3225	3225	0	0	0	0.00	0
	20150114	3225	3225				3225	3225	0	0	0	0.00	0
	20150115	3225	3225				3225	3225	0	0	0	0.00	0
	20150116	3225	3225				3225	3225	0	0	0	0.00	0
	20150119	3225	3225				3225	3225	0	0	0	0.00	0
	20150120	3225	3225				3225	3225	0	0	0	0.00	0
	20150121	3225	3225				3225	3225	0	0	0	0.00	0
	20150122	3225	3225				3225	3225	0	0	0	0.00	0
	20150123	3225	3225				3225	3225	0	0	0	0.00	0
	20150126	3225	3225				3225	3225	0	0	0	0.00	0
	20150127	3225	3225				3225	3225	0	0	0	0.00	0
	20150128	3225	3225				3225	3225	0	0	0	0.00	0
	20150129	3225	3225				3225	3225	0	0	0	0.00	0
	20150130	3225	3225	3063	3291	3063	3291	3177	66	-48	4	63.54	2
	20150202	3291	3177				3177	3177	0	0	0	0.00	2
	20150203	3177	3177	3018	3325	3018	3325	3171	148	-6	4	63.43	4
	20150204	3325	3171	3177	3177	3177	3177	3177	6	6	4	63.54	0
	20150205	3177	3177				3177	3177	0	0	0	0.00	0
	20150206	3177	3177				3177	3177	0	0	0	0.00	0
	20150209	3177	3177				3177	3177	0	0	0	0.00	0
	20150210	3177	3177				3177	3177	0	0	0	0.00	0
	20150211	3177	3177				3177	3177	0	0	0	0.00	0
	20150212	3177	3177				3177	3177	0	0	0	0.00	0
	20150213	3177	3177				3177	3177	0	0	0	0.00	0
	20150216	3177	3177				3177	3177	0	0	0	0.00	0
	20150217	3177	3177				3398	3398	221	221	0	0.00	0
	20150225	3398	3398	3599	3599	3161	3350	3374	-48	-24	10	168.70	0
	20150226	3350	3374				3205	3205	-169	-169	0	0.00	0
	20150227	3205	3205				3173	3173	-32	-32	0	0.00	0
	20150302	3173	3173				3250	3250	77	77	0	0.00	0
	20150303	3250	3250				3339	3339	89	89	0	0.00	0
	20150304	3339	3339				3339	3339	0	0	0	0.00	0
	20150305	3339	3339				3435	3435	96	96	0	0.00	0
	20150306	3435	3435				3301	3301	-134	-134	0	0.00	0
	20150309	3301	3301				3137	3137	-164	-164	0	0.00	0
	20150310	3137	3137				3144	3144	7	7	0	0.00	0
	20150311	3144	3144				2989	2989	-155	-155	0	0.00	0
	20150312	2989	2989				2989	2989	0	0	0	0.00	0
	20150313	2989	2989				2841	2841	-148	-148	0	0.00	0
	20150316	2841	2841				2700	2700	-141	-141	0	0.00	0
	20150317	2700	2700				2700	2700	0	0	0	0.00	0
	20150318	2700	2700				2835	2835	135	135	0	0.00	0
	20150319	2835	2835				2693	2693	-142	-142	0	0.00	0
	20150320	2693	2693				2801	2801	108	108	0	0.00	0
	20150323	2801	2801				2808	2808	7	7	0	0.00	0
	20150324	2808	2808	2948	2948	2948	2948	2948	140	140	2	29.48	2
	20150325	2948	2948				2879	2879	-69	-69	0	0.00	2
	20150326	2879	2879				3022	3022	143	143	0	0.00	2
	20150327	3022	3022				3173	3173	151	151	0	0.00	2
	20150330	3173	3173	3331	3331	3331	3331	3331	158	158	2	33.31	0
	20150331	3331	3331				3331	3331	0	0	0	0.00	0
	20150401	3331	3331				3331	3331	0	0	0	0.00	0
	20150402	3331	3331				3331	3331	0	0	0	0.00	0
	20150403	3331	3331				3331	3331	0	0	0	0.00	0
	20150407	3331	3331				3331	3331	0	0	0	0.00	0
	20150408	3331	3331				3164	3164	-167	-167	0	0.00	0
	20150409	3164	3164				3170	3170	6	6	0	0.00	0
	20150410	3170	3170				3327	3327	157	157	0	0.00	0
	20150413	3327	3327				3327	3327	0	0	0	0.00	0
	20150414	3327	3327				3327	3327	0	0	0	0.00	0
	20150415	3327	3327				3327	3327	0	0	0	0.00	0
	20150416	3327	3327				3327	3327	0	0	0	0.00	0
	20150417	3327	3327				3327	3327	0	0	0	0.00	0
	20150420	3327	3327				3327	3327	0	0	0	0.00	0
	20150421	3327	3327				3327	3327	0	0	0	0.00	0
	20150422	3327	3327				3327	3327	0	0	0	0.00	0
	20150423	3327	3327				3327	3327	0	0	0	0.00	0
	20150424	3327	3327				3327	3327	0	0	0	0.00	0
	20150427	3327	3327				3327	3327	0	0	0	0.00	0
	20150428	3327	3327				3327	3327	0	0	0	0.00	0
	20150429	3327	3327				3327	3327	0	0	0	0.00	0
	20150430	3327	3327				3399	3399	72	72	0	0.00	0
fu1603	20150302	3173	3173				3250	3250	77	77	0	0.00	0
	20150303	3250	3250				3339	3339	89	89	0	0.00	0
	20150304	3339	3339				3339	3339	0	0	0	0.00	0
	20150305	3339	3339	3672	3672	3672	3672	3672	333	333	2	36.72	2
	20150306	3672	3672				3529	3529	-143	-143	0	0.00	2
	20150309	3529	3529				3354	3354	-175	-175	0	0.00	2
	20150310	3354	3354				3361	3361	7	7	0	0.00	2
	20150311	3361	3361				3195	3195	-166	-166	0	0.00	2
	20150312	3195	3195				3195	3195	0	0	0	0.00	2
	20150313	3195	3195				3037	3037	-158	-158	0	0.00	2
	20150316	3037	3037	2885	2902	2885	2902	2893	-135	-144	4	57.87	0
	20150317	2902	2893				2893	2893	0	0	0	0.00	0
	20150318	2893	2893				3037	3037	144	144	0	0.00	0
	20150319	3037	3037				2885	2885	-152	-152	0	0.00	0
	20150320	2885	2885				3001	3001	116	116	0	0.00	0
	20150323	3001	3001				3151	3151	150	150	0	0.00	0
	20150324	3151	3151				3308	3308	157	157	0	0.00	0
	20150325	3308	3308				3230	3230	-78	-78	0	0.00	0
	20150326	3230	3230				3207	3207	-23	-23	0	0.00	0
	20150327	3207	3207				3050	3050	-157	-157	0	0.00	0
	20150330	3050	3050				3201	3201	151	151	0	0.00	0
	20150331	3201	3201				3139	3139	-62	-62	0	0.00	0
	20150401	3139	3139				2982	2982	-157	-157	0	0.00	0
	20150402	2982	2982				3131	3131	149	149	0	0.00	0
	20150403	3131	3131				3082	3082	-49	-49	0	0.00	0
	20150407	3082	3082				3236	3236	154	154	0	0.00	0
	20150408	3236	3236				3074	3074	-162	-162	0	0.00	0
	20150409	3074	3074				3227	3227	153	153	0	0.00	0
	20150410	3227	3227				3387	3387	160	160	0	0.00	0
	20150413	3387	3387				3341	3341	-46	-46	0	0.00	0
	20150414	3341	3341				3341	3341	0	0	0	0.00	0
	20150415	3341	3341				3336	3336	-5	-5	0	0.00	0
	20150416	3336	3336				3336	3336	0	0	0	0.00	0
	20150417	3336	3336				3336	3336	0	0	0	0.00	0
	20150420	3336	3336				3336	3336	0	0	0	0.00	0
	20150421	3336	3336				3202	3202	-134	-134	0	0.00	0
	20150422	3202	3202				3063	3063	-139	-139	0	0.00	0
	20150423	3063	3063				3216	3216	153	153	0	0.00	0
	20150424	3216	3216				3216	3216	0	0	0	0.00	0
	20150427	3216	3216				3297	3297	81	81	0	0.00	0
	20150428	3297	3297				3304	3304	7	7	0	0.00	0
	20150429	3304	3304				3138	3138	-166	-166	0	0.00	0
	20150430	3138	3138				3294	3294	156	156	0	0.00	0
fu1604	20150401	3139	3139				3139	3139	0	0	0	0.00	0
	20150402	3139	3139				3139	3139	0	0	0	0.00	0
	20150403	3139	3139				3139	3139	0	0	0	0.00	0
	20150407	3139	3139	3452	3452	3452	3452	3452	313	313	2	34.52	2
	20150408	3452	3452				3279	3279	-173	-173	0	0.00	2
	20150409	3279	3279				3286	3286	7	7	0	0.00	2
	20150410	3286	3286				3286	3286	0	0	0	0.00	2
	20150413	3286	3286				3241	3241	-45	-45	0	0.00	2
	20150414	3241	3241				3080	3080	-161	-161	0	0.00	2
	20150415	3080	3080				3234	3234	154	154	0	0.00	2
	20150416	3234	3234				3269	3269	35	35	0	0.00	2
	20150417	3269	3269				3247	3247	-22	-22	0	0.00	2
	20150420	3247	3247				3235	3235	-12	-12	0	0.00	2
	20150421	3235	3235				3105	3105	-130	-130	0	0.00	2
	20150422	3105	3105				2970	2970	-135	-135	0	0.00	2
	20150423	2970	2970				3118	3118	148	148	0	0.00	2
	20150424	3118	3118				3118	3118	0	0	0	0.00	2
	20150427	3118	3118				3197	3197	79	79	0	0.00	2
	20150428	3197	3197				3203	3203	6	6	0	0.00	2
	20150429	3203	3203				3042	3042	-161	-161	0	0.00	2
	20150430	3042	3042				3194	3194	152	152	0	0.00	2
hc1501	20150105	2970	2992	2950	2980	2950	2980	2966	-12	-26	594	1,762.92	9900
	20150106	2980	2966	2970	2972	2970	2972	2970	6	4	300	891.36	9780
	20150107	2972	2970	3000	3000	2980	3000	2990	30	20	540	1,614.60	9240
	20150108	3000	2990				2990	2990	0	0	0	0.00	9240
	20150109	2990	2990	2962	2980	2960	2980	2968	-10	-22	300	890.64	9120
	20150112	2980	2968	2972	2972	2950	2950	2960	-18	-8	120	355.32	9000
	20150113	2950	2960	2866	2866	2866	2866	2866	-94	-94	60	171.96	8940
	20150114	2866	2866	2760	2760	2760	2760	2760	-106	-106	60	165.60	9000
	20150115	2760	2760	2662	2850	2648	2850	2760	90	0	480	1,325.40	9120
hc1502	20150105	2976	2976				2952	2952	-24	-24	0	0.00	0
	20150106	2952	2952				2956	2956	4	4	0	0.00	0
	20150107	2956	2956				2974	2974	18	18	0	0.00	0
	20150108	2974	2974				2974	2974	0	0	0	0.00	0
	20150109	2974	2974				2952	2952	-22	-22	0	0.00	0
	20150112	2952	2952				2944	2944	-8	-8	0	0.00	0
	20150113	2944	2944				2850	2850	-94	-94	0	0.00	0
	20150114	2850	2850				2744	2744	-106	-106	0	0.00	0
	20150115	2744	2744				2744	2744	0	0	0	0.00	0
	20150116	2744	2744				2744	2744	0	0	0	0.00	0
	20150119	2744	2744				2744	2744	0	0	0	0.00	0
	20150120	2744	2744				2744	2744	0	0	0	0.00	0
	20150121	2744	2744				2744	2744	0	0	0	0.00	0
	20150122	2744	2744				2744	2744	0	0	0	0.00	0
	20150123	2744	2744				2744	2744	0	0	0	0.00	0
	20150126	2744	2744				2744	2744	0	0	0	0.00	0
	20150127	2744	2744				2744	2744	0	0	0	0.00	0
	20150128	2744	2744				2744	2744	0	0	0	0.00	0
	20150129	2744	2744				2744	2744	0	0	0	0.00	0
	20150130	2744	2744				2744	2744	0	0	0	0.00	0
	20150202	2744	2744				2744	2744	0	0	0	0.00	0
	20150203	2744	2744				2744	2744	0	0	0	0.00	0
	20150204	2744	2744				2744	2744	0	0	0	0.00	0
	20150205	2744	2744				2744	2744	0	0	0	0.00	0
	20150206	2744	2744				2744	2744	0	0	0	0.00	0
	20150209	2744	2744				2744	2744	0	0	0	0.00	0
	20150210	2744	2744				2744	2744	0	0	0	0.00	0
hc1503	20150105	2830	2830				2806	2806	-24	-24	0	0.00	312
	20150106	2806	2806				2810	2810	4	4	0	0.00	312
	20150107	2810	2810	2922	2922	2806	2806	2864	-4	54	4	11.46	312
	20150108	2806	2864				2864	2864	0	0	0	0.00	312
	20150109	2864	2864				2842	2842	-22	-22	0	0.00	312
	20150112	2842	2842				2834	2834	-8	-8	0	0.00	312
	20150113	2834	2834				2744	2744	-90	-90	0	0.00	312
	20150114	2744	2744				2642	2642	-102	-102	0	0.00	312
	20150115	2642	2642				2642	2642	0	0	0	0.00	312
	20150116	2642	2642				2642	2642	0	0	0	0.00	312
	20150119	2642	2642				2642	2642	0	0	0	0.00	312
	20150120	2642	2642	2564	2638	2536	2596	2586	-46	-56	10	25.87	308
	20150121	2596	2586				2586	2586	0	0	0	0.00	308
	20150122	2586	2586				2586	2586	0	0	0	0.00	308
	20150123	2586	2586				2586	2586	0	0	0	0.00	308
	20150126	2586	2586				2586	2586	0	0	0	0.00	308
	20150127	2586	2586				2586	2586	0	0	0	0.00	308
	20150128	2586	2586				2586	2586	0	0	0	0.00	308
	20150129	2586	2586				2586	2586	0	0	0	0.00	308
	20150130	2586	2586				2586	2586	0	0	0	0.00	308
	20150202	2586	2586				2586	2586	0	0	0	0.00	308
	20150203	2586	2586				2586	2586	0	0	0	0.00	308
	20150204	2586	2586				2586	2586	0	0	0	0.00	308
	20150205	2586	2586				2586	2586	0	0	0	0.00	308
	20150206	2586	2586				2586	2586	0	0	0	0.00	308
	20150209	2586	2586				2586	2586	0	0	0	0.00	308
	20150210	2586	2586				2586	2586	0	0	0	0.00	308
	20150211	2586	2586				2586	2586	0	0	0	0.00	308
	20150212	2586	2586				2500	2500	-86	-86	0	0.00	308
	20150213	2500	2500	2450	2600	2418	2420	2456	-80	-44	18	44.21	308
	20150216	2420	2456	2554	2554	2554	2554	2554	98	98	8	20.43	300
	20150217	2554	2554	2500	2500	2400	2400	2482	-154	-72	12	29.80	302
	20150225	2400	2482				2482	2482	0	0	0	0.00	302
	20150226	2482	2482				2482	2482	0	0	0	0.00	302
	20150227	2482	2482	2400	2400	2400	2400	2400	-82	-82	2	4.80	300
	20150302	2400	2400				2400	2400	0	0	0	0.00	300
	20150303	2400	2400				2400	2400	0	0	0	0.00	300
	20150304	2400	2400				2400	2400	0	0	0	0.00	300
	20150305	2400	2400	2380	2420	2380	2420	2404	20	4	300	721.20	300
	20150306	2420	2404				2404	2404	0	0	0	0.00	300
	20150309	2404	2404				2404	2404	0	0	0	0.00	300
	20150310	2404	2404				2404	2404	0	0	0	0.00	300
	20150311	2404	2404	2400	2400	2400	2400	2400	-4	-4	300	720.00	300
	20150312	2400	2400				2400	2400	0	0	0	0.00	300
	20150313	2400	2400	2470	2470	2470	2470	2470	70	70	60	148.20	300
	20150316	2470	2470				2470	2470	0	0	0	0.00	300
hc1504	20150105	2778	2778				2754	2754	-24	-24	0	0.00	2
	20150106	2754	2754				2758	2758	4	4	0	0.00	2
	20150107	2758	2758				2810	2810	52	52	0	0.00	2
	20150108	2810	2810				2810	2810	0	0	0	0.00	2
	20150109	2810	2810				2790	2790	-20	-20	0	0.00	2
	20150112	2790	2790				2782	2782	-8	-8	0	0.00	2
	20150113	2782	2782	2890	2890	2680	2680	2784	-102	2	8	22.28	2
	20150114	2680	2784				2680	2680	-104	-104	0	0.00	2
	20150115	2680	2680				2680	2680	0	0	0	0.00	2
	20150116	2680	2680				2680	2680	0	0	0	0.00	2
	20150119	2680	2680				2680	2680	0	0	0	0.00	2
	20150120	2680	2680				2624	2624	-56	-56	0	0.00	2
	20150121	2624	2624				2624	2624	0	0	0	0.00	2
	20150122	2624	2624				2624	2624	0	0	0	0.00	2
	20150123	2624	2624				2624	2624	0	0	0	0.00	2
	20150126	2624	2624				2624	2624	0	0	0	0.00	2
	20150127	2624	2624				2624	2624	0	0	0	0.00	2
	20150128	2624	2624				2624	2624	0	0	0	0.00	2
	20150129	2624	2624				2624	2624	0	0	0	0.00	2
	20150130	2624	2624				2624	2624	0	0	0	0.00	2
	20150202	2624	2624				2624	2624	0	0	0	0.00	2
	20150203	2624	2624				2624	2624	0	0	0	0.00	2
	20150204	2624	2624				2624	2624	0	0	0	0.00	2
	20150205	2624	2624				2624	2624	0	0	0	0.00	2
	20150206	2624	2624				2624	2624	0	0	0	0.00	2
	20150209	2624	2624	2726	2726	2714	2714	2720	90	96	4	10.88	2
	20150210	2714	2720				2720	2720	0	0	0	0.00	2
	20150211	2720	2720				2720	2720	0	0	0	0.00	2
	20150212	2720	2720				2720	2720	0	0	0	0.00	2
	20150213	2720	2720	2828	2828	2828	2828	2828	108	108	2	5.66	4
	20150216	2828	2828				2714	2714	-114	-114	0	0.00	4
	20150217	2714	2714				2714	2714	0	0	0	0.00	4
	20150225	2714	2714				2714	2714	0	0	0	0.00	4
	20150226	2714	2714				2714	2714	0	0	0	0.00	4
	20150227	2714	2714	2584	2584	2584	2584	2584	-130	-130	2	5.17	4
	20150302	2584	2584	2600	2600	2600	2600	2600	16	16	2	5.20	2
	20150303	2600	2600	2470	2720	2470	2720	2594	120	-6	16	41.52	2
	20150304	2720	2594	2722	2722	2504	2598	2662	4	68	16	42.61	2
	20150305	2598	2662	2528	2528	2528	2528	2528	-134	-134	2	5.06	2
	20150306	2528	2528	2402	2402	2402	2402	2402	-126	-126	2	4.80	2
	20150309	2402	2402				2402	2402	0	0	0	0.00	2
	20150310	2402	2402				2402	2402	0	0	0	0.00	2
	20150311	2402	2402				2398	2398	-4	-4	0	0.00	2
	20150312	2398	2398	2308	2308	2308	2308	2308	-90	-90	2	4.62	2
	20150313	2308	2308				2374	2374	66	66	0	0.00	2
	20150316	2374	2374				2374	2374	0	0	0	0.00	2
	20150317	2374	2374	2328	2328	2328	2328	2328	-46	-46	2	4.66	2
	20150318	2328	2328				2328	2328	0	0	0	0.00	2
	20150319	2328	2328	2314	2314	2314	2314	2314	-14	-14	2	4.63	2
	20150320	2314	2314				2396	2396	82	82	0	0.00	2
	20150323	2396	2396	2276	2378	2276	2378	2326	-18	-70	4	9.31	0
	20150324	2378	2326				2326	2326	0	0	0	0.00	0
	20150325	2326	2326				2326	2326	0	0	0	0.00	0
	20150326	2326	2326				2326	2326	0	0	0	0.00	0
	20150327	2326	2326				2326	2326	0	0	0	0.00	0
	20150330	2326	2326				2326	2326	0	0	0	0.00	0
	20150331	2326	2326				2326	2326	0	0	0	0.00	0
	20150401	2326	2326				2326	2326	0	0	0	0.00	0
	20150402	2326	2326				2326	2326	0	0	0	0.00	0
	20150403	2326	2326				2326	2326	0	0	0	0.00	0
	20150407	2326	2326				2326	2326	0	0	0	0.00	0
	20150408	2326	2326				2326	2326	0	0	0	0.00	0
	20150409	2326	2326				2326	2326	0	0	0	0.00	0
	20150410	2326	2326				2326	2326	0	0	0	0.00	0
	20150413	2326	2326				2326	2326	0	0	0	0.00	0
	20150414	2326	2326				2326	2326	0	0	0	0.00	0
	20150415	2326	2326				2326	2326	0	0	0	0.00	0
hc1505	20150105	2928	2924	2928	2928	2886	2902	2900	-22	-24	3480	10,094.02	14328
	20150106	2902	2900	2882	2992	2882	2936	2936	36	36	7502	22,035.92	14760
	20150107	2936	2936	2930	2932	2894	2902	2904	-34	-32	4930	14,319.09	14582
	20150108	2902	2904	2902	2912	2874	2878	2888	-26	-16	3476	10,041.56	14606
	20150109	2878	2888	2882	2882	2832	2834	2854	-54	-34	4748	13,552.23	15336
	20150112	2834	2854	2836	2842	2750	2752	2792	-102	-62	10700	29,874.70	15696
	20150113	2752	2792	2750	2764	2724	2736	2738	-56	-54	7650	20,956.50	17142
	20150114	2736	2738	2732	2742	2628	2670	2682	-68	-56	20266	54,392.21	20594
	20150115	2670	2682	2670	2696	2658	2692	2674	10	-8	11844	31,679.77	21966
	20150116	2692	2674	2698	2708	2650	2682	2676	8	2	11764	31,496.27	22776
	20150119	2682	2676	2676	2684	2650	2666	2664	-10	-12	10318	27,504.80	23730
	20150120	2666	2664	2656	2674	2638	2644	2650	-20	-14	10034	26,600.42	22320
	20150121	2644	2650	2650	2662	2632	2640	2646	-10	-4	9092	24,064.65	21312
	20150122	2640	2646	2628	2656	2612	2632	2638	-14	-8	8936	23,586.64	21898
	20150123	2632	2638	2632	2640	2606	2610	2620	-28	-18	9434	24,724.59	24036
	20150126	2610	2620	2604	2612	2544	2560	2576	-60	-44	18546	47,802.99	25014
	20150127	2560	2576	2560	2576	2546	2550	2558	-26	-18	20578	52,638.96	32330
	20150128	2550	2558	2550	2620	2546	2594	2592	36	34	38828	100,662.07	33702
	20150129	2594	2592	2602	2626	2586	2622	2608	30	16	23438	61,171.27	37972
	20150130	2622	2608	2620	2624	2596	2600	2612	-8	4	11080	28,951.96	37316
	20150202	2600	2612	2602	2716	2578	2592	2606	-20	-6	22808	59,462.59	40268
	20150203	2592	2606	2598	2602	2582	2586	2592	-20	-14	13414	34,769.42	43610
	20150204	2586	2592	2590	2606	2572	2574	2586	-18	-6	21074	54,521.47	49806
	20150205	2574	2586	2586	2588	2564	2578	2576	-8	-10	18368	47,346.13	55352
	20150206	2578	2576	2578	2594	2574	2584	2580	8	4	13122	33,880.20	59312
	20150209	2584	2580	2588	2588	2566	2574	2574	-6	-6	10306	26,535.93	60020
	20150210	2574	2574	2570	2586	2570	2582	2578	8	4	5198	13,408.48	59506
	20150211	2582	2578	2582	2606	2578	2602	2588	24	10	7740	20,033.80	58380
	20150212	2602	2588	2606	2610	2580	2596	2588	8	0	5844	15,129.94	58176
	20150213	2596	2588	2598	2622	2586	2610	2606	22	18	11490	29,953.88	58164
	20150216	2610	2606	2608	2646	2608	2624	2628	18	22	14306	37,619.38	58304
	20150217	2624	2628	2628	2628	2602	2612	2612	-16	-16	6546	17,101.50	58520
	20150225	2612	2612	2614	2614	2572	2594	2588	-18	-24	6510	16,853.98	57920
	20150226	2594	2588	2594	2614	2588	2610	2600	22	12	10500	27,320.10	59772
	20150227	2610	2600	2614	2620	2582	2584	2598	-16	-2	11906	30,938.05	60794
	20150302	2584	2598	2584	2606	2570	2594	2584	-4	-14	16776	43,359.62	60410
	20150303	2594	2584	2592	2602	2578	2584	2588	0	4	12670	32,801.11	61224
	20150304	2584	2588	2582	2594	2578	2590	2586	2	-2	7622	19,711.69	61116
	20150305	2590	2586	2590	2590	2554	2562	2568	-24	-18	26012	66,799.98	59512
	20150306	2562	2568	2562	2572	2544	2548	2556	-20	-12	17016	43,522.58	57808
	20150309	2548	2556	2548	2562	2516	2526	2534	-30	-22	30006	76,073.33	54124
	20150310	2526	2534	2524	2532	2494	2498	2514	-36	-20	16732	42,065.82	49812
	20150311	2498	2514	2482	2508	2482	2494	2494	-20	-20	14032	35,006.90	47990
	20150312	2494	2494	2488	2560	2484	2510	2506	16	12	15190	38,089.36	46778
	20150313	2510	2506	2512	2526	2498	2502	2512	-4	6	9272	23,292.39	45808
	20150316	2502	2512	2502	2530	2496	2528	2512	16	0	7804	19,611.22	45022
	20150317	2528	2512	2518	2536	2516	2534	2526	22	14	6372	16,107.62	44096
	20150318	2534	2526	2532	2538	2498	2504	2514	-22	-12	14544	36,591.85	39188
	20150319	2504	2514	2502	2524	2498	2510	2510	-4	-4	6528	16,385.66	39008
	20150320	2510	2510	2506	2524	2506	2510	2514	0	4	6560	16,496.02	38942
	20150323	2510	2514	2510	2568	2502	2558	2538	44	24	15814	40,152.63	35758
	20150324	2558	2538	2576	2580	2546	2554	2560	16	22	10188	26,093.10	33026
	20150325	2554	2560	2552	2566	2532	2536	2546	-24	-14	7886	20,089.08	29524
	20150326	2536	2546	2540	2546	2514	2518	2528	-28	-18	10798	27,299.88	25476
	20150327	2518	2528	2512	2520	2458	2508	2490	-20	-38	10010	24,943.99	23798
	20150330	2508	2490	2508	2520	2474	2488	2494	-2	4	6086	15,182.10	23340
	20150331	2488	2494	2490	2506	2476	2478	2484	-16	-10	5566	13,836.43	23460
	20150401	2478	2484	2480	2502	2448	2452	2466	-32	-18	8982	22,160.49	21024
	20150402	2452	2466	2452	2460	2410	2410	2426	-56	-40	10034	24,355.49	18756
	20150403	2410	2426	2412	2430	2392	2398	2410	-28	-16	6570	15,834.36	16678
	20150407	2398	2410	2394	2410	2342	2342	2378	-68	-32	6728	16,007.34	14100
	20150408	2342	2378	2348	2380	2314	2350	2340	-28	-38	5854	13,706.79	12730
	20150409	2350	2340	2354	2354	2318	2326	2328	-14	-12	1886	4,392.73	12316
	20150410	2326	2328	2320	2324	2282	2310	2310	-18	-18	2634	6,086.58	12192
	20150413	2310	2310	2302	2362	2302	2362	2334	52	24	2480	5,790.47	11610
	20150414	2362	2334	2366	2370	2330	2358	2352	24	18	1146	2,696.33	11462
	20150415	2358	2352	2356	2362	2316	2318	2346	-34	-6	1506	3,533.22	10834
	20150416	2318	2346	2318	2358	2318	2346	2338	0	-8	1198	2,802.52	10898
	20150417	2346	2338	2352	2364	2328	2348	2342	10	4	516	1,208.94	10736
	20150420	2348	2342	2330	2348	2322	2322	2330	-20	-12	1850	4,311.95	10398
	20150421	2322	2330	2312	2330	2304	2330	2314	0	-16	2280	5,279.20	9710
	20150422	2330	2314	2320	2386	2316	2366	2332	52	18	2406	5,613.65	9152
	20150423	2366	2332	2374	2374	2348	2364	2360	32	28	662	1,562.88	8992
	20150424	2364	2360	2374	2412	2358	2412	2390	52	30	2448	5,853.49	8088
	20150427	2412	2390	2408	2440	2372	2428	2414	38	24	1674	4,043.90	7764
	20150428	2428	2414	2438	2446	2429	2430	2437	16	23	982	2,394.00	7504
	20150429	2430	2437	2412	2444	2366	2390	2418	-47	-19	570	1,378.42	7088
	20150430	2390	2418	2373	2420	2361	2401	2378	-17	-40	3296	7,840.44	6842
hc1506	20150105	2976	2976				2976	2976	0	0	0	0.00	2
	20150106	2976	2976				2976	2976	0	0	0	0.00	2
	20150107	2976	2976				2944	2944	-32	-32	0	0.00	2
	20150108	2944	2944				2928	2928	-16	-16	0	0.00	2
	20150109	2928	2928	2810	2956	2810	2956	2882	28	-46	4	11.53	2
	20150112	2956	2882				2818	2818	-64	-64	0	0.00	2
	20150113	2818	2818				2764	2764	-54	-54	0	0.00	2
	20150114	2764	2764				2708	2708	-56	-56	0	0.00	2
	20150115	2708	2708				2700	2700	-8	-8	0	0.00	2
	20150116	2700	2700				2702	2702	2	2	0	0.00	2
	20150119	2702	2702				2690	2690	-12	-12	0	0.00	2
	20150120	2690	2690				2676	2676	-14	-14	0	0.00	2
	20150121	2676	2676				2672	2672	-4	-4	0	0.00	2
	20150122	2672	2672				2664	2664	-8	-8	0	0.00	2
	20150123	2664	2664				2646	2646	-18	-18	0	0.00	2
	20150126	2646	2646				2602	2602	-44	-44	0	0.00	2
	20150127	2602	2602				2582	2582	-20	-20	0	0.00	2
	20150128	2582	2582	2610	2610	2610	2610	2610	28	28	2	5.22	2
	20150129	2610	2610				2628	2628	18	18	0	0.00	2
	20150130	2628	2628				2632	2632	4	4	0	0.00	2
	20150202	2632	2632				2626	2626	-6	-6	0	0.00	2
	20150203	2626	2626				2610	2610	-16	-16	0	0.00	2
	20150204	2610	2610				2604	2604	-6	-6	0	0.00	2
	20150205	2604	2604				2594	2594	-10	-10	0	0.00	2
	20150206	2594	2594				2598	2598	4	4	0	0.00	2
	20150209	2598	2598				2592	2592	-6	-6	0	0.00	2
	20150210	2592	2592				2596	2596	4	4	0	0.00	2
	20150211	2596	2596				2606	2606	10	10	0	0.00	2
	20150212	2606	2606				2606	2606	0	0	0	0.00	2
	20150213	2606	2606				2624	2624	18	18	0	0.00	2
	20150216	2624	2624				2646	2646	22	22	0	0.00	2
	20150217	2646	2646				2646	2646	0	0	0	0.00	2
	20150225	2646	2646				2646	2646	0	0	0	0.00	2
	20150226	2646	2646	2714	2714	2714	2714	2714	68	68	2	5.43	4
	20150227	2714	2714	2680	2680	2680	2680	2680	-34	-34	2	5.36	4
	20150302	2680	2680				2680	2680	0	0	0	0.00	4
	20150303	2680	2680				2680	2680	0	0	0	0.00	4
	20150304	2680	2680				2680	2680	0	0	0	0.00	4
	20150305	2680	2680				2680	2680	0	0	0	0.00	4
	20150306	2680	2680				2680	2680	0	0	0	0.00	4
	20150309	2680	2680				2658	2658	-22	-22	0	0.00	4
	20150310	2658	2658				2636	2636	-22	-22	0	0.00	4
	20150311	2636	2636				2614	2614	-22	-22	0	0.00	4
	20150312	2614	2614				2614	2614	0	0	0	0.00	4
	20150313	2614	2614				2614	2614	0	0	0	0.00	4
	20150316	2614	2614				2614	2614	0	0	0	0.00	4
	20150317	2614	2614				2614	2614	0	0	0	0.00	4
	20150318	2614	2614				2614	2614	0	0	0	0.00	4
	20150319	2614	2614				2614	2614	0	0	0	0.00	4
	20150320	2614	2614				2614	2614	0	0	0	0.00	4
	20150323	2614	2614	2628	2630	2628	2630	2628	16	14	8	21.04	12
	20150324	2630	2628	2584	2584	2584	2584	2584	-44	-44	2	5.17	10
	20150325	2584	2584				2570	2570	-14	-14	0	0.00	10
	20150326	2570	2570				2552	2552	-18	-18	0	0.00	10
	20150327	2552	2552				2552	2552	0	0	0	0.00	10
	20150330	2552	2552				2556	2556	4	4	0	0.00	10
	20150331	2556	2556				2556	2556	0	0	0	0.00	10
	20150401	2556	2556				2538	2538	-18	-18	0	0.00	10
	20150402	2538	2538				2498	2498	-40	-40	0	0.00	10
	20150403	2498	2498				2480	2480	-18	-18	0	0.00	10
	20150407	2480	2480				2448	2448	-32	-32	0	0.00	10
	20150408	2448	2448				2410	2410	-38	-38	0	0.00	10
	20150409	2410	2410				2398	2398	-12	-12	0	0.00	10
	20150410	2398	2398	2320	2410	2320	2410	2358	12	-40	12	28.30	10
	20150413	2410	2358				2382	2382	24	24	0	0.00	10
	20150414	2382	2382				2400	2400	18	18	0	0.00	10
	20150415	2400	2400				2392	2392	-8	-8	0	0.00	10
	20150416	2392	2392				2384	2384	-8	-8	0	0.00	10
	20150417	2384	2384	2400	2426	2324	2400	2396	16	12	12	28.76	8
	20150420	2400	2396	2312	2312	2312	2312	2312	-84	-84	2	4.62	8
	20150421	2312	2312				2296	2296	-16	-16	0	0.00	8
	20150422	2296	2296				2314	2314	18	18	0	0.00	8
	20150423	2314	2314	2348	2350	2342	2342	2346	28	32	10	23.47	2
	20150424	2342	2346				2376	2376	30	30	0	0.00	2
	20150427	2376	2376				2400	2400	24	24	0	0.00	2
	20150428	2400	2400				2423	2423	23	23	0	0.00	2
	20150429	2423	2423				2404	2404	-19	-19	0	0.00	2
	20150430	2404	2404				2365	2365	-39	-39	0	0.00	2
hc1507	20150105	3024	3024				2998	2998	-26	-26	0	0.00	2
	20150106	2998	2998				3036	3036	38	38	0	0.00	2
	20150107	3036	3036				3002	3002	-34	-34	0	0.00	2
	20150108	3002	3002				2986	2986	-16	-16	0	0.00	2
	20150109	2986	2986				2940	2940	-46	-46	0	0.00	2
	20150112	2940	2940				2876	2876	-64	-64	0	0.00	2
	20150113	2876	2876				2820	2820	-56	-56	0	0.00	2
	20150114	2820	2820				2764	2764	-56	-56	0	0.00	2
	20150115	2764	2764				2756	2756	-8	-8	0	0.00	2
	20150116	2756	2756				2758	2758	2	2	0	0.00	2
	20150119	2758	2758				2746	2746	-12	-12	0	0.00	2
	20150120	2746	2746				2732	2732	-14	-14	0	0.00	2
	20150121	2732	2732				2728	2728	-4	-4	0	0.00	2
	20150122	2728	2728				2720	2720	-8	-8	0	0.00	2
	20150123	2720	2720				2702	2702	-18	-18	0	0.00	2
	20150126	2702	2702				2658	2658	-44	-44	0	0.00	2
	20150127	2658	2658				2658	2658	0	0	0	0.00	2
	20150128	2658	2658				2686	2686	28	28	0	0.00	2
	20150129	2686	2686				2704	2704	18	18	0	0.00	2
	20150130	2704	2704				2708	2708	4	4	0	0.00	2
	20150202	2708	2708				2708	2708	0	0	0	0.00	2
	20150203	2708	2708				2692	2692	-16	-16	0	0.00	2
	20150204	2692	2692				2686	2686	-6	-6	0	0.00	2
	20150205	2686	2686				2676	2676	-10	-10	0	0.00	2
	20150206	2676	2676				2682	2682	6	6	0	0.00	2
	20150209	2682	2682				2676	2676	-6	-6	0	0.00	2
	20150210	2676	2676				2680	2680	4	4	0	0.00	2
	20150211	2680	2680				2690	2690	10	10	0	0.00	2
	20150212	2690	2690				2690	2690	0	0	0	0.00	2
	20150213	2690	2690				2708	2708	18	18	0	0.00	2
	20150216	2708	2708				2732	2732	24	24	0	0.00	2
	20150217	2732	2732				2714	2714	-18	-18	0	0.00	2
	20150225	2714	2714				2690	2690	-24	-24	0	0.00	2
	20150226	2690	2690				2758	2758	68	68	0	0.00	2
	20150227	2758	2758				2722	2722	-36	-36	0	0.00	2
	20150302	2722	2722				2706	2706	-16	-16	0	0.00	2
	20150303	2706	2706				2710	2710	4	4	0	0.00	2
	20150304	2710	2710				2708	2708	-2	-2	0	0.00	2
	20150305	2708	2708				2688	2688	-20	-20	0	0.00	2
	20150306	2688	2688				2676	2676	-12	-12	0	0.00	2
	20150309	2676	2676				2654	2654	-22	-22	0	0.00	2
	20150310	2654	2654				2632	2632	-22	-22	0	0.00	2
	20150311	2632	2632				2610	2610	-22	-22	0	0.00	2
	20150312	2610	2610				2624	2624	14	14	0	0.00	2
	20150313	2624	2624				2630	2630	6	6	0	0.00	2
	20150316	2630	2630				2630	2630	0	0	0	0.00	2
	20150317	2630	2630				2646	2646	16	16	0	0.00	2
	20150318	2646	2646				2634	2634	-12	-12	0	0.00	2
	20150319	2634	2634				2628	2628	-6	-6	0	0.00	2
	20150320	2628	2628				2632	2632	4	4	0	0.00	2
	20150323	2632	2632				2646	2646	14	14	0	0.00	2
	20150324	2646	2646				2600	2600	-46	-46	0	0.00	2
	20150325	2600	2600				2586	2586	-14	-14	0	0.00	2
	20150326	2586	2586				2566	2566	-20	-20	0	0.00	2
	20150327	2566	2566				2528	2528	-38	-38	0	0.00	2
	20150330	2528	2528				2532	2532	4	4	0	0.00	2
	20150331	2532	2532				2522	2522	-10	-10	0	0.00	2
	20150401	2522	2522				2504	2504	-18	-18	0	0.00	2
	20150402	2504	2504				2464	2464	-40	-40	0	0.00	2
	20150403	2464	2464				2446	2446	-18	-18	0	0.00	2
	20150407	2446	2446				2414	2414	-32	-32	0	0.00	2
	20150408	2414	2414				2376	2376	-38	-38	0	0.00	2
	20150409	2376	2376				2364	2364	-12	-12	0	0.00	2
	20150410	2364	2364				2324	2324	-40	-40	0	0.00	2
	20150413	2324	2324				2348	2348	24	24	0	0.00	2
	20150414	2348	2348				2366	2366	18	18	0	0.00	2
	20150415	2366	2366				2360	2360	-6	-6	0	0.00	2
	20150416	2360	2360				2352	2352	-8	-8	0	0.00	2
	20150417	2352	2352				2364	2364	12	12	0	0.00	2
	20150420	2364	2364				2280	2280	-84	-84	0	0.00	2
	20150421	2280	2280				2264	2264	-16	-16	0	0.00	2
	20150422	2264	2264				2282	2282	18	18	0	0.00	2
	20150423	2282	2282				2314	2314	32	32	0	0.00	2
	20150424	2314	2314				2344	2344	30	30	0	0.00	2
	20150427	2344	2344				2368	2368	24	24	0	0.00	2
	20150428	2368	2368				2391	2391	23	23	0	0.00	2
	20150429	2391	2391				2372	2372	-19	-19	0	0.00	2
	20150430	2372	2372				2333	2333	-39	-39	0	0.00	2
hc1508	20150105	3004	3004				3004	3004	0	0	0	0.00	0
	20150106	3004	3004				3004	3004	0	0	0	0.00	0
	20150107	3004	3004				3004	3004	0	0	0	0.00	0
	20150108	3004	3004				3004	3004	0	0	0	0.00	0
	20150109	3004	3004				3004	3004	0	0	0	0.00	0
	20150112	3004	3004				3004	3004	0	0	0	0.00	0
	20150113	3004	3004				3004	3004	0	0	0	0.00	0
	20150114	3004	3004	2762	2762	2762	2762	2762	-242	-242	2	5.52	2
	20150115	2762	2762				2754	2754	-8	-8	0	0.00	2
	20150116	2754	2754				2756	2756	2	2	0	0.00	2
	20150119	2756	2756				2744	2744	-12	-12	0	0.00	2
	20150120	2744	2744				2730	2730	-14	-14	0	0.00	2
	20150121	2730	2730				2726	2726	-4	-4	0	0.00	2
	20150122	2726	2726				2718	2718	-8	-8	0	0.00	2
	20150123	2718	2718				2700	2700	-18	-18	0	0.00	2
	20150126	2700	2700				2656	2656	-44	-44	0	0.00	2
	20150127	2656	2656				2636	2636	-20	-20	0	0.00	2
	20150128	2636	2636				2664	2664	28	28	0	0.00	2
	20150129	2664	2664				2682	2682	18	18	0	0.00	2
	20150130	2682	2682				2686	2686	4	4	0	0.00	2
	20150202	2686	2686				2686	2686	0	0	0	0.00	2
	20150203	2686	2686				2670	2670	-16	-16	0	0.00	2
	20150204	2670	2670				2664	2664	-6	-6	0	0.00	2
	20150205	2664	2664				2654	2654	-10	-10	0	0.00	2
	20150206	2654	2654				2660	2660	6	6	0	0.00	2
	20150209	2660	2660				2654	2654	-6	-6	0	0.00	2
	20150210	2654	2654				2658	2658	4	4	0	0.00	2
	20150211	2658	2658				2668	2668	10	10	0	0.00	2
	20150212	2668	2668				2668	2668	0	0	0	0.00	2
	20150213	2668	2668				2686	2686	18	18	0	0.00	2
	20150216	2686	2686				2710	2710	24	24	0	0.00	2
	20150217	2710	2710				2694	2694	-16	-16	0	0.00	2
	20150225	2694	2694				2670	2670	-24	-24	0	0.00	2
	20150226	2670	2670				2738	2738	68	68	0	0.00	2
	20150227	2738	2738				2702	2702	-36	-36	0	0.00	2
	20150302	2702	2702				2688	2688	-14	-14	0	0.00	2
	20150303	2688	2688				2692	2692	4	4	0	0.00	2
	20150304	2692	2692				2690	2690	-2	-2	0	0.00	2
	20150305	2690	2690				2670	2670	-20	-20	0	0.00	2
	20150306	2670	2670				2658	2658	-12	-12	0	0.00	2
	20150309	2658	2658				2636	2636	-22	-22	0	0.00	2
	20150310	2636	2636				2614	2614	-22	-22	0	0.00	2
	20150311	2614	2614				2594	2594	-20	-20	0	0.00	2
	20150312	2594	2594				2608	2608	14	14	0	0.00	2
	20150313	2608	2608				2614	2614	6	6	0	0.00	2
	20150316	2614	2614				2614	2614	0	0	0	0.00	2
	20150317	2614	2614				2630	2630	16	16	0	0.00	2
	20150318	2630	2630				2618	2618	-12	-12	0	0.00	2
	20150319	2618	2618				2612	2612	-6	-6	0	0.00	2
	20150320	2612	2612				2616	2616	4	4	0	0.00	2
	20150323	2616	2616				2630	2630	14	14	0	0.00	2
	20150324	2630	2630				2584	2584	-46	-46	0	0.00	2
	20150325	2584	2584				2570	2570	-14	-14	0	0.00	2
	20150326	2570	2570	2636	2636	2500	2500	2568	-70	-2	4	10.27	4
	20150327	2500	2568				2530	2530	-38	-38	0	0.00	4
	20150330	2530	2530				2530	2530	0	0	0	0.00	4
	20150331	2530	2530				2520	2520	-10	-10	0	0.00	4
	20150401	2520	2520				2502	2502	-18	-18	0	0.00	4
	20150402	2502	2502				2462	2462	-40	-40	0	0.00	4
	20150403	2462	2462				2444	2444	-18	-18	0	0.00	4
	20150407	2444	2444				2412	2412	-32	-32	0	0.00	4
	20150408	2412	2412	2390	2390	2390	2390	2390	-22	-22	2	4.78	2
	20150409	2390	2390				2378	2378	-12	-12	0	0.00	2
	20150410	2378	2378				2338	2338	-40	-40	0	0.00	2
	20150413	2338	2338				2362	2362	24	24	0	0.00	2
	20150414	2362	2362				2380	2380	18	18	0	0.00	2
	20150415	2380	2380				2374	2374	-6	-6	0	0.00	2
	20150416	2374	2374				2366	2366	-8	-8	0	0.00	2
	20150417	2366	2366				2378	2378	12	12	0	0.00	2
	20150420	2378	2378				2294	2294	-84	-84	0	0.00	2
	20150421	2294	2294				2278	2278	-16	-16	0	0.00	2
	20150422	2278	2278				2296	2296	18	18	0	0.00	2
	20150423	2296	2296				2328	2328	32	32	0	0.00	2
	20150424	2328	2328				2358	2358	30	30	0	0.00	2
	20150427	2358	2358	2474	2474	2474	2474	2474	116	116	2	4.95	0
	20150428	2474	2474	2424	2584	2424	2471	2461	-3	-13	56	137.84	0
	20150429	2471	2461				2442	2442	-19	-19	0	0.00	0
	20150430	2442	2442				2402	2402	-40	-40	0	0.00	0
hc1509	20150105	3012	3012				3012	3012	0	0	0	0.00	0
	20150106	3012	3012				3012	3012	0	0	0	0.00	0
	20150107	3012	3012				3012	3012	0	0	0	0.00	0
	20150108	3012	3012				3012	3012	0	0	0	0.00	0
	20150109	3012	3012				3012	3012	0	0	0	0.00	0
	20150112	3012	3012				3012	3012	0	0	0	0.00	0
	20150113	3012	3012				3012	3012	0	0	0	0.00	0
	20150114	3012	3012	2770	2770	2770	2770	2770	-242	-242	4	11.08	4
	20150115	2770	2770	2802	2814	2752	2752	2796	-18	26	16	44.76	16
	20150116	2752	2796	2786	2786	2686	2686	2760	-110	-36	8	22.09	20
	20150119	2686	2760	2652	2754	2652	2754	2662	-6	-98	20	53.24	4
	20150120	2754	2662				2648	2648	-14	-14	0	0.00	4
	20150121	2648	2648				2644	2644	-4	-4	0	0.00	4
	20150122	2644	2644				2636	2636	-8	-8	0	0.00	4
	20150123	2636	2636				2618	2618	-18	-18	0	0.00	4
	20150126	2618	2618				2574	2574	-44	-44	0	0.00	4
	20150127	2574	2574				2574	2574	0	0	0	0.00	4
	20150128	2574	2574				2600	2600	26	26	0	0.00	4
	20150129	2600	2600				2616	2616	16	16	0	0.00	4
	20150130	2616	2616	2618	2676	2600	2630	2636	14	20	18	47.46	10
	20150202	2630	2636	2738	2738	2648	2648	2670	12	34	10	26.70	8
	20150203	2648	2670	2620	2634	2620	2634	2622	-36	-48	8	20.99	2
	20150204	2634	2622				2622	2622	0	0	0	0.00	2
	20150205	2622	2622				2622	2622	0	0	0	0.00	2
	20150206	2622	2622	2622	2622	2622	2622	2622	0	0	2	5.24	2
	20150209	2622	2622				2622	2622	0	0	0	0.00	2
	20150210	2622	2622				2622	2622	0	0	0	0.00	2
	20150211	2622	2622				2622	2622	0	0	0	0.00	2
	20150212	2622	2622				2622	2622	0	0	0	0.00	2
	20150213	2622	2622				2622	2622	0	0	0	0.00	2
	20150216	2622	2622				2644	2644	22	22	0	0.00	2
	20150217	2644	2644	2696	2696	2650	2650	2672	6	28	4	10.69	2
	20150225	2650	2672				2672	2672	0	0	0	0.00	2
	20150226	2672	2672	2700	2700	2594	2626	2644	-46	-28	10	26.44	2
	20150227	2626	2644	2672	2676	2618	2618	2646	-26	2	12	31.76	2
	20150302	2618	2646	2680	2680	2680	2680	2680	34	34	4	10.72	6
	20150303	2680	2680	2672	2672	2642	2642	2656	-38	-24	4	10.63	4
	20150304	2642	2656				2656	2656	0	0	0	0.00	4
	20150305	2656	2656	2622	2622	2622	2622	2622	-34	-34	2	5.24	2
	20150306	2622	2622				2622	2622	0	0	0	0.00	2
	20150309	2622	2622	2514	2524	2508	2522	2516	-100	-106	100	251.77	100
	20150310	2522	2516				2528	2528	12	12	0	0.00	100
	20150311	2528	2528				2528	2528	0	0	0	0.00	100
	20150312	2528	2528				2528	2528	0	0	0	0.00	100
	20150313	2528	2528	2580	2608	2510	2572	2552	44	24	14	35.74	102
	20150316	2572	2552				2552	2552	0	0	0	0.00	102
	20150317	2552	2552	2618	2618	2618	2618	2618	66	66	2	5.24	100
	20150318	2618	2618	2656	2656	2520	2520	2580	-98	-38	80	206.40	102
	20150319	2520	2580	2544	2568	2544	2568	2556	-12	-24	4	10.22	100
	20150320	2568	2556				2556	2556	0	0	0	0.00	100
	20150323	2556	2556				2556	2556	0	0	0	0.00	100
	20150324	2556	2556				2556	2556	0	0	0	0.00	100
	20150325	2556	2556	2560	2646	2544	2552	2576	-4	20	32	82.47	100
	20150326	2552	2576				2576	2576	0	0	0	0.00	100
	20150327	2576	2576	2594	2594	2486	2486	2536	-90	-40	8	20.30	100
	20150330	2486	2536	2542	2542	2542	2542	2542	6	6	2	5.08	100
	20150331	2542	2542	2560	2560	2560	2560	2560	18	18	2	5.12	100
	20150401	2560	2560	2504	2508	2472	2472	2488	-88	-72	48	119.44	100
	20150402	2472	2488	2440	2460	2438	2460	2446	-28	-42	6	14.68	100
	20150403	2460	2446	2442	2444	2420	2420	2434	-26	-12	6	14.61	100
	20150407	2420	2434				2406	2406	-28	-28	0	0.00	100
	20150408	2406	2406	2376	2410	2296	2368	2364	-38	-42	132	312.20	100
	20150409	2368	2364	2290	2290	2290	2290	2290	-74	-74	2	4.58	100
	20150410	2290	2290	2360	2374	2290	2336	2336	46	46	22	51.42	100
	20150413	2336	2336	2338	2408	2312	2388	2356	52	20	122	287.50	100
	20150414	2388	2356	2356	2400	2328	2400	2360	44	4	6	14.17	100
	20150415	2400	2360	2372	2372	2362	2362	2366	2	6	10	23.67	100
	20150416	2362	2366	2340	2372	2336	2364	2350	-2	-16	30	70.55	100
	20150417	2364	2350	2346	2362	2344	2352	2352	2	2	14	32.93	100
	20150420	2352	2352	2304	2350	2304	2330	2326	-22	-26	30	69.81	100
	20150421	2330	2326	2334	2418	2310	2328	2338	2	12	46	107.62	102
	20150422	2328	2338	2352	2370	2320	2370	2344	32	6	22	51.61	108
	20150423	2370	2344	2382	2454	2366	2384	2378	40	34	68	161.74	108
	20150424	2384	2378	2402	2450	2402	2450	2434	72	56	18	43.83	102
	20150427	2450	2434	2468	2504	2426	2482	2468	48	34	92	227.11	114
	20150428	2482	2468	2566	2566	2566	2566	2566	98	98	4	10.26	112
	20150429	2566	2566	2510	2510	2437	2454	2488	-112	-78	22	54.74	108
	20150430	2454	2488	2440	2523	2403	2474	2467	-14	-21	26	64.14	124
hc1510	20150105	2936	2936				2912	2912	-24	-24	0	0.00	2
	20150106	2912	2912				2948	2948	36	36	0	0.00	2
	20150107	2948	2948				2916	2916	-32	-32	0	0.00	2
	20150108	2916	2916				2900	2900	-16	-16	0	0.00	2
	20150109	2900	2900	2976	2976	2798	2798	2886	-102	-14	4	11.55	4
	20150112	2798	2886				2822	2822	-64	-64	0	0.00	4
	20150113	2822	2822	2710	2796	2710	2734	2746	-88	-76	6	16.48	2
	20150114	2734	2746				2746	2746	0	0	0	0.00	2
	20150115	2746	2746				2772	2772	26	26	0	0.00	2
	20150116	2772	2772				2736	2736	-36	-36	0	0.00	2
	20150119	2736	2736				2736	2736	0	0	0	0.00	2
	20150120	2736	2736	2760	2760	2760	2760	2760	24	24	2	5.52	0
	20150121	2760	2760				2756	2756	-4	-4	0	0.00	0
	20150122	2756	2756				2748	2748	-8	-8	0	0.00	0
	20150123	2748	2748				2730	2730	-18	-18	0	0.00	0
	20150126	2730	2730				2684	2684	-46	-46	0	0.00	0
	20150127	2684	2684				2684	2684	0	0	0	0.00	0
	20150128	2684	2684				2712	2712	28	28	0	0.00	0
	20150129	2712	2712				2712	2712	0	0	0	0.00	0
	20150130	2712	2712				2712	2712	0	0	0	0.00	0
	20150202	2712	2712				2712	2712	0	0	0	0.00	0
	20150203	2712	2712				2664	2664	-48	-48	0	0.00	0
	20150204	2664	2664				2664	2664	0	0	0	0.00	0
	20150205	2664	2664				2654	2654	-10	-10	0	0.00	0
	20150206	2654	2654				2654	2654	0	0	0	0.00	0
	20150209	2654	2654				2648	2648	-6	-6	0	0.00	0
	20150210	2648	2648				2648	2648	0	0	0	0.00	0
	20150211	2648	2648	2608	2608	2608	2608	2608	-40	-40	2	5.22	2
	20150212	2608	2608	2670	2670	2670	2670	2670	62	62	2	5.34	2
	20150213	2670	2670				2670	2670	0	0	0	0.00	2
	20150216	2670	2670				2670	2670	0	0	0	0.00	2
	20150217	2670	2670				2670	2670	0	0	0	0.00	2
	20150225	2670	2670				2646	2646	-24	-24	0	0.00	2
	20150226	2646	2646				2646	2646	0	0	0	0.00	2
	20150227	2646	2646				2646	2646	0	0	0	0.00	2
	20150302	2646	2646	2646	2646	2646	2646	2646	0	0	2	5.29	4
	20150303	2646	2646				2646	2646	0	0	0	0.00	4
	20150304	2646	2646	2592	2690	2590	2690	2632	44	-14	142	373.92	86
	20150305	2690	2632	2660	2676	2640	2640	2650	8	18	84	222.60	94
	20150306	2640	2650	2650	2656	2614	2614	2638	-36	-12	16	42.22	94
	20150309	2614	2638	2604	2638	2594	2612	2608	-26	-30	120	313.12	184
	20150310	2612	2608	2610	2610	2572	2584	2600	-24	-8	372	967.74	468
	20150311	2584	2600	2526	2572	2526	2564	2560	-36	-40	304	778.56	494
	20150312	2564	2560	2570	2592	2554	2586	2572	26	12	234	602.13	574
	20150313	2586	2572	2582	2602	2560	2568	2568	-4	-4	1804	4,634.66	1534
	20150316	2568	2568	2568	2600	2558	2594	2584	26	16	1448	3,741.68	2358
	20150317	2594	2584	2600	2602	2582	2590	2590	6	6	288	746.07	2384
	20150318	2590	2590	2590	2596	2558	2570	2582	-20	-8	1352	3,492.04	2890
	20150319	2570	2582	2556	2580	2556	2566	2568	-16	-14	458	1,176.98	2920
	20150320	2566	2568	2558	2570	2552	2560	2562	-8	-6	1206	3,090.58	3408
	20150323	2560	2562	2576	2600	2554	2590	2586	28	24	5404	13,977.68	7148
	20150324	2590	2586	2596	2622	2592	2598	2606	12	20	3366	8,773.74	8518
	20150325	2598	2606	2602	2606	2578	2586	2590	-20	-16	3794	9,827.18	9912
	20150326	2586	2590	2580	2588	2572	2574	2578	-16	-12	2500	6,449.18	11090
	20150327	2574	2578	2570	2574	2500	2552	2538	-26	-40	2810	7,136.78	11064
	20150330	2552	2538	2546	2560	2526	2532	2540	-6	2	1742	4,426.62	11692
	20150331	2532	2540	2540	2548	2518	2522	2528	-18	-12	2404	6,081.84	11942
	20150401	2522	2528	2524	2528	2482	2494	2502	-34	-26	5676	14,203.84	10954
	20150402	2494	2502	2480	2484	2446	2450	2458	-52	-44	9396	23,110.89	14348
	20150403	2450	2458	2448	2468	2430	2432	2444	-26	-14	4478	10,948.04	15316
	20150407	2432	2444	2430	2436	2376	2376	2394	-68	-50	13406	32,096.48	21928
	20150408	2376	2394	2376	2404	2354	2392	2374	-2	-20	9706	23,050.84	22790
	20150409	2392	2374	2382	2388	2358	2362	2370	-12	-4	4618	10,945.02	22972
	20150410	2362	2370	2362	2366	2344	2346	2354	-24	-16	5278	12,424.48	22758
	20150413	2346	2354	2346	2420	2344	2412	2378	58	24	8930	21,237.01	23238
	20150414	2412	2378	2412	2424	2390	2406	2404	28	26	8230	19,787.65	23888
	20150415	2406	2404	2408	2414	2380	2382	2398	-22	-6	7002	16,801.55	23954
	20150416	2382	2398	2372	2410	2372	2396	2394	-2	-4	7012	16,795.93	23922
	20150417	2396	2394	2398	2414	2390	2396	2400	2	6	6458	15,503.13	25024
	20150420	2396	2400	2390	2394	2364	2366	2378	-34	-22	10158	24,159.68	23054
	20150421	2366	2378	2364	2376	2356	2372	2366	-6	-12	5278	12,488.61	23038
	20150422	2372	2366	2376	2430	2370	2422	2402	56	36	10954	26,311.86	22792
	20150423	2422	2402	2424	2436	2408	2434	2424	32	22	15212	36,875.83	22382
	20150424	2434	2424	2434	2496	2434	2490	2466	66	42	29142	71,917.19	26170
	20150427	2490	2466	2500	2516	2476	2510	2496	44	30	14874	37,141.66	26244
	20150428	2510	2496	2512	2532	2492	2498	2513	2	17	19506	49,018.97	27638
	20150429	2498	2513	2497	2519	2446	2460	2487	-53	-26	17196	42,783.42	27710
	20150430	2460	2487	2460	2492	2454	2487	2478	0	-9	9826	24,351.14	27246
hc1511	20150105	2828	2828				2804	2804	-24	-24	0	0.00	0
	20150106	2804	2804				2840	2840	36	36	0	0.00	0
	20150107	2840	2840				2808	2808	-32	-32	0	0.00	0
	20150108	2808	2808				2792	2792	-16	-16	0	0.00	0
	20150109	2792	2792				2778	2778	-14	-14	0	0.00	0
	20150112	2778	2778				2716	2716	-62	-62	0	0.00	0
	20150113	2716	2716				2716	2716	0	0	0	0.00	0
	20150114	2716	2716				2716	2716	0	0	0	0.00	0
	20150115	2716	2716				2742	2742	26	26	0	0.00	0
	20150116	2742	2742				2706	2706	-36	-36	0	0.00	0
	20150119	2706	2706				2610	2610	-96	-96	0	0.00	0
	20150120	2610	2610				2632	2632	22	22	0	0.00	0
	20150121	2632	2632				2628	2628	-4	-4	0	0.00	0
	20150122	2628	2628				2620	2620	-8	-8	0	0.00	0
	20150123	2620	2620				2602	2602	-18	-18	0	0.00	0
	20150126	2602	2602				2558	2558	-44	-44	0	0.00	0
	20150127	2558	2558				2558	2558	0	0	0	0.00	0
	20150128	2558	2558				2584	2584	26	26	0	0.00	0
	20150129	2584	2584				2584	2584	0	0	0	0.00	0
	20150130	2584	2584				2584	2584	0	0	0	0.00	0
	20150202	2584	2584				2584	2584	0	0	0	0.00	0
	20150203	2584	2584				2538	2538	-46	-46	0	0.00	0
	20150204	2538	2538				2532	2532	-6	-6	0	0.00	0
	20150205	2532	2532				2522	2522	-10	-10	0	0.00	0
	20150206	2522	2522				2522	2522	0	0	0	0.00	0
	20150209	2522	2522				2552	2552	30	30	0	0.00	0
	20150210	2552	2552				2560	2560	8	8	0	0.00	0
	20150211	2560	2560				2520	2520	-40	-40	0	0.00	0
	20150212	2520	2520				2554	2554	34	34	0	0.00	0
	20150213	2554	2554				2580	2580	26	26	0	0.00	0
	20150216	2580	2580				2580	2580	0	0	0	0.00	0
	20150217	2580	2580				2608	2608	28	28	0	0.00	0
	20150225	2608	2608				2584	2584	-24	-24	0	0.00	0
	20150226	2584	2584				2584	2584	0	0	0	0.00	0
	20150227	2584	2584				2584	2584	0	0	0	0.00	0
	20150302	2584	2584				2584	2584	0	0	0	0.00	0
	20150303	2584	2584				2584	2584	0	0	0	0.00	0
	20150304	2584	2584				2570	2570	-14	-14	0	0.00	0
	20150305	2570	2570				2570	2570	0	0	0	0.00	0
	20150306	2570	2570				2570	2570	0	0	0	0.00	0
	20150309	2570	2570				2570	2570	0	0	0	0.00	0
	20150310	2570	2570				2570	2570	0	0	0	0.00	0
	20150311	2570	2570				2570	2570	0	0	0	0.00	0
	20150312	2570	2570				2570	2570	0	0	0	0.00	0
	20150313	2570	2570				2570	2570	0	0	0	0.00	0
	20150316	2570	2570				2570	2570	0	0	0	0.00	0
	20150317	2570	2570				2570	2570	0	0	0	0.00	0
	20150318	2570	2570				2570	2570	0	0	0	0.00	0
	20150319	2570	2570				2570	2570	0	0	0	0.00	0
	20150320	2570	2570				2570	2570	0	0	0	0.00	0
	20150323	2570	2570				2570	2570	0	0	0	0.00	0
	20150324	2570	2570				2570	2570	0	0	0	0.00	0
	20150325	2570	2570				2570	2570	0	0	0	0.00	0
	20150326	2570	2570				2570	2570	0	0	0	0.00	0
	20150327	2570	2570				2570	2570	0	0	0	0.00	0
	20150330	2570	2570				2570	2570	0	0	0	0.00	0
	20150331	2570	2570				2570	2570	0	0	0	0.00	0
	20150401	2570	2570				2570	2570	0	0	0	0.00	0
	20150402	2570	2570				2548	2548	-22	-22	0	0.00	0
	20150403	2548	2548				2524	2524	-24	-24	0	0.00	0
	20150407	2524	2524				2470	2470	-54	-54	0	0.00	0
	20150408	2470	2470				2470	2470	0	0	0	0.00	0
	20150409	2470	2470				2458	2458	-12	-12	0	0.00	0
	20150410	2458	2458				2448	2448	-10	-10	0	0.00	0
	20150413	2448	2448	2320	2442	2320	2370	2364	-78	-84	8	18.92	2
	20150414	2370	2364				2364	2364	0	0	0	0.00	2
	20150415	2364	2364				2364	2364	0	0	0	0.00	2
	20150416	2364	2364				2364	2364	0	0	0	0.00	2
	20150417	2364	2364				2370	2370	6	6	0	0.00	2
	20150420	2370	2370				2370	2370	0	0	0	0.00	2
	20150421	2370	2370				2370	2370	0	0	0	0.00	2
	20150422	2370	2370				2406	2406	36	36	0	0.00	2
	20150423	2406	2406				2406	2406	0	0	0	0.00	2
	20150424	2406	2406				2430	2430	24	24	0	0.00	2
	20150427	2430	2430				2444	2444	14	14	0	0.00	2
	20150428	2444	2444				2447	2447	3	3	0	0.00	2
	20150429	2447	2447				2470	2470	23	23	0	0.00	2
	20150430	2470	2470				2470	2470	0	0	0	0.00	2
hc1512	20150105	2828	2828				2804	2804	-24	-24	0	0.00	0
	20150106	2804	2804				2840	2840	36	36	0	0.00	0
	20150107	2840	2840				2808	2808	-32	-32	0	0.00	0
	20150108	2808	2808				2792	2792	-16	-16	0	0.00	0
	20150109	2792	2792				2778	2778	-14	-14	0	0.00	0
	20150112	2778	2778				2716	2716	-62	-62	0	0.00	0
	20150113	2716	2716				2716	2716	0	0	0	0.00	0
	20150114	2716	2716				2716	2716	0	0	0	0.00	0
	20150115	2716	2716				2742	2742	26	26	0	0.00	0
	20150116	2742	2742				2706	2706	-36	-36	0	0.00	0
	20150119	2706	2706				2706	2706	0	0	0	0.00	0
	20150120	2706	2706	2770	2770	2640	2640	2704	-66	-2	4	10.82	0
	20150121	2640	2704				2700	2700	-4	-4	0	0.00	0
	20150122	2700	2700				2692	2692	-8	-8	0	0.00	0
	20150123	2692	2692				2674	2674	-18	-18	0	0.00	0
	20150126	2674	2674				2630	2630	-44	-44	0	0.00	0
	20150127	2630	2630				2610	2610	-20	-20	0	0.00	0
	20150128	2610	2610				2638	2638	28	28	0	0.00	0
	20150129	2638	2638				2656	2656	18	18	0	0.00	0
	20150130	2656	2656				2656	2656	0	0	0	0.00	0
	20150202	2656	2656				2690	2690	34	34	0	0.00	0
	20150203	2690	2690				2642	2642	-48	-48	0	0.00	0
	20150204	2642	2642				2636	2636	-6	-6	0	0.00	0
	20150205	2636	2636				2626	2626	-10	-10	0	0.00	0
	20150206	2626	2626				2626	2626	0	0	0	0.00	0
	20150209	2626	2626				2620	2620	-6	-6	0	0.00	0
	20150210	2620	2620				2620	2620	0	0	0	0.00	0
	20150211	2620	2620				2580	2580	-40	-40	0	0.00	0
	20150212	2580	2580				2640	2640	60	60	0	0.00	0
	20150213	2640	2640				2658	2658	18	18	0	0.00	0
	20150216	2658	2658				2658	2658	0	0	0	0.00	0
	20150217	2658	2658				2658	2658	0	0	0	0.00	0
	20150225	2658	2658				2634	2634	-24	-24	0	0.00	0
	20150226	2634	2634				2634	2634	0	0	0	0.00	0
	20150227	2634	2634				2634	2634	0	0	0	0.00	0
	20150302	2634	2634				2634	2634	0	0	0	0.00	0
	20150303	2634	2634				2634	2634	0	0	0	0.00	0
	20150304	2634	2634				2634	2634	0	0	0	0.00	0
	20150305	2634	2634				2634	2634	0	0	0	0.00	0
	20150306	2634	2634				2634	2634	0	0	0	0.00	0
	20150309	2634	2634				2634	2634	0	0	0	0.00	0
	20150310	2634	2634				2634	2634	0	0	0	0.00	0
	20150311	2634	2634	2508	2664	2508	2664	2586	30	-48	4	10.34	0
	20150312	2664	2586				2586	2586	0	0	0	0.00	0
	20150313	2586	2586				2586	2586	0	0	0	0.00	0
	20150316	2586	2586				2586	2586	0	0	0	0.00	0
	20150317	2586	2586				2586	2586	0	0	0	0.00	0
	20150318	2586	2586				2586	2586	0	0	0	0.00	0
	20150319	2586	2586				2586	2586	0	0	0	0.00	0
	20150320	2586	2586				2586	2586	0	0	0	0.00	0
	20150323	2586	2586				2586	2586	0	0	0	0.00	0
	20150324	2586	2586				2586	2586	0	0	0	0.00	0
	20150325	2586	2586				2586	2586	0	0	0	0.00	0
	20150326	2586	2586				2574	2574	-12	-12	0	0.00	0
	20150327	2574	2574				2574	2574	0	0	0	0.00	0
	20150330	2574	2574				2574	2574	0	0	0	0.00	0
	20150331	2574	2574				2574	2574	0	0	0	0.00	0
	20150401	2574	2574				2574	2574	0	0	0	0.00	0
	20150402	2574	2574				2530	2530	-44	-44	0	0.00	0
	20150403	2530	2530				2516	2516	-14	-14	0	0.00	0
	20150407	2516	2516				2464	2464	-52	-52	0	0.00	0
	20150408	2464	2464				2464	2464	0	0	0	0.00	0
	20150409	2464	2464				2458	2458	-6	-6	0	0.00	0
	20150410	2458	2458				2440	2440	-18	-18	0	0.00	0
	20150413	2440	2440				2440	2440	0	0	0	0.00	0
	20150414	2440	2440				2440	2440	0	0	0	0.00	0
	20150415	2440	2440				2440	2440	0	0	0	0.00	0
	20150416	2440	2440				2436	2436	-4	-4	0	0.00	0
	20150417	2436	2436				2442	2442	6	6	0	0.00	0
	20150420	2442	2442				2420	2420	-22	-22	0	0.00	0
	20150421	2420	2420				2406	2406	-14	-14	0	0.00	0
	20150422	2406	2406				2442	2442	36	36	0	0.00	0
	20150423	2442	2442				2464	2464	22	22	0	0.00	0
	20150424	2464	2464				2508	2508	44	44	0	0.00	0
	20150427	2508	2508				2508	2508	0	0	0	0.00	0
	20150428	2508	2508	2480	2537	2480	2537	2500	29	-8	30	75.02	18
	20150429	2537	2500				2500	2500	0	0	0	0.00	18
	20150430	2500	2500				2491	2491	-9	-9	0	0.00	18
hc1601	20150116	2742	2742				2742	2742	0	0	0	0.00	0
	20150119	2742	2742				2742	2742	0	0	0	0.00	0
	20150120	2742	2742	2598	2598	2598	2598	2598	-144	-144	2	5.20	2
	20150121	2598	2598	2570	2620	2570	2620	2594	22	-4	4	10.38	6
	20150122	2620	2594				2594	2594	0	0	0	0.00	6
	20150123	2594	2594				2594	2594	0	0	0	0.00	6
	20150126	2594	2594	2538	2538	2538	2538	2538	-56	-56	2	5.08	6
	20150127	2538	2538	2502	2596	2502	2516	2526	-22	-12	10	25.26	6
	20150128	2516	2526	2624	2626	2554	2626	2600	100	74	12	31.21	6
	20150129	2626	2600	2662	2680	2626	2626	2656	26	56	6	15.94	8
	20150130	2626	2656				2656	2656	0	0	0	0.00	8
	20150202	2656	2656				2656	2656	0	0	0	0.00	8
	20150203	2656	2656				2656	2656	0	0	0	0.00	8
	20150204	2656	2656	2698	2698	2698	2698	2698	42	42	2	5.40	10
	20150205	2698	2698				2698	2698	0	0	0	0.00	10
	20150206	2698	2698				2698	2698	0	0	0	0.00	10
	20150209	2698	2698				2698	2698	0	0	0	0.00	10
	20150210	2698	2698				2698	2698	0	0	0	0.00	10
	20150211	2698	2698				2698	2698	0	0	0	0.00	10
	20150212	2698	2698				2698	2698	0	0	0	0.00	10
	20150213	2698	2698				2698	2698	0	0	0	0.00	10
	20150216	2698	2698				2698	2698	0	0	0	0.00	10
	20150217	2698	2698	2598	2736	2598	2736	2666	38	-32	4	10.67	8
	20150225	2736	2666				2642	2642	-24	-24	0	0.00	8
	20150226	2642	2642				2646	2646	4	4	0	0.00	8
	20150227	2646	2646				2646	2646	0	0	0	0.00	8
	20150302	2646	2646				2646	2646	0	0	0	0.00	8
	20150303	2646	2646				2646	2646	0	0	0	0.00	8
	20150304	2646	2646				2646	2646	0	0	0	0.00	8
	20150305	2646	2646				2646	2646	0	0	0	0.00	8
	20150306	2646	2646				2634	2634	-12	-12	0	0.00	8
	20150309	2634	2634				2634	2634	0	0	0	0.00	8
	20150310	2634	2634				2634	2634	0	0	0	0.00	8
	20150311	2634	2634				2634	2634	0	0	0	0.00	8
	20150312	2634	2634				2634	2634	0	0	0	0.00	8
	20150313	2634	2634				2630	2630	-4	-4	0	0.00	8
	20150316	2630	2630				2630	2630	0	0	0	0.00	8
	20150317	2630	2630				2636	2636	6	6	0	0.00	8
	20150318	2636	2636				2628	2628	-8	-8	0	0.00	8
	20150319	2628	2628				2614	2614	-14	-14	0	0.00	8
	20150320	2614	2614				2614	2614	0	0	0	0.00	8
	20150323	2614	2614				2614	2614	0	0	0	0.00	8
	20150324	2614	2614	2680	2680	2582	2582	2630	-32	16	4	10.52	10
	20150325	2582	2630				2614	2614	-16	-16	0	0.00	10
	20150326	2614	2614				2614	2614	0	0	0	0.00	10
	20150327	2614	2614	2582	2582	2582	2582	2582	-32	-32	2	5.16	8
	20150330	2582	2582				2582	2582	0	0	0	0.00	8
	20150331	2582	2582				2582	2582	0	0	0	0.00	8
	20150401	2582	2582				2582	2582	0	0	0	0.00	8
	20150402	2582	2582	2574	2574	2510	2510	2548	-72	-34	6	15.29	12
	20150403	2510	2548				2548	2548	0	0	0	0.00	12
	20150407	2548	2548	2424	2424	2422	2422	2422	-126	-126	6	14.54	14
	20150408	2422	2422				2422	2422	0	0	0	0.00	14
	20150409	2422	2422				2422	2422	0	0	0	0.00	14
	20150410	2422	2422				2422	2422	0	0	0	0.00	14
	20150413	2422	2422				2422	2422	0	0	0	0.00	14
	20150414	2422	2422	2490	2490	2450	2450	2470	28	48	4	9.88	14
	20150415	2450	2470				2470	2470	0	0	0	0.00	14
	20150416	2470	2470				2470	2470	0	0	0	0.00	14
	20150417	2470	2470				2470	2470	0	0	0	0.00	14
	20150420	2470	2470	2498	2498	2370	2370	2434	-100	-36	4	9.74	14
	20150421	2370	2434				2420	2420	-14	-14	0	0.00	14
	20150422	2420	2420				2470	2470	50	50	0	0.00	14
	20150423	2470	2470	2500	2500	2500	2500	2500	30	30	2	5.00	16
	20150424	2500	2500				2502	2502	2	2	0	0.00	16
	20150427	2502	2502	2502	2622	2502	2608	2610	106	108	58	151.39	62
	20150428	2608	2610	2603	2603	2600	2601	2600	-9	-10	22	57.21	72
	20150429	2601	2600	2570	2570	2570	2570	2570	-30	-30	6	15.42	76
	20150430	2570	2570				2570	2570	0	0	0	0.00	76
hc1602	20150216	2698	2698				2722	2722	24	24	0	0.00	0
	20150217	2722	2722				2690	2690	-32	-32	0	0.00	0
	20150225	2690	2690				2666	2666	-24	-24	0	0.00	0
	20150226	2666	2666				2638	2638	-28	-28	0	0.00	0
	20150227	2638	2638				2640	2640	2	2	0	0.00	0
	20150302	2640	2640				2640	2640	0	0	0	0.00	0
	20150303	2640	2640				2640	2640	0	0	0	0.00	0
	20150304	2640	2640				2640	2640	0	0	0	0.00	0
	20150305	2640	2640				2640	2640	0	0	0	0.00	0
	20150306	2640	2640				2628	2628	-12	-12	0	0.00	0
	20150309	2628	2628				2628	2628	0	0	0	0.00	0
	20150310	2628	2628				2628	2628	0	0	0	0.00	0
	20150311	2628	2628				2628	2628	0	0	0	0.00	0
	20150312	2628	2628				2628	2628	0	0	0	0.00	0
	20150313	2628	2628				2624	2624	-4	-4	0	0.00	0
	20150316	2624	2624				2624	2624	0	0	0	0.00	0
	20150317	2624	2624				2630	2630	6	6	0	0.00	0
	20150318	2630	2630				2622	2622	-8	-8	0	0.00	0
	20150319	2622	2622				2608	2608	-14	-14	0	0.00	0
	20150320	2608	2608				2608	2608	0	0	0	0.00	0
	20150323	2608	2608				2608	2608	0	0	0	0.00	0
	20150324	2608	2608				2608	2608	0	0	0	0.00	0
	20150325	2608	2608				2592	2592	-16	-16	0	0.00	0
	20150326	2592	2592				2592	2592	0	0	0	0.00	0
	20150327	2592	2592				2592	2592	0	0	0	0.00	0
	20150330	2592	2592				2592	2592	0	0	0	0.00	0
	20150331	2592	2592				2592	2592	0	0	0	0.00	0
	20150401	2592	2592				2592	2592	0	0	0	0.00	0
	20150402	2592	2592				2556	2556	-36	-36	0	0.00	0
	20150403	2556	2556				2556	2556	0	0	0	0.00	0
	20150407	2556	2556				2430	2430	-126	-126	0	0.00	0
	20150408	2430	2430				2430	2430	0	0	0	0.00	0
	20150409	2430	2430				2424	2424	-6	-6	0	0.00	0
	20150410	2424	2424				2424	2424	0	0	0	0.00	0
	20150413	2424	2424				2424	2424	0	0	0	0.00	0
	20150414	2424	2424				2472	2472	48	48	0	0.00	0
	20150415	2472	2472				2472	2472	0	0	0	0.00	0
	20150416	2472	2472				2468	2468	-4	-4	0	0.00	0
	20150417	2468	2468				2468	2468	0	0	0	0.00	0
	20150420	2468	2468				2468	2468	0	0	0	0.00	0
	20150421	2468	2468				2454	2454	-14	-14	0	0.00	0
	20150422	2454	2454				2490	2490	36	36	0	0.00	0
	20150423	2490	2490				2520	2520	30	30	0	0.00	0
	20150424	2520	2520				2564	2564	44	44	0	0.00	0
	20150427	2564	2564				2674	2674	110	110	0	0.00	0
	20150428	2674	2674				2664	2664	-10	-10	0	0.00	0
	20150429	2664	2664				2633	2633	-31	-31	0	0.00	0
	20150430	2633	2633				2623	2623	-10	-10	0	0.00	0
hc1603	20150317	2624	2624				2630	2630	6	6	0	0.00	0
	20150318	2630	2630				2622	2622	-8	-8	0	0.00	0
	20150319	2622	2622				2608	2608	-14	-14	0	0.00	0
	20150320	2608	2608				2608	2608	0	0	0	0.00	0
	20150323	2608	2608				2608	2608	0	0	0	0.00	0
	20150324	2608	2608				2608	2608	0	0	0	0.00	0
	20150325	2608	2608				2592	2592	-16	-16	0	0.00	0
	20150326	2592	2592				2592	2592	0	0	0	0.00	0
	20150327	2592	2592				2592	2592	0	0	0	0.00	0
	20150330	2592	2592				2594	2594	2	2	0	0.00	0
	20150331	2594	2594				2582	2582	-12	-12	0	0.00	0
	20150401	2582	2582				2554	2554	-28	-28	0	0.00	0
	20150402	2554	2554				2520	2520	-34	-34	0	0.00	0
	20150403	2520	2520				2520	2520	0	0	0	0.00	0
	20150407	2520	2520				2396	2396	-124	-124	0	0.00	0
	20150408	2396	2396				2396	2396	0	0	0	0.00	0
	20150409	2396	2396				2396	2396	0	0	0	0.00	0
	20150410	2396	2396				2396	2396	0	0	0	0.00	0
	20150413	2396	2396				2396	2396	0	0	0	0.00	0
	20150414	2396	2396				2442	2442	46	46	0	0.00	0
	20150415	2442	2442				2442	2442	0	0	0	0.00	0
	20150416	2442	2442				2438	2438	-4	-4	0	0.00	0
	20150417	2438	2438				2438	2438	0	0	0	0.00	0
	20150420	2438	2438				2438	2438	0	0	0	0.00	0
	20150421	2438	2438				2424	2424	-14	-14	0	0.00	0
	20150422	2424	2424				2460	2460	36	36	0	0.00	0
	20150423	2460	2460	2564	2564	2564	2564	2564	104	104	20	51.28	20
	20150424	2564	2564				2610	2610	46	46	0	0.00	20
	20150427	2610	2610				2722	2722	112	112	0	0.00	20
	20150428	2722	2722				2712	2712	-10	-10	0	0.00	20
	20150429	2712	2712				2680	2680	-32	-32	0	0.00	20
	20150430	2680	2680				2670	2670	-10	-10	0	0.00	20
hc1604	20150416	2442	2442				2438	2438	-4	-4	0	0.00	0
	20150417	2438	2438				2444	2444	6	6	0	0.00	0
	20150420	2444	2444				2408	2408	-36	-36	0	0.00	0
	20150421	2408	2408	2486	2486	2486	2486	2486	78	78	2	4.97	2
	20150422	2486	2486				2522	2522	36	36	0	0.00	2
	20150423	2522	2522	2564	2566	2564	2566	2564	44	42	6	15.39	6
	20150424	2566	2564				2610	2610	46	46	0	0.00	6
	20150427	2610	2610				2722	2722	112	112	0	0.00	6
	20150428	2722	2722				2712	2712	-10	-10	0	0.00	6
	20150429	2712	2712				2680	2680	-32	-32	0	0.00	6
	20150430	2680	2680				2670	2670	-10	-10	0	0.00	6
ni1507	20150327	102070	102070	101870	102710	100650	101080	101180	-990	-890	28860	292,013.14	14364
	20150330	101080	101180	99010	100000	96820	98430	98390	-2750	-2790	66684	656,151.76	34186
	20150331	98430	98390	98000	98200	93840	95040	95950	-3350	-2440	105600	1,013,274.91	54888
	20150401	95040	95950	93940	94130	91270	92500	92870	-3450	-3080	158952	1,476,338.49	70960
	20150402	92500	92870	92870	96600	92550	96160	94320	3290	1450	202848	1,913,386.81	80724
	20150403	96160	94320	96000	97800	95660	97300	96530	2980	2210	150282	1,450,703.29	80998
	20150407	97300	96530	97500	97980	95950	96420	96790	-110	260	75688	732,658.13	83542
	20150408	96420	96790	94500	95630	93300	93950	94450	-2840	-2340	183088	1,729,307.82	95102
	20150409	93950	94450	94450	95260	93880	94300	94500	-150	50	160974	1,521,333.54	99084
	20150410	94300	94500	94500	94970	93180	94540	94080	40	-420	137722	1,295,809.03	105628
	20150413	94540	94080	94280	95670	93700	95230	94720	1150	640	180214	1,707,095.12	112858
	20150414	95230	94720	94780	95070	92810	93100	93740	-1620	-980	199150	1,866,881.88	127690
	20150415	93100	93740	92700	95000	92640	94730	93970	990	230	220106	2,068,449.08	132258
	20150416	94730	93970	94610	95900	94260	95400	95090	1430	1120	195920	1,863,068.59	131624
	20150417	95400	95090	96280	96660	95010	95850	95900	760	810	168702	1,617,969.57	127284
	20150420	95850	95900	95980	96550	95200	95410	95910	-490	10	148104	1,420,552.79	116410
	20150421	95410	95910	95330	96800	94900	95880	95910	-30	0	140930	1,351,681.21	110552
	20150422	95880	95910	95910	96720	95750	96330	96260	420	350	123902	1,192,744.71	110516
	20150423	96330	96260	96120	96500	95600	95860	96140	-400	-120	101066	971,708.27	110646
	20150424	95860	96140	95840	97900	95700	97830	96660	1690	520	118180	1,142,342.82	113816
	20150427	97830	96660	98000	101490	97990	101490	100090	4830	3430	241904	2,421,304.81	116290
	20150428	101490	100090	102490	104530	101420	102650	103110	2560	3020	285722	2,946,180.49	111958
	20150429	102650	103110	102350	104400	100500	101020	102440	-2090	-670	317634	3,253,921.33	111334
	20150430	101020	102440	101190	106980	101160	106010	104070	3570	1630	552750	5,752,803.94	125970
ni1508	20150327	102070	102070	102710	102710	100040	101210	101270	-860	-800	742	7,514.94	534
	20150330	101210	101270	99200	105990	97010	98520	98380	-2750	-2890	796	7,831.17	952
	20150331	98520	98380	97170	98110	94100	94900	95420	-3480	-2960	2070	19,753.24	2190
	20150401	94900	95420	93840	94090	91600	92700	92910	-2720	-2510	1256	11,670.29	2406
	20150402	92700	92910	93090	96150	92500	96000	94220	3090	1310	1456	13,719.22	2008
	20150403	96000	94220	95550	97800	95500	96900	96390	2680	2170	318	3,065.45	2072
	20150407	96900	96390	97220	97580	95500	96070	96450	-320	60	1222	11,787.01	2716
	20150408	96070	96450	94410	95150	93100	93550	94280	-2900	-2170	1618	15,255.41	3076
	20150409	93550	94280	94100	94810	93560	93840	94010	-440	-270	710	6,675.38	3136
	20150410	93840	94010	94150	94490	92950	94240	93630	230	-380	512	4,794.13	3194
	20150413	94240	93630	94240	95180	93290	94830	94180	1200	550	1188	11,188.83	3648
	20150414	94830	94180	94170	94420	92400	92730	93180	-1450	-1000	1904	17,742.21	4202
	20150415	92730	93180	92200	94100	92200	93800	93470	620	290	1610	15,049.27	5288
	20150416	93800	93470	93800	95260	93350	94550	94360	1080	890	1534	14,475.34	5392
	20150417	94550	94360	95350	95610	94170	94700	94790	340	430	1794	17,006.35	5776
	20150420	94700	94790	94750	96290	94180	94260	95250	-530	460	4026	38,349.46	5724
	20150421	94260	95250	94200	95530	93900	94800	94710	-450	-540	1670	15,817.10	5874
	20150422	94800	94710	94960	95530	94840	95250	95210	540	500	1912	18,205.80	6026
	20150423	95250	95210	95270	95500	94840	94990	95200	-220	-10	1450	13,804.76	6198
	20150424	94990	95200	95130	96800	94880	96800	95790	1600	590	2740	26,246.87	6828
	20150427	96800	95790	97900	100570	96950	100570	99490	4780	3700	4124	41,032.48	6670
	20150428	100570	99490	102000	103230	100200	101380	101620	1890	2130	4506	45,792.44	6968
	20150429	101380	101620	101250	103310	99370	100000	101330	-1620	-290	3562	36,095.79	7380
	20150430	100000	101330	100350	105540	98910	104750	102710	3420	1380	3406	34,985.94	7556
ni1509	20150327	102070	102070	102500	103000	100260	101000	101420	-1070	-650	392	3,976.00	156
	20150330	101000	101420	100100	100100	97140	98730	98800	-2690	-2620	574	5,671.40	386
	20150331	98730	98800	98530	98530	94480	94940	95920	-3860	-2880	1550	14,868.35	930
	20150401	94940	95920	93840	94000	91530	92460	92990	-3460	-2930	1116	10,378.00	1394
	20150402	92460	92990	93160	96150	92390	95910	94090	2920	1100	1772	16,673.27	1632
	20150403	95910	94090	95720	97210	95450	96840	96140	2750	2050	492	4,730.40	1682
	20150407	96840	96140	96990	97600	95300	96100	96610	-40	470	1258	12,153.60	2312
	20150408	96100	96610	94800	95230	93050	93580	94000	-3030	-2610	3328	31,284.80	3436
	20150409	93580	94000	94060	94760	93400	93700	94040	-300	40	1838	17,286.04	3808
	20150410	93700	94040	93960	94480	92900	94140	93820	100	-220	1078	10,113.99	4020
	20150413	94140	93820	94500	94900	93300	94560	94110	740	290	3312	31,169.85	4370
	20150414	94560	94110	94020	94390	92320	92680	93140	-1430	-970	7562	70,434.28	7394
	20150415	92680	93140	92250	94140	92200	93790	93600	650	460	5028	47,065.26	8198
	20150416	93790	93600	93810	94580	93240	94340	93990	740	390	4902	46,075.09	8914
	20150417	94340	93990	95470	95470	93840	94220	94430	230	440	5200	49,107.83	10060
	20150420	94220	94430	94120	94770	93670	93700	94120	-730	-310	4350	40,943.41	10574
	20150421	93700	94120	93850	94920	93510	94140	94270	20	150	4148	39,103.83	9624
	20150422	94140	94270	94370	95000	94350	94860	94630	590	360	1644	15,558.09	9592
	20150423	94860	94630	94700	95160	94580	94700	94930	70	300	2640	25,063.48	10398
	20150424	94700	94930	94880	96210	94670	96190	95590	1260	660	6740	64,428.31	12750
	20150427	96190	95590	96570	100360	96430	100360	99310	4770	3720	21326	211,789.63	18366
	20150428	100360	99310	101190	102900	99800	101040	101300	1730	1990	16910	171,310.22	20692
	20150429	101040	101300	101110	103090	99060	99810	101000	-1490	-300	18452	186,372.85	23212
	20150430	99810	101000	99860	105600	99850	104490	102780	3490	1780	27204	279,629.23	29610
ni1510	20150327	102070	102070	102800	102800	99520	101970	101200	-100	-870	20	202.42	8
	20150330	101970	101200	99070	99070	96970	98650	98490	-2550	-2710	18	177.29	20
	20150331	98650	98490	95580	95580	95580	95580	95580	-2910	-2910	2	19.12	20
	20150401	95580	95580	93430	93630	93430	93480	93510	-2100	-2070	6	56.11	24
	20150402	93480	93510	94870	94870	94060	94140	94440	630	930	40	377.79	36
	20150403	94140	94440	97260	97260	97260	97260	97260	2820	2820	2	19.45	36
	20150407	97260	97260	98340	98340	96020	96020	97630	-1240	370	58	566.29	54
	20150408	96020	97630	94870	94870	93830	93830	94250	-3800	-3380	8	75.40	58
	20150409	93830	94250	95460	95460	94270	94450	94570	200	320	18	170.24	58
	20150410	94450	94570				94350	94350	-220	-220	0	0.00	58
	20150413	94350	94350	93280	94930	93280	94930	93780	580	-570	42	393.90	70
	20150414	94930	93780	89090	95990	89090	93280	93440	-500	-340	26	242.94	62
	20150415	93280	93440				93440	93440	0	0	0	0.00	62
	20150416	93440	93440				93440	93440	0	0	0	0.00	62
	20150417	93440	93440	95010	95010	93170	93800	94360	360	920	56	528.44	104
	20150420	93800	94360	93750	93750	93690	93690	93720	-670	-640	4	37.49	100
	20150421	93690	93720	93810	93810	93810	93810	93810	90	90	4	37.52	100
	20150422	93810	93810				94170	94170	360	360	0	0.00	100
	20150423	94170	94170	93890	93890	93890	93890	93890	-280	-280	2	18.78	98
	20150424	93890	93890	94410	95240	94410	95240	94770	1350	880	36	341.18	102
	20150427	95240	94770	97040	99500	97000	99500	98840	4730	4070	82	810.55	106
	20150428	99500	98840	99500	103490	99500	100470	101050	1630	2210	64	646.77	98
	20150429	100470	101050	100870	101740	99120	101520	100200	470	-850	46	460.94	102
	20150430	101520	100200	99730	104370	99730	103840	102280	3640	2080	100	1,022.84	100
ni1511	20150327	102070	102070	103500	103500	100820	101260	101690	-810	-380	20	203.39	16
	20150330	101260	101690	97150	97350	97150	97300	97260	-4390	-4430	6	58.36	14
	20150331	97300	97260	97960	97960	95000	96040	96460	-1220	-800	64	617.39	30
	20150401	96040	96460	94540	94540	92810	92850	93550	-3610	-2910	76	711.01	46
	20150402	92850	93550	94340	96310	94340	96310	95030	2760	1480	60	570.22	56
	20150403	96310	95030				96360	96360	1330	1330	0	0.00	56
	20150407	96360	96360	97640	97640	97640	97640	97640	1280	1280	2	19.53	56
	20150408	97640	97640	94770	95190	93950	94340	94490	-3300	-3150	24	226.78	56
	20150409	94340	94490	94980	94980	94720	94720	94850	230	360	4	37.94	56
	20150410	94720	94850	93710	93710	93710	93710	93710	-1140	-1140	6	56.23	54
	20150413	93710	93710	94460	94460	94460	94460	94460	750	750	8	75.57	54
	20150414	94460	94460	94210	94230	94190	94190	94210	-270	-250	6	56.53	50
	20150415	94190	94210	92740	92740	92740	92740	92740	-1470	-1470	2	18.55	50
	20150416	92740	92740	94330	95310	94330	95310	94980	2570	2240	6	56.99	50
	20150417	95310	94980	95790	95790	94500	94500	95140	-480	160	4	38.06	50
	20150420	94500	95140				94490	94490	-650	-650	0	0.00	50
	20150421	94490	94490	93330	95370	93330	94290	93950	-200	-540	28	263.07	56
	20150422	94290	93950	94340	94500	94340	94500	94400	550	450	10	94.40	56
	20150423	94500	94400	94730	94730	94440	94440	94510	40	110	8	75.61	62
	20150424	94440	94510	95060	95790	95060	95790	95250	1280	740	8	76.20	58
	20150427	95790	95250	96930	100000	96930	99900	99310	4650	4060	74	734.96	66
	20150428	99900	99310	102200	102440	99010	100030	101630	720	2320	42	426.88	64
	20150429	100030	101630	100740	101380	100550	100550	100820	-1080	-810	24	241.98	66
	20150430	100550	100820	99730	104630	99730	103920	103270	3100	2450	32	330.49	64
ni1512	20150327	102070	102070	106660	106660	100680	101000	101870	-1070	-200	12	122.25	8
	20150330	101000	101870	99170	99490	98320	99170	99310	-2700	-2560	64	635.62	72
	20150331	99170	99310	98360	98560	95280	96220	97160	-3090	-2150	92	893.89	50
	20150401	96220	97160	93660	93660	93240	93240	93460	-3920	-3700	6	56.08	50
	20150402	93240	93460	93870	96280	93740	96040	95450	2580	1990	120	1,145.48	108
	20150403	96040	95450	96180	96520	96180	96520	96220	1070	770	14	134.72	108
	20150407	96520	96220	97930	97930	96380	96380	96970	160	750	20	193.94	118
	20150408	96380	96970	95110	95910	94720	94720	95210	-2250	-1760	8	76.17	120
	20150409	94720	95210	95000	95000	94990	94990	94990	-220	-220	4	38.00	116
	20150410	94990	94990	94400	94400	94000	94000	94260	-990	-730	10	94.27	110
	20150413	94000	94260	94000	94000	94000	94000	94000	-260	-260	2	18.80	110
	20150414	94000	94000	94720	94720	91750	91750	92640	-2250	-1360	16	148.23	120
	20150415	91750	92640	92900	94200	92840	94200	93120	1560	480	10	93.12	120
	20150416	94200	93120	95000	95000	94050	94050	94520	930	1400	4	37.81	120
	20150417	94050	94520	96340	96340	93060	94470	94770	-50	250	18	170.59	122
	20150420	94470	94770				94770	94770	0	0	0	0.00	122
	20150421	94770	94770	92910	96940	92910	94200	94910	-570	140	10	94.92	124
	20150422	94200	94910	96190	96190	93530	93530	94690	-1380	-220	8	75.76	124
	20150423	93530	94690	94710	95190	94190	94950	95060	260	370	72	684.43	146
	20150424	94950	95060	94650	95600	94460	95600	94680	540	-380	14	132.56	142
	20150427	95600	94680	97390	99400	96770	99360	97640	4680	2960	92	898.31	124
	20150428	99360	97640	99560	102470	99560	100780	101510	3140	3870	268	2,720.58	270
	20150429	100780	101510	100860	101550	99600	99600	100170	-1910	-1340	210	2,103.68	244
	20150430	99600	100170	99890	104400	99890	103700	102940	3530	2770	128	1,317.71	244
ni1601	20150327	102070	102070	107800	107800	100500	101240	101360	-830	-710	120	1,216.37	96
	20150330	101240	101360	99810	99860	97890	98610	98860	-2750	-2500	276	2,728.71	140
	20150331	98610	98860	98810	99130	96120	96530	97260	-2330	-1600	154	1,497.94	192
	20150401	96530	97260	95000	95000	93160	93760	94080	-3500	-3180	192	1,806.49	198
	20150402	93760	94080	94490	96590	94280	95740	95870	1660	1790	246	2,358.57	256
	20150403	95740	95870	95570	97440	95570	97380	96360	1510	490	42	404.75	252
	20150407	97380	96360	98340	98340	96300	96460	97420	100	1060	52	506.62	278
	20150408	96460	97420	95240	95950	93330	94190	94440	-3230	-2980	316	2,984.40	422
	20150409	94190	94440	94670	95230	93190	94170	94060	-270	-380	148	1,392.13	422
	20150410	94170	94060	94400	94570	93080	94340	93700	280	-360	108	1,012.05	442
	20150413	94340	93700	94240	95350	93720	95350	94470	1650	770	310	2,928.71	556
	20150414	95350	94470	95150	95190	93110	93400	93630	-1070	-840	400	3,745.23	744
	20150415	93400	93630	93050	94860	93050	94860	94060	1230	430	232	2,182.20	750
	20150416	94860	94060	94550	94770	93810	94230	94400	170	340	502	4,739.19	1062
	20150417	94230	94400	95000	95320	93860	94190	94460	-210	60	292	2,758.45	1142
	20150420	94190	94460	94790	94790	93970	93970	94320	-490	-140	154	1,452.65	1146
	20150421	93970	94320	93950	95010	93730	94860	94270	540	-50	172	1,621.56	1166
	20150422	94860	94270	94780	95000	93760	94960	94610	690	340	222	2,100.52	1192
	20150423	94960	94610	96500	96500	94240	94570	94810	-40	200	206	1,953.13	1250
	20150424	94570	94810	94780	96100	94400	96100	95040	1290	230	454	4,314.91	1402
	20150427	96100	95040	96680	99790	96310	99790	98870	4750	3830	324	3,203.50	1476
	20150428	99790	98870	100790	103250	99290	100820	101110	1950	2240	1588	16,056.49	2426
	20150429	100820	101110	100500	102500	99190	99650	100580	-1460	-530	528	5,310.63	2512
	20150430	99650	100580	100030	105230	100020	104770	102830	4190	2250	852	8,761.24	2484
ni1602	20150327	102070	102070	111190	111190	100530	100900	101260	-1170	-810	114	1,154.41	72
	20150330	100900	101260	98730	99150	98100	98100	98710	-3160	-2550	18	177.68	78
	20150331	98100	98710	99180	99180	96000	97000	97940	-1710	-770	30	293.82	90
	20150401	97000	97940				97940	97940	0	0	0	0.00	90
	20150402	97940	97940	96600	96600	96600	96600	96600	-1340	-1340	12	115.92	80
	20150403	96600	96600	96510	96510	96510	96510	96510	-90	-90	4	38.60	82
	20150407	96510	96510	97800	97800	96600	96600	97060	90	550	12	116.48	90
	20150408	96600	97060	95300	95300	93720	94600	94040	-2460	-3020	30	282.15	94
	20150409	94600	94040				93660	93660	-380	-380	0	0.00	94
	20150410	93660	93660	94130	94130	93790	93790	94030	130	370	8	75.22	102
	20150413	93790	94030				94800	94800	770	770	0	0.00	102
	20150414	94800	94800	94220	94220	93850	93850	94120	-950	-680	8	75.30	100
	20150415	93850	94120				94550	94550	430	430	0	0.00	100
	20150416	94550	94550	94720	94960	94720	94960	94870	410	320	16	151.80	112
	20150417	94960	94870	94830	94830	94760	94760	94790	-110	-80	4	37.92	112
	20150420	94760	94790	95400	95400	94650	94700	94730	-90	-60	24	227.36	106
	20150421	94700	94730	93840	94930	93840	94060	94280	-670	-450	16	150.86	108
	20150422	94060	94280				94620	94620	340	340	0	0.00	108
	20150423	94620	94620	95100	95100	94600	94600	94750	-20	130	28	265.30	106
	20150424	94600	94750				94980	94980	230	230	0	0.00	106
	20150427	94980	94980				98810	98810	3830	3830	0	0.00	106
	20150428	98810	98810				101050	101050	2240	2240	0	0.00	106
	20150429	101050	101050				100520	100520	-530	-530	0	0.00	106
	20150430	100520	100520				100520	100520	0	0	0	0.00	106
ni1603	20150327	102070	102070	100640	102010	100290	101430	100980	-640	-1090	16	161.58	12
	20150330	101430	100980	99230	100620	97330	99740	98890	-1240	-2090	60	593.40	54
	20150331	99740	98890	96100	100270	96100	97100	98280	-1790	-610	48	471.75	76
	20150401	97100	98280				95500	95500	-2780	-2780	0	0.00	76
	20150402	95500	95500	97160	97450	96850	97300	97200	1800	1700	50	486.02	102
	20150403	97300	97200	97040	97890	96670	97890	96990	690	-210	28	271.58	102
	20150407	97890	96990	97970	98310	96660	96660	97590	-330	600	42	409.91	124
	20150408	96660	97590	95600	95600	93980	94610	94870	-2980	-2720	58	550.30	154
	20150409	94610	94870	95070	95600	94330	94670	94890	-200	20	20	189.78	164
	20150410	94670	94890	95000	95000	93840	94550	94350	-340	-540	18	169.83	174
	20150413	94550	94350	94920	95670	93990	95670	94700	1320	350	16	151.53	178
	20150414	95670	94700	95220	95220	93420	93420	94020	-1280	-680	96	902.63	212
	20150415	93420	94020	93500	94490	93500	94280	94090	260	70	6	56.45	212
	20150416	94280	94090	95420	95550	95030	95030	95290	940	1200	10	95.29	222
	20150417	95030	95290	95630	95630	94580	95090	95140	-200	-150	16	152.23	234
	20150420	95090	95140	95270	95560	93510	94280	94490	-860	-650	88	831.57	270
	20150421	94280	94490	94290	95000	94290	94320	94630	-170	140	42	397.47	292
	20150422	94320	94630	94630	95000	94430	94900	94690	270	60	58	549.20	314
	20150423	94900	94690	95000	95370	94500	94530	94720	-160	30	142	1,345.09	412
	20150424	94530	94720	94760	96000	94760	96000	95220	1280	500	84	799.86	442
	20150427	96000	95220	96910	99980	96800	99970	98390	4750	3170	88	865.89	440
	20150428	99970	98390	101390	101390	100100	100100	100260	1710	1870	44	441.15	434
	20150429	100100	100260	100940	102090	99690	99690	100550	-570	290	60	603.32	474
	20150430	99690	100550	101900	104250	101900	103900	103430	3350	2880	56	579.22	460
ni1604	20150416	94090	94090	95060	95060	95060	95060	95060	970	970	2	19.01	2
	20150417	95060	95060	95590	95590	95540	95540	95560	480	500	8	76.45	10
	20150420	95540	95560	95220	95220	94800	94800	95020	-760	-540	12	114.02	22
	20150421	94800	95020				95160	95160	140	140	0	0.00	22
	20150422	95160	95160	96960	96960	95350	95380	96610	220	1450	78	753.59	82
	20150423	95380	96610	94680	94680	94680	94680	94680	-1930	-1930	4	37.87	86
	20150424	94680	94680	95460	95460	95460	95460	95460	780	780	2	19.09	88
	20150427	95460	95460	99540	99540	99540	99540	99540	4080	4080	2	19.91	86
	20150428	99540	99540				101430	101430	1890	1890	0	0.00	86
	20150429	101430	101430	101560	101560	100200	100200	100570	-1230	-860	10	100.57	88
	20150430	100200	100570	102020	102020	102020	102020	102020	1450	1450	4	40.81	92
pb1501	20150105	12070	12300	12375	12375	12275	12315	12295	15	-5	1070	6,579.08	4790
	20150106	12315	12295	12205	12320	12180	12320	12250	25	-45	830	5,083.78	4220
	20150107	12320	12250	12270	12350	12270	12340	12315	90	65	470	2,895.10	4130
	20150108	12340	12315	12280	12330	12280	12310	12310	-5	-5	430	2,647.53	4120
	20150109	12310	12310	12310	12360	12310	12360	12340	50	30	540	3,332.93	4080
	20150112	12360	12340	12295	12310	12215	12215	12285	-125	-55	360	2,211.40	3920
	20150113	12215	12285	12250	12250	12200	12200	12220	-85	-65	380	2,322.35	3550
	20150114	12200	12220	12000	12010	11850	11850	11945	-370	-275	930	5,555.20	2860
	20150115	11850	11945	11970	12120	11970	12105	12055	160	110	440	2,652.73	2850
pb1502	20150105	12380	12375	12330	12500	12315	12395	12385	20	10	4384	27,154.03	14744
	20150106	12395	12385	12205	12600	12115	12395	12285	10	-100	5534	34,004.76	13340
	20150107	12395	12285	12390	12465	12305	12385	12390	100	105	4278	26,511.55	11324
	20150108	12385	12390	12365	12460	12340	12405	12395	15	5	2630	16,302.18	10368
	20150109	12405	12395	12505	12535	12370	12415	12425	20	30	1734	10,773.04	9880
	20150112	12415	12425	12350	12450	12175	12325	12360	-100	-65	1430	8,838.28	9128
	20150113	12325	12360	12170	12305	12170	12185	12250	-175	-110	1534	9,396.60	8652
	20150114	12185	12250	12175	12175	11830	11850	11960	-400	-290	3808	22,780.58	6700
	20150115	11850	11960	11860	12185	11860	12170	12090	210	130	1124	6,794.75	6242
	20150116	12170	12090	12265	12475	12210	12220	12335	130	245	1414	8,721.75	5660
	20150119	12220	12335	12280	12560	12280	12475	12430	140	95	690	4,289.39	5246
	20150120	12475	12430	12480	12490	12390	12460	12435	30	5	808	5,024.95	4594
	20150121	12460	12435	12540	12570	12485	12540	12520	105	85	716	4,482.92	3992
	20150122	12540	12520	12480	12740	12480	12645	12625	125	105	228	1,439.71	3810
	20150123	12645	12625	12630	12630	12470	12485	12505	-140	-120	552	3,452.19	3362
	20150126	12485	12505	12475	12475	12400	12470	12430	-35	-75	312	1,939.65	3194
	20150127	12470	12430	12600	12645	12465	12540	12565	110	135	206	1,294.40	3092
	20150128	12540	12565	12510	12550	12500	12550	12525	-15	-40	482	3,018.54	2990
	20150129	12550	12525	12595	12655	12460	12590	12595	65	70	660	4,157.51	3018
	20150130	12590	12595	12535	12560	12480	12490	12510	-105	-85	272	1,702.00	2790
	20150202	12490	12510	12600	12605	12580	12600	12590	90	80	450	2,833.58	2740
	20150203	12600	12590	12620	12670	12620	12670	12635	80	45	360	2,274.68	2590
	20150204	12670	12635	12670	12670	12550	12615	12590	-20	-45	300	1,888.93	2350
	20150205	12615	12590	12580	12580	12560	12560	12570	-30	-20	190	1,194.43	2350
	20150206	12560	12570	12595	12620	12595	12620	12605	50	35	160	1,008.53	2330
	20150209	12620	12605	12590	12600	12580	12600	12595	-5	-10	100	629.75	2360
	20150210	12600	12595	12600	12600	12575	12575	12595	-20	0	50	314.88	2370
pb1503	20150105	12420	12410	12410	12535	12350	12405	12400	-5	-10	4856	30,114.33	18958
	20150106	12405	12400	12290	12450	12140	12410	12295	10	-105	11062	68,017.80	20230
	20150107	12410	12295	12395	12485	12305	12380	12410	85	115	11656	72,325.87	22438
	20150108	12380	12410	12380	12475	12330	12400	12395	-10	-15	8806	54,595.25	23146
	20150109	12400	12395	12455	12520	12350	12400	12420	5	25	6522	40,513.51	24212
	20150112	12400	12420	12350	12455	12295	12335	12350	-85	-70	13684	84,501.94	24430
	20150113	12335	12350	12200	12320	12160	12170	12245	-180	-105	12092	74,034.81	25580
	20150114	12170	12245	12000	12145	11770	11770	11955	-475	-290	27796	166,168.29	27450
	20150115	11770	11955	11830	12170	11810	12140	12005	185	50	23288	139,835.35	24920
	20150116	12140	12005	12200	12395	12145	12175	12265	170	260	20170	123,707.76	21698
	20150119	12175	12265	12170	12500	12155	12500	12380	235	115	14680	90,900.24	20624
	20150120	12500	12380	12400	12480	12345	12425	12405	45	25	10686	66,293.00	19264
	20150121	12425	12405	12555	12555	12445	12515	12495	110	90	8622	53,876.99	18568
	20150122	12515	12495	12445	12695	12445	12615	12600	120	105	9198	57,954.93	17216
	20150123	12615	12600	12630	12660	12410	12500	12525	-100	-75	8488	53,159.60	16690
	20150126	12500	12525	12455	12495	12355	12460	12410	-65	-115	8034	49,868.36	16038
	20150127	12460	12410	12510	12580	12485	12485	12535	75	125	5816	36,462.77	14378
	20150128	12485	12535	12460	12565	12445	12560	12500	25	-35	4306	26,921.91	13344
	20150129	12560	12500	12555	12595	12500	12515	12535	15	35	3230	20,250.30	12860
	20150130	12515	12535	12470	12530	12390	12415	12465	-120	-70	5236	32,640.76	11662
	20150202	12415	12465	12475	12585	12435	12565	12525	100	60	3704	23,200.30	10088
	20150203	12565	12525	12555	12620	12510	12585	12565	60	40	2630	16,525.71	8926
	20150204	12585	12565	12150	12665	12150	12540	12600	-25	35	1930	12,162.90	8014
	20150205	12540	12600	12570	12630	12545	12565	12575	-35	-25	1502	9,446.43	7420
	20150206	12565	12575	12600	12645	12595	12640	12620	65	45	1708	10,780.71	6596
	20150209	12640	12620	12630	12655	12570	12570	12590	-50	-30	820	5,163.16	6130
	20150210	12570	12590	12580	12625	12575	12575	12585	-15	-5	576	3,624.63	5888
	20150211	12575	12585	12550	12575	12420	12495	12490	-90	-95	924	5,771.21	5380
	20150212	12495	12490	12495	12495	12310	12370	12355	-120	-135	826	5,104.00	4994
	20150213	12370	12355	12455	12635	12420	12635	12550	280	195	574	3,601.86	4788
	20150216	12635	12550	12560	12570	12540	12570	12550	20	0	254	1,594.40	4630
	20150217	12570	12550	12540	12575	12510	12555	12540	5	-10	478	2,998.07	4390
	20150225	12555	12540	12325	12370	12320	12325	12330	-215	-210	746	4,600.22	4284
	20150226	12325	12330	12320	12320	12180	12295	12275	-35	-55	1534	9,416.90	3352
	20150227	12295	12275	12310	12310	12100	12200	12280	-75	5	698	4,287.41	2760
	20150302	12200	12280	12235	12235	12100	12180	12160	-100	-120	670	4,073.78	2360
	20150303	12180	12160	12165	12180	12150	12170	12170	10	10	400	2,434.25	1970
	20150304	12170	12170	12185	12250	12170	12250	12195	80	25	650	3,964.35	1460
	20150305	12250	12195	12230	12240	12220	12220	12235	25	40	180	1,101.28	1380
	20150306	12220	12235	12250	12285	12245	12285	12260	50	25	270	1,655.50	1170
	20150309	12285	12260	12315	12315	12300	12300	12305	40	45	190	1,169.15	1000
	20150310	12300	12305	12340	12360	12300	12325	12330	20	25	640	3,946.05	880
	20150311	12325	12330	12260	12290	12245	12290	12255	-40	-75	220	1,348.43	820
	20150312	12290	12255	12300	12300	12300	12300	12300	45	45	40	246.00	820
	20150313	12300	12300	12400	12400	12400	12400	12400	100	100	110	682.00	780
	20150316	12400	12400	12200	12200	12200	12200	12200	-200	-200	10	61.00	780
pb1504	20150105	12445	12450	12460	12550	12405	12450	12430	0	-20	1078	6,701.17	3470
	20150106	12450	12430	12275	12435	12175	12425	12320	-5	-110	966	5,952.79	3816
	20150107	12425	12320	12440	12510	12335	12400	12440	80	120	778	4,839.34	3966
	20150108	12400	12440	12450	12495	12370	12435	12420	-5	-20	728	4,521.29	4398
	20150109	12435	12420	12500	12530	12385	12430	12440	10	20	974	6,058.69	4558
	20150112	12430	12440	12350	12470	12330	12370	12375	-70	-65	1008	6,237.34	4972
	20150113	12370	12375	12300	12345	12185	12190	12265	-185	-110	2150	13,186.77	5978
	20150114	12190	12265	12020	12150	11800	11800	11985	-465	-280	4850	29,071.22	6788
	20150115	11800	11985	11840	12255	11840	12145	12035	160	50	2462	14,820.42	7044
	20150116	12145	12035	12250	12375	12160	12180	12265	145	230	3288	20,165.43	7488
	20150119	12180	12265	12165	12495	12165	12485	12370	220	105	2870	17,756.21	7502
	20150120	12485	12370	12405	12465	12345	12415	12400	45	30	1960	12,155.82	7906
	20150121	12415	12400	12520	12540	12435	12510	12485	110	85	2692	16,811.46	7960
	20150122	12510	12485	12470	12690	12450	12595	12595	110	110	2334	14,703.59	8108
	20150123	12595	12595	12605	12640	12300	12470	12475	-125	-120	3704	23,112.22	8614
	20150126	12470	12475	12450	12450	12320	12400	12365	-75	-110	3280	20,283.24	9474
	20150127	12400	12365	12470	12515	12425	12445	12480	80	115	3192	19,922.61	10570
	20150128	12445	12480	12430	12500	12425	12500	12455	20	-25	2066	12,869.01	11598
	20150129	12500	12455	12505	12520	12450	12455	12475	0	20	1296	8,085.33	11916
	20150130	12455	12475	12405	12460	12335	12350	12405	-125	-70	2224	13,797.61	12806
	20150202	12350	12405	12410	12500	12380	12490	12465	85	60	2680	16,705.48	13338
	20150203	12490	12465	12485	12550	12435	12515	12500	50	35	3666	22,913.72	14372
	20150204	12515	12500	12535	12620	12475	12480	12545	-20	45	4674	29,323.27	15212
	20150205	12480	12545	12520	12580	12485	12505	12520	-40	-25	2978	18,646.58	15758
	20150206	12505	12520	12510	12590	12505	12575	12555	55	35	3282	20,605.11	16506
	20150209	12575	12555	12580	12625	12510	12515	12540	-40	-15	3282	20,585.03	16706
	20150210	12515	12540	12550	12570	12510	12520	12530	-20	-10	1662	10,416.05	16510
	20150211	12520	12530	12500	12510	12370	12435	12425	-95	-105	4080	25,349.90	16768
	20150212	12435	12425	12435	12450	12225	12310	12305	-115	-120	9564	58,850.84	17454
	20150213	12310	12305	12370	12580	12355	12570	12465	265	160	6130	38,210.15	15630
	20150216	12570	12465	12575	12605	12475	12525	12510	60	45	1702	10,648.70	15252
	20150217	12525	12510	12520	12625	12475	12510	12520	0	10	1634	10,231.63	14864
	20150225	12510	12520	12195	12340	12195	12290	12305	-230	-215	2286	14,065.08	15042
	20150226	12290	12305	12285	12285	12220	12260	12255	-45	-50	4182	25,631.75	15554
	20150227	12260	12255	12275	12320	12225	12245	12260	-10	5	2236	13,710.68	15172
	20150302	12245	12260	12215	12230	12090	12200	12150	-60	-110	3966	24,097.98	14198
	20150303	12200	12150	12155	12205	12150	12165	12170	15	20	2258	13,745.47	12990
	20150304	12165	12170	12150	12255	12150	12240	12195	70	25	2720	16,589.79	11918
	20150305	12240	12195	12240	12305	12200	12240	12245	45	50	1690	10,350.75	11176
	20150306	12240	12245	12255	12300	12250	12295	12280	50	35	2290	14,065.00	10144
	20150309	12295	12280	12300	12320	12210	12305	12300	25	20	1978	12,164.84	9202
	20150310	12305	12300	12300	12370	12290	12320	12345	20	45	2630	16,235.29	8224
	20150311	12320	12345	12275	12315	12215	12275	12290	-70	-55	1736	10,671.10	7432
	20150312	12275	12290	12300	12400	12300	12400	12325	110	35	492	3,032.46	7142
	20150313	12400	12325	12430	12615	12345	12365	12370	40	45	788	4,875.09	6594
	20150316	12365	12370	12305	12330	12200	12300	12270	-70	-100	670	4,111.93	6272
	20150317	12300	12270	12290	12300	12185	12185	12220	-85	-50	546	3,337.01	6042
	20150318	12185	12220	12150	12185	12090	12090	12140	-130	-80	710	4,310.03	5606
	20150319	12090	12140	12085	12170	12065	12165	12115	25	-25	488	2,957.25	5374
	20150320	12165	12115	12085	12170	12085	12130	12120	15	5	982	5,953.33	4576
	20150323	12130	12120	12195	12370	12195	12325	12310	205	190	764	4,703.02	4038
	20150324	12325	12310	12410	12515	12405	12495	12445	185	135	1034	6,435.06	3688
	20150325	12495	12445	12515	12515	12390	12485	12430	40	-15	644	4,003.81	3198
	20150326	12485	12430	12515	12515	12355	12490	12470	60	40	878	5,475.65	2772
	20150327	12490	12470	12500	12585	12385	12430	12430	-40	-40	236	1,467.00	2652
	20150330	12430	12430	12410	12490	12390	12445	12425	15	-5	446	2,771.12	2216
	20150331	12445	12425	12380	12470	12220	12400	12410	-25	-15	416	2,581.50	1860
	20150401	12400	12410	12390	12430	12390	12395	12400	-15	-10	380	2,356.48	1960
	20150402	12395	12400	12500	12500	12400	12450	12440	50	40	420	2,613.08	1850
	20150403	12450	12440	12500	12600	12490	12600	12540	160	100	440	2,759.13	2030
	20150407	12600	12540	12650	12650	12600	12650	12630	110	90	170	1,073.65	2070
	20150408	12650	12630	12515	12705	12515	12625	12615	-5	-15	560	3,532.35	2060
	20150409	12625	12615	12715	12740	12710	12710	12725	95	110	230	1,463.43	2100
	20150410	12710	12725	12815	13230	12815	13230	13000	505	275	470	3,055.40	2250
	20150413	13230	13000	12300	13320	12300	13240	13100	240	100	140	917.30	2320
	20150414	13240	13100	13010	13010	12900	12900	12945	-200	-155	230	1,489.08	2330
	20150415	12900	12945	12830	13220	12830	13220	13020	275	75	210	1,367.50	2420
pb1505	20150105	12420	12415	12505	12505	12450	12480	12475	65	60	86	536.46	518
	20150106	12480	12475	12315	12450	12250	12450	12340	-25	-135	74	456.76	520
	20150107	12450	12340	12525	12550	12365	12465	12455	125	115	358	2,230.22	530
	20150108	12465	12455	12445	12465	12400	12455	12425	0	-30	120	745.60	592
	20150109	12455	12425	12510	12545	12470	12505	12485	80	60	26	162.33	602
	20150112	12505	12485	12410	12440	12400	12405	12410	-80	-75	80	496.45	640
	20150113	12405	12410	12325	12390	12230	12230	12325	-180	-85	260	1,602.49	736
	20150114	12230	12325	12205	12205	11890	11900	11985	-425	-340	920	5,514.45	1228
	20150115	11900	11985	12020	12200	11950	12200	12055	215	70	814	4,908.25	1380
	20150116	12200	12055	12255	12405	12175	12190	12265	135	210	754	4,624.02	1614
	20150119	12190	12265	12150	12475	12150	12435	12390	170	125	522	3,234.98	1616
	20150120	12435	12390	12450	12450	12355	12435	12410	45	20	362	2,246.23	1632
	20150121	12435	12410	12500	12535	12445	12535	12490	125	80	378	2,361.01	1768
	20150122	12535	12490	12480	12850	12450	12630	12625	140	135	532	3,359.07	1880
	20150123	12630	12625	12605	12605	12390	12490	12475	-135	-150	450	2,806.88	2048
	20150126	12490	12475	12400	12445	12320	12410	12365	-65	-110	534	3,302.26	2176
	20150127	12410	12365	12465	12550	12430	12440	12480	75	115	412	2,570.91	2268
	20150128	12440	12480	12440	12500	12440	12500	12460	20	-20	372	2,318.11	2458
	20150129	12500	12460	12490	12495	12445	12460	12465	0	5	200	1,246.72	2554
	20150130	12460	12465	12420	12440	12330	12345	12405	-120	-60	578	3,585.87	2776
	20150202	12345	12405	12425	12500	12390	12490	12475	85	70	442	2,757.07	2904
	20150203	12490	12475	12475	12535	12435	12500	12500	25	25	186	1,162.86	2896
	20150204	12500	12500	12645	12645	12480	12480	12540	-20	40	658	4,126.51	3198
	20150205	12480	12540	12490	12585	12480	12500	12520	-40	-20	684	4,283.44	3442
	20150206	12500	12520	12550	12575	12520	12565	12550	45	30	260	1,631.55	3504
	20150209	12565	12550	12560	12560	12510	12515	12525	-35	-25	284	1,778.63	3634
	20150210	12515	12525	12530	12590	12500	12505	12510	-20	-15	290	1,814.61	3734
	20150211	12505	12510	12475	12475	12350	12425	12395	-85	-115	750	4,648.51	4070
	20150212	12425	12395	12430	12430	12225	12315	12265	-80	-130	2316	14,207.22	5266
	20150213	12315	12265	12385	12530	12360	12515	12435	250	170	1472	9,154.89	5286
	20150216	12515	12435	12510	12510	12455	12490	12475	55	40	454	2,832.15	5412
	20150217	12490	12475	12470	12500	12455	12480	12475	5	0	780	4,866.17	5586
	20150225	12480	12475	12240	12305	12190	12270	12275	-205	-200	1482	9,096.35	6176
	20150226	12270	12275	12280	12280	12200	12240	12230	-35	-45	3422	20,931.06	8004
	20150227	12240	12230	12300	12300	12210	12240	12245	10	15	2078	12,724.20	8502
	20150302	12240	12245	12205	12220	12070	12175	12135	-70	-110	6436	39,054.28	11000
	20150303	12175	12135	12135	12195	12125	12160	12150	25	15	3476	21,124.64	12420
	20150304	12160	12150	12170	12220	12135	12205	12175	55	25	3740	22,768.05	13826
	20150305	12205	12175	12215	12280	12140	12205	12215	30	40	4472	27,313.90	14192
	20150306	12205	12215	12240	12285	12220	12245	12245	30	30	4162	25,482.09	14904
	20150309	12245	12245	12265	12350	12100	12240	12230	-5	-15	4178	25,549.35	15952
	20150310	12240	12230	12245	12305	12235	12275	12275	45	45	3154	19,361.41	16794
	20150311	12275	12275	12230	12250	12135	12220	12210	-55	-65	3036	18,540.28	17816
	20150312	12220	12210	12240	12370	12225	12370	12270	160	60	1770	10,861.29	17854
	20150313	12370	12270	12355	12370	12285	12350	12330	80	60	3160	19,484.58	16774
	20150316	12350	12330	12300	12300	12160	12280	12245	-50	-85	4820	29,514.17	16552
	20150317	12280	12245	12260	12280	12165	12165	12210	-80	-35	3610	22,040.37	16180
	20150318	12165	12210	12115	12185	12035	12085	12130	-125	-80	3628	22,008.66	15682
	20150319	12085	12130	12065	12165	11995	12150	12090	20	-40	4312	26,070.90	15688
	20150320	12150	12090	12135	12155	12070	12070	12110	-20	20	3042	18,421.31	15674
	20150323	12070	12110	12165	12350	12140	12335	12275	225	165	5790	35,545.20	14806
	20150324	12335	12275	12400	12570	12355	12480	12440	205	165	6344	39,470.71	13274
	20150325	12480	12440	12490	12550	12390	12480	12445	40	5	3550	22,092.74	12990
	20150326	12480	12445	12495	12540	12440	12495	12475	50	30	2482	15,487.43	12442
	20150327	12495	12475	12500	12505	12385	12425	12435	-50	-40	2142	13,321.40	11914
	20150330	12425	12435	12435	12500	12375	12415	12440	-20	5	2634	16,388.39	10370
	20150331	12415	12440	12420	12470	12365	12385	12415	-55	-25	2692	16,711.94	9322
	20150401	12385	12415	12370	12480	12270	12450	12385	35	-30	2550	15,792.44	8592
	20150402	12450	12385	12435	12570	12390	12520	12495	135	110	2938	18,357.16	7856
	20150403	12520	12495	12530	12680	12500	12680	12590	185	95	2474	15,579.64	7052
	20150407	12680	12590	12670	12740	12620	12720	12690	130	100	1546	9,811.28	6386
	20150408	12720	12690	12755	12800	12650	12710	12715	20	25	2118	13,470.23	5784
	20150409	12710	12715	12725	12815	12705	12790	12770	75	55	1856	11,855.10	5296
	20150410	12790	12770	12845	13280	12810	13280	13020	510	250	2382	15,511.30	4804
	20150413	13280	13020	13450	13450	13185	13295	13325	275	305	2224	14,821.99	3962
	20150414	13295	13325	13300	13340	12845	12935	13040	-390	-285	1286	8,385.77	3598
	20150415	12935	13040	13000	13185	12995	13175	13095	135	55	464	3,038.58	3452
	20150416	13175	13095	13235	13310	13140	13255	13230	160	135	630	4,168.82	3366
	20150417	13255	13230	13440	13695	13365	13590	13565	360	335	1196	8,112.21	2924
	20150420	13590	13565	13595	13685	13440	13580	13570	15	5	282	1,913.43	2798
	20150421	13580	13570	13625	13625	13485	13485	13510	-85	-60	446	3,013.04	2604
	20150422	13485	13510	13480	13750	13480	13720	13610	210	100	498	3,389.39	2556
	20150423	13720	13610	13735	13735	13410	13490	13570	-120	-40	552	3,746.29	2314
	20150424	13490	13570	13490	13560	13375	13480	13430	-90	-140	314	2,108.74	2204
	20150427	13480	13430	13660	13845	13610	13750	13740	320	310	454	3,119.05	1982
	20150428	13750	13740	13800	13970	13655	13710	13730	-30	-10	182	1,249.50	1870
	20150429	13710	13730	13725	13725	13650	13700	13675	-30	-55	210	1,436.06	1776
	20150430	13700	13675	13675	13970	13675	13750	13750	75	75	454	3,122.34	1560
pb1506	20150105	12540	12495	12525	12545	12525	12545	12530	50	35	6	37.60	364
	20150106	12545	12530	12440	12445	12440	12445	12440	-85	-90	6	37.33	368
	20150107	12445	12440	12520	12590	12450	12590	12485	150	45	32	199.76	386
	20150108	12590	12485	12485	12535	12485	12520	12525	35	40	54	338.19	376
	20150109	12520	12525	12525	12595	12520	12520	12550	-5	25	26	163.18	374
	20150112	12520	12550	12465	12465	12445	12445	12455	-105	-95	4	24.91	374
	20150113	12445	12455	12350	12410	12290	12290	12360	-165	-95	202	1,248.53	414
	20150114	12290	12360	12180	12275	11945	11965	12010	-395	-350	276	1,657.54	458
	20150115	11965	12010	12000	12200	12000	12165	12050	155	40	230	1,385.92	476
	20150116	12165	12050	12435	12435	12135	12245	12275	195	225	98	601.68	486
	20150119	12245	12275				12390	12390	115	115	0	0.00	486
	20150120	12390	12390				12420	12420	30	30	0	0.00	486
	20150121	12420	12420	12500	12505	12495	12505	12500	85	80	24	150.05	478
	20150122	12505	12500	12450	12745	12450	12650	12640	150	140	70	442.51	474
	20150123	12650	12640	12615	12615	12450	12560	12555	-80	-85	48	301.35	470
	20150126	12560	12555	12500	12500	12385	12390	12400	-165	-155	60	372.08	470
	20150127	12390	12400	12505	12505	12505	12505	12505	105	105	40	250.10	458
	20150128	12505	12505	12420	12495	12420	12465	12465	-40	-40	274	1,708.28	504
	20150129	12465	12465	12480	12480	12460	12470	12465	5	0	144	897.76	530
	20150130	12470	12465	12445	12445	12375	12375	12435	-90	-30	80	497.57	562
	20150202	12375	12435	12490	12520	12490	12510	12495	75	60	92	574.86	634
	20150203	12510	12495	12490	12490	12490	12490	12490	-5	-5	2	12.49	634
	20150204	12490	12490	12505	12505	12505	12505	12505	15	15	2	12.51	634
	20150205	12505	12505	12540	12540	12515	12520	12520	15	15	54	338.16	676
	20150206	12520	12520	12550	12570	12520	12565	12550	45	30	282	1,769.70	808
	20150209	12565	12550	12540	12550	12505	12505	12530	-45	-20	140	877.20	888
	20150210	12505	12530	12540	12540	12525	12540	12535	10	5	94	589.15	944
	20150211	12540	12535	12500	12515	12390	12420	12440	-115	-95	188	1,169.57	1030
	20150212	12420	12440	12370	12370	12260	12325	12285	-115	-155	276	1,695.73	1236
	20150213	12325	12285	12360	12550	12360	12500	12455	215	170	436	2,715.38	1384
	20150216	12500	12455	12510	12510	12480	12510	12500	55	45	116	725.25	1428
	20150217	12510	12500	12470	12525	12470	12525	12510	25	10	44	275.30	1466
	20150225	12525	12510	12290	12410	12270	12275	12285	-235	-225	356	2,187.54	1710
	20150226	12275	12285	12265	12265	12210	12230	12230	-55	-55	898	5,493.32	2344
	20150227	12230	12230	12245	12300	12225	12240	12240	10	10	616	3,771.44	2682
	20150302	12240	12240	12225	12225	12100	12190	12145	-50	-95	986	5,987.87	3074
	20150303	12190	12145	12170	12195	12145	12185	12165	40	20	456	2,774.72	3356
	20150304	12185	12165	12160	12230	12160	12230	12190	65	25	274	1,670.08	3422
	20150305	12230	12190	12250	12250	12185	12210	12230	20	40	354	2,164.79	3300
	20150306	12210	12230	12260	12270	12230	12245	12250	15	20	434	2,658.71	3440
	20150309	12245	12250	12250	12270	12150	12250	12230	0	-20	598	3,657.59	3536
	20150310	12250	12230	12255	12300	12255	12270	12275	40	45	1138	6,985.99	4122
	20150311	12270	12275	12175	12240	12155	12210	12210	-65	-65	452	2,759.61	4218
	20150312	12210	12210	12225	12345	12220	12345	12255	135	45	536	3,284.83	4482
	20150313	12345	12255	12355	12355	12270	12340	12310	85	55	1336	8,224.55	4960
	20150316	12340	12310	12290	12290	12170	12275	12230	-35	-80	1444	8,831.51	5504
	20150317	12275	12230	12245	12265	12165	12165	12190	-65	-40	1222	7,450.09	5956
	20150318	12165	12190	12150	12165	12050	12085	12115	-105	-75	1918	11,620.89	6948
	20150319	12085	12115	12075	12145	12000	12140	12095	25	-20	2022	12,229.75	7716
	20150320	12140	12095	12130	12130	12030	12030	12090	-65	-5	1860	11,248.29	8438
	20150323	12030	12090	12280	12330	12125	12330	12250	240	160	3374	20,667.16	8208
	20150324	12330	12250	12405	12500	12355	12470	12420	220	170	3302	20,511.42	8742
	20150325	12470	12420	12485	12530	12370	12485	12435	65	15	2812	17,490.51	9442
	20150326	12485	12435	12500	12530	12420	12485	12465	50	30	1882	11,732.23	9926
	20150327	12485	12465	12495	12500	12375	12410	12420	-55	-45	2080	12,917.61	10240
	20150330	12410	12420	12420	12485	12375	12405	12415	-15	-5	1792	11,126.25	10804
	20150331	12405	12415	12430	12450	12350	12360	12395	-55	-20	1552	9,619.77	11282
	20150401	12360	12395	12340	12450	12275	12440	12360	45	-35	1858	11,485.32	11734
	20150402	12440	12360	12390	12700	12370	12500	12470	140	110	2936	18,311.01	12610
	20150403	12500	12470	12500	12660	12470	12660	12565	190	95	3832	24,082.88	13422
	20150407	12660	12565	12700	12730	12600	12690	12665	125	100	2112	13,377.49	13736
	20150408	12690	12665	12725	12840	12625	12680	12710	15	45	3878	24,650.04	14410
	20150409	12680	12710	12715	12820	12680	12810	12760	100	50	6694	42,720.50	16172
	20150410	12810	12760	12860	13270	12830	13270	13030	510	270	13692	89,214.43	18306
	20150413	13270	13030	13450	13500	13210	13320	13365	290	335	23234	155,272.81	20444
	20150414	13320	13365	13305	13355	12870	12925	13075	-440	-290	19678	128,657.89	18842
	20150415	12925	13075	13000	13260	12935	13180	13100	105	25	11186	73,276.33	17790
	20150416	13180	13100	13150	13365	13130	13290	13250	190	150	15764	104,442.91	17238
	20150417	13290	13250	13410	13720	13385	13540	13560	290	310	22928	155,498.71	17714
	20150420	13540	13560	13510	13660	13410	13565	13555	5	-5	14726	99,834.95	16558
	20150421	13565	13555	13520	13645	13445	13475	13530	-80	-25	9088	61,493.08	15672
	20150422	13475	13530	13485	13750	13480	13725	13630	195	100	10376	70,721.57	16494
	20150423	13725	13630	13720	13740	13210	13490	13595	-140	-35	13940	94,777.26	16980
	20150424	13490	13595	13490	13545	13355	13495	13460	-100	-135	8382	56,429.96	16286
	20150427	13495	13460	13620	13840	13595	13755	13720	295	260	13520	92,774.21	16370
	20150428	13755	13720	13780	13885	13680	13740	13790	20	70	8828	60,885.01	15412
	20150429	13740	13790	13800	13820	13650	13730	13725	-60	-65	5294	36,332.53	15020
	20150430	13730	13725	13785	13865	13745	13790	13795	65	70	5512	38,025.95	13776
pb1507	20150105	12610	12595				12595	12595	0	0	0	0.00	34
	20150106	12595	12595	12555	12605	12555	12605	12570	10	-25	8	50.29	32
	20150107	12605	12570				12570	12570	0	0	0	0.00	32
	20150108	12570	12570	12580	12580	12580	12580	12580	10	10	2	12.58	32
	20150109	12580	12580	12575	12575	12575	12575	12575	-5	-5	4	25.15	32
	20150112	12575	12575				12575	12575	0	0	0	0.00	32
	20150113	12575	12575				12390	12390	-185	-185	0	0.00	32
	20150114	12390	12390	12045	12045	12020	12020	12025	-370	-365	8	48.11	38
	20150115	12020	12025	12070	12215	12070	12210	12170	185	145	12	73.03	36
	20150116	12210	12170	12205	12275	12205	12240	12230	70	60	10	61.16	36
	20150119	12240	12230	12250	12350	12250	12350	12300	120	70	4	24.60	36
	20150120	12350	12300	12520	12520	12520	12520	12520	220	220	2	12.52	34
	20150121	12520	12520				12520	12520	0	0	0	0.00	34
	20150122	12520	12520	12730	12750	12695	12735	12730	215	210	18	114.57	30
	20150123	12735	12730	12645	12645	12480	12480	12545	-250	-185	6	37.64	34
	20150126	12480	12545				12545	12545	0	0	0	0.00	34
	20150127	12545	12545	12510	12510	12470	12470	12505	-75	-40	20	125.06	26
	20150128	12470	12505				12505	12505	0	0	0	0.00	26
	20150129	12505	12505				12505	12505	0	0	0	0.00	26
	20150130	12505	12505				12465	12465	-40	-40	0	0.00	26
	20150202	12465	12465				12465	12465	0	0	0	0.00	26
	20150203	12465	12465				12465	12465	0	0	0	0.00	26
	20150204	12465	12465				12465	12465	0	0	0	0.00	26
	20150205	12465	12465				12465	12465	0	0	0	0.00	26
	20150206	12465	12465				12465	12465	0	0	0	0.00	26
	20150209	12465	12465				12465	12465	0	0	0	0.00	26
	20150210	12465	12465				12465	12465	0	0	0	0.00	26
	20150211	12465	12465				12465	12465	0	0	0	0.00	26
	20150212	12465	12465				12465	12465	0	0	0	0.00	26
	20150213	12465	12465	12580	12580	12580	12580	12580	115	115	2	12.58	26
	20150216	12580	12580				12565	12565	-15	-15	0	0.00	26
	20150217	12565	12565	12475	12475	12475	12475	12475	-90	-90	2	12.48	26
	20150225	12475	12475	12325	12325	12325	12325	12325	-150	-150	2	12.33	24
	20150226	12325	12325	12245	12245	12240	12240	12240	-85	-85	4	24.49	24
	20150227	12240	12240				12240	12240	0	0	0	0.00	24
	20150302	12240	12240	12150	12180	12135	12180	12155	-60	-85	12	72.93	34
	20150303	12180	12155				12155	12155	0	0	0	0.00	34
	20150304	12155	12155	12170	12195	12170	12195	12180	40	25	32	194.92	50
	20150305	12195	12180	12220	12220	12220	12220	12220	40	40	2	12.22	50
	20150306	12220	12220	12265	12265	12265	12265	12265	45	45	2	12.27	52
	20150309	12265	12265	12270	12295	12175	12270	12265	5	0	136	834.07	148
	20150310	12270	12265	12290	12325	12290	12300	12315	35	50	54	332.57	198
	20150311	12300	12315	12240	12280	12240	12260	12260	-55	-55	98	600.86	294
	20150312	12260	12260	12280	12350	12280	12350	12335	90	75	14	86.35	296
	20150313	12350	12335	12345	12355	12340	12350	12345	15	10	92	567.97	384
	20150316	12350	12345	12255	12300	12255	12280	12280	-65	-65	90	552.81	446
	20150317	12280	12280	12255	12255	12180	12190	12205	-90	-75	250	1,525.64	618
	20150318	12190	12205	12120	12165	12100	12100	12140	-105	-65	110	667.72	670
	20150319	12100	12140	12110	12145	12045	12140	12110	0	-30	118	714.74	722
	20150320	12140	12110	12095	12125	12090	12105	12110	-5	0	270	1,634.86	906
	20150323	12105	12110	12140	12325	12140	12285	12255	175	145	342	2,096.05	998
	20150324	12285	12255	12360	12490	12360	12445	12420	190	165	324	2,012.50	1162
	20150325	12445	12420	12500	12525	12370	12475	12415	55	-5	578	3,589.07	1306
	20150326	12475	12415	12505	12505	12430	12475	12455	60	40	342	2,129.93	1298
	20150327	12475	12455	12465	12490	12380	12425	12415	-30	-40	284	1,762.94	1392
	20150330	12425	12415	12400	12475	12380	12415	12425	0	10	234	1,454.09	1362
	20150331	12415	12425	12400	12435	12365	12365	12400	-60	-25	738	4,576.47	1754
	20150401	12365	12400	12350	12440	12300	12440	12375	40	-25	442	2,734.92	1834
	20150402	12440	12375	12410	12590	12410	12480	12475	105	100	1006	6,275.55	2056
	20150403	12480	12475	12505	12660	12500	12660	12575	185	100	450	2,830.01	2160
	20150407	12660	12575	12645	12720	12625	12675	12665	100	90	510	3,230.01	2252
	20150408	12675	12665	12700	12780	12625	12685	12680	20	15	772	4,894.91	2362
	20150409	12685	12680	12730	12805	12730	12805	12760	125	80	738	4,709.93	2756
	20150410	12805	12760	12850	13270	12840	13270	13040	510	280	1802	11,752.57	3422
	20150413	13270	13040	13365	13485	13205	13310	13325	270	285	1916	12,768.45	3792
	20150414	13310	13325	13280	13350	12895	12960	13080	-365	-245	3416	22,341.01	4984
	20150415	12960	13080	13025	13265	12970	13195	13115	115	35	1898	12,450.85	5094
	20150416	13195	13115	13155	13360	13140	13295	13255	180	140	1786	11,838.16	5704
	20150417	13295	13255	13410	13710	13410	13555	13555	300	300	3908	26,492.73	5776
	20150420	13555	13555	13560	13635	13420	13560	13545	5	-10	1424	9,645.24	5952
	20150421	13560	13545	13515	13620	13440	13470	13505	-75	-40	1532	10,346.95	6290
	20150422	13470	13505	13490	13740	13465	13725	13620	220	115	3848	26,208.51	7806
	20150423	13725	13620	13710	13710	13395	13470	13580	-150	-40	3388	23,008.48	8176
	20150424	13470	13580	13425	13525	13345	13500	13445	-80	-135	1582	10,636.33	8306
	20150427	13500	13445	13620	13820	13595	13725	13705	280	260	4230	28,987.49	9704
	20150428	13725	13705	13765	13880	13675	13735	13770	30	65	5942	40,912.78	11064
	20150429	13735	13770	13780	13795	13645	13740	13720	-30	-50	2682	18,401.91	11528
	20150430	13740	13720	13775	13875	13755	13790	13805	70	85	3978	27,461.94	12200
pb1508	20150105	12645	12645	12730	12730	12660	12660	12695	15	50	4	25.39	60
	20150106	12660	12695	12570	12700	12570	12640	12620	-55	-75	18	113.58	58
	20150107	12640	12620				12665	12665	45	45	0	0.00	58
	20150108	12665	12665	12655	12655	12655	12655	12655	-10	-10	2	12.66	58
	20150109	12655	12655	12640	12650	12640	12650	12645	-5	-10	4	25.29	60
	20150112	12650	12645	12565	12565	12565	12565	12565	-80	-80	2	12.57	60
	20150113	12565	12565				12465	12465	-100	-100	0	0.00	60
	20150114	12465	12465	12320	12320	12035	12075	12075	-390	-390	16	96.63	68
	20150115	12075	12075	12065	12220	12015	12190	12100	115	25	18	108.93	64
	20150116	12190	12100				12160	12160	60	60	0	0.00	64
	20150119	12160	12160	12385	12515	12385	12515	12465	355	305	6	37.40	64
	20150120	12515	12465				12465	12465	0	0	0	0.00	64
	20150121	12465	12465				12545	12545	80	80	0	0.00	64
	20150122	12545	12545	12640	12895	12640	12895	12740	350	195	18	114.69	58
	20150123	12895	12740				12615	12615	-125	-125	0	0.00	58
	20150126	12615	12615	12485	12485	12485	12485	12485	-130	-130	2	12.49	60
	20150127	12485	12485	12585	12585	12520	12520	12530	35	45	28	175.46	44
	20150128	12520	12530				12530	12530	0	0	0	0.00	44
	20150129	12530	12530	12550	12550	12550	12550	12550	20	20	2	12.55	44
	20150130	12550	12550	12470	12470	12470	12470	12470	-80	-80	2	12.47	44
	20150202	12470	12470				12470	12470	0	0	0	0.00	44
	20150203	12470	12470				12470	12470	0	0	0	0.00	44
	20150204	12470	12470	12590	12590	12590	12590	12590	120	120	2	12.59	44
	20150205	12590	12590	12600	12600	12600	12600	12600	10	10	2	12.60	44
	20150206	12600	12600				12600	12600	0	0	0	0.00	44
	20150209	12600	12600				12580	12580	-20	-20	0	0.00	44
	20150210	12580	12580	12550	12550	12550	12550	12550	-30	-30	2	12.55	44
	20150211	12550	12550	12550	12550	12550	12550	12550	0	0	4	25.10	48
	20150212	12550	12550	12385	12385	12385	12385	12385	-165	-165	2	12.39	48
	20150213	12385	12385	12565	12590	12560	12590	12570	205	185	6	37.72	44
	20150216	12590	12570				12570	12570	0	0	0	0.00	44
	20150217	12570	12570	12525	12525	12525	12525	12525	-45	-45	2	12.53	44
	20150225	12525	12525				12370	12370	-155	-155	0	0.00	44
	20150226	12370	12370				12370	12370	0	0	0	0.00	44
	20150227	12370	12370				12290	12290	-80	-80	0	0.00	44
	20150302	12290	12290	12150	12200	12100	12200	12150	-90	-140	18	109.36	46
	20150303	12200	12150	12120	12245	12120	12140	12160	-10	10	8	48.65	44
	20150304	12140	12160	12170	12170	12170	12170	12170	10	10	2	12.17	44
	20150305	12170	12170	12200	12210	12200	12210	12205	40	35	12	73.25	52
	20150306	12210	12205	12275	12275	12275	12275	12275	70	70	10	61.38	62
	20150309	12275	12275	12280	12280	12265	12280	12275	5	0	12	73.67	66
	20150310	12280	12275	12290	12365	12290	12300	12340	25	65	14	86.39	70
	20150311	12300	12340	12260	12260	12260	12260	12260	-80	-80	2	12.26	70
	20150312	12260	12260				12355	12355	95	95	0	0.00	70
	20150313	12355	12355				12355	12355	0	0	0	0.00	70
	20150316	12355	12355	12265	12265	12265	12265	12265	-90	-90	2	12.27	70
	20150317	12265	12265	12260	12260	12255	12255	12255	-10	-10	6	36.77	70
	20150318	12255	12255				12190	12190	-65	-65	0	0.00	70
	20150319	12190	12190	12170	12170	12170	12170	12170	-20	-20	2	12.17	70
	20150320	12170	12170				12130	12130	-40	-40	0	0.00	70
	20150323	12130	12130				12130	12130	0	0	0	0.00	70
	20150324	12130	12130				12230	12230	100	100	0	0.00	70
	20150325	12230	12230	12480	12480	12405	12405	12440	175	210	4	24.89	72
	20150326	12405	12440	12460	12460	12460	12460	12460	20	20	2	12.46	70
	20150327	12460	12460				12420	12420	-40	-40	0	0.00	70
	20150330	12420	12420				12420	12420	0	0	0	0.00	70
	20150331	12420	12420				12420	12420	0	0	0	0.00	70
	20150401	12420	12420	12405	12455	12405	12430	12425	10	5	10	62.15	66
	20150402	12430	12425	12435	12435	12435	12435	12435	10	10	2	12.44	64
	20150403	12435	12435	12520	12635	12520	12630	12575	195	140	10	62.88	66
	20150407	12630	12575				12665	12665	90	90	0	0.00	66
	20150408	12665	12665	12680	12680	12680	12680	12680	15	15	2	12.68	64
	20150409	12680	12680				12760	12760	80	80	0	0.00	64
	20150410	12760	12760	13000	13270	12990	13270	13185	510	425	130	857.06	96
	20150413	13270	13185	13600	13600	13240	13300	13320	115	135	314	2,091.63	270
	20150414	13300	13320	13300	13300	12910	12955	13055	-365	-265	708	4,621.48	550
	20150415	12955	13055	13050	13205	13050	13185	13105	130	50	300	1,966.47	652
	20150416	13185	13105	13295	13350	13165	13300	13240	195	135	446	2,953.29	750
	20150417	13300	13240	13465	13685	13445	13545	13575	305	335	1324	8,988.74	1460
	20150420	13545	13575	13495	13625	13450	13510	13565	-65	-10	532	3,609.58	1548
	20150421	13510	13565	13530	13605	13395	13470	13475	-95	-90	276	1,860.18	1620
	20150422	13470	13475	13525	13710	13490	13705	13585	230	110	818	5,557.69	1892
	20150423	13705	13585	13655	13700	13410	13455	13525	-130	-60	1128	7,629.95	2258
	20150424	13455	13525	13460	13500	13360	13500	13450	-25	-75	836	5,623.92	2532
	20150427	13500	13450	13655	13805	13605	13785	13720	335	270	534	3,663.76	2652
	20150428	13785	13720	13785	13855	13675	13720	13740	0	20	1024	7,036.53	3146
	20150429	13720	13740	13800	13800	13640	13740	13690	0	-50	516	3,532.51	3276
	20150430	13740	13690	13780	13865	13755	13785	13785	95	95	652	4,495.22	3434
pb1509	20150105	12685	12685	12700	12710	12700	12710	12700	25	15	16	101.63	38
	20150106	12710	12700				12700	12700	0	0	0	0.00	38
	20150107	12700	12700				12700	12700	0	0	0	0.00	38
	20150108	12700	12700	12725	12725	12660	12660	12690	-40	-10	4	25.39	40
	20150109	12660	12690	12625	12635	12625	12635	12630	-55	-60	4	25.26	42
	20150112	12635	12630				12630	12630	0	0	0	0.00	42
	20150113	12630	12630	12565	12565	12500	12505	12515	-125	-115	8	50.07	42
	20150114	12505	12515	12375	12375	12020	12020	12205	-495	-310	22	134.30	50
	20150115	12020	12205	12150	12375	12045	12375	12180	170	-25	28	170.57	68
	20150116	12375	12180	12480	12480	12280	12280	12325	100	145	10	61.63	66
	20150119	12280	12325	12430	12450	12430	12450	12440	125	115	4	24.88	64
	20150120	12450	12440	12515	12515	12515	12515	12515	75	75	2	12.52	66
	20150121	12515	12515	12605	12605	12605	12605	12605	90	90	2	12.61	66
	20150122	12605	12605	12735	12755	12735	12755	12740	150	135	10	63.70	60
	20150123	12755	12740	12710	12710	12585	12585	12675	-155	-65	16	101.44	60
	20150126	12585	12675	12465	12515	12465	12515	12490	-160	-185	4	24.98	56
	20150127	12515	12490	12580	12580	12555	12555	12565	65	75	4	25.14	56
	20150128	12555	12565				12565	12565	0	0	0	0.00	56
	20150129	12565	12565	12595	12595	12595	12595	12595	30	30	2	12.60	56
	20150130	12595	12595				12510	12510	-85	-85	0	0.00	56
	20150202	12510	12510				12510	12510	0	0	0	0.00	56
	20150203	12510	12510				12510	12510	0	0	0	0.00	56
	20150204	12510	12510				12630	12630	120	120	0	0.00	56
	20150205	12630	12630	12625	12625	12590	12590	12600	-40	-30	6	37.81	58
	20150206	12590	12600				12630	12630	30	30	0	0.00	58
	20150209	12630	12630	12625	12625	12625	12625	12625	-5	-5	2	12.63	60
	20150210	12625	12625				12625	12625	0	0	0	0.00	60
	20150211	12625	12625				12545	12545	-80	-80	0	0.00	60
	20150212	12545	12545				12405	12405	-140	-140	0	0.00	60
	20150213	12405	12405	12630	12630	12630	12630	12630	225	225	2	12.63	60
	20150216	12630	12630	12590	12590	12590	12590	12590	-40	-40	2	12.59	62
	20150217	12590	12590	12525	12525	12490	12505	12505	-85	-85	16	100.08	58
	20150225	12505	12505				12350	12350	-155	-155	0	0.00	58
	20150226	12350	12350	12300	12305	12280	12280	12295	-70	-55	6	36.89	58
	20150227	12280	12295	12325	12325	12300	12300	12305	5	10	10	61.53	64
	20150302	12300	12305	12170	12210	12170	12210	12190	-95	-115	4	24.38	64
	20150303	12210	12190	12215	12215	12215	12215	12215	25	25	2	12.22	66
	20150304	12215	12215				12215	12215	0	0	0	0.00	66
	20150305	12215	12215	12220	12245	12220	12245	12235	30	20	6	36.71	64
	20150306	12245	12235				12305	12305	70	70	0	0.00	64
	20150309	12305	12305				12305	12305	0	0	0	0.00	64
	20150310	12305	12305				12305	12305	0	0	0	0.00	64
	20150311	12305	12305				12275	12275	-30	-30	0	0.00	64
	20150312	12275	12275	12305	12305	12230	12230	12265	-45	-10	4	24.54	64
	20150313	12230	12265				12265	12265	0	0	0	0.00	64
	20150316	12265	12265				12265	12265	0	0	0	0.00	64
	20150317	12265	12265				12230	12230	-35	-35	0	0.00	64
	20150318	12230	12230	12135	12135	12135	12135	12135	-95	-95	2	12.14	66
	20150319	12135	12135	12165	12185	12165	12185	12175	50	40	4	24.35	66
	20150320	12185	12175	12105	12105	12105	12105	12105	-70	-70	2	12.11	66
	20150323	12105	12105	12210	12325	12210	12285	12290	180	185	20	122.92	68
	20150324	12285	12290	12405	12570	12405	12425	12460	135	170	20	124.61	64
	20150325	12425	12460				12460	12460	0	0	0	0.00	64
	20150326	12460	12460	12580	12580	12500	12500	12525	40	65	12	75.17	68
	20150327	12500	12525	12425	12425	12425	12425	12425	-100	-100	6	37.28	70
	20150330	12425	12425	12420	12420	12420	12420	12420	-5	-5	2	12.42	72
	20150331	12420	12420	12420	12420	12420	12420	12420	0	0	2	12.42	72
	20150401	12420	12420	12415	12500	12415	12500	12450	80	30	6	37.36	74
	20150402	12500	12450	12430	12520	12430	12480	12485	30	35	20	124.85	78
	20150403	12480	12485	12500	12540	12500	12540	12520	55	35	14	87.66	74
	20150407	12540	12520	12650	12650	12650	12650	12650	130	130	2	12.65	72
	20150408	12650	12650	12730	12765	12635	12680	12690	30	40	16	101.55	70
	20150409	12680	12690	12770	12770	12770	12770	12770	80	80	2	12.77	68
	20150410	12770	12770	12945	13280	12945	13280	13170	510	400	36	237.08	58
	20150413	13280	13170	13520	13520	13280	13280	13435	110	265	130	873.55	108
	20150414	13280	13435	13320	13325	12970	13000	13150	-435	-285	36	236.72	116
	20150415	13000	13150	13145	13220	13120	13205	13155	55	5	48	315.82	132
	20150416	13205	13155	13275	13370	13180	13370	13275	215	120	62	411.56	140
	20150417	13370	13275	13480	13710	13480	13630	13575	355	300	108	733.29	174
	20150420	13630	13575	13555	13625	13540	13550	13570	-25	-5	102	692.19	198
	20150421	13550	13570	13555	13555	13500	13510	13520	-60	-50	20	135.21	192
	20150422	13510	13520	13635	13720	13635	13715	13705	195	185	32	219.33	182
	20150423	13715	13705	13670	13715	13405	13460	13555	-245	-150	160	1,084.45	236
	20150424	13460	13555	13450	13515	13350	13515	13475	-40	-80	52	350.40	238
	20150427	13515	13475	13700	13800	13660	13775	13765	300	290	618	4,254.69	644
	20150428	13775	13765	13815	13900	13690	13720	13755	-45	-10	546	3,755.88	606
	20150429	13720	13755	13780	13780	13655	13750	13705	-5	-50	190	1,302.36	640
	20150430	13750	13705	13840	13850	13760	13760	13800	55	95	64	441.67	644
pb1510	20150105	12695	12680	12730	12730	12680	12680	12705	0	25	4	25.41	414
	20150106	12680	12705	12650	12660	12645	12645	12650	-60	-55	8	50.61	416
	20150107	12645	12650	12615	12630	12615	12630	12620	-20	-30	10	63.11	406
	20150108	12630	12620				12620	12620	0	0	0	0.00	406
	20150109	12620	12620	12650	12710	12650	12710	12680	90	60	4	25.36	408
	20150112	12710	12680	12640	12640	12640	12640	12640	-40	-40	2	12.64	408
	20150113	12640	12640	12535	12610	12485	12485	12535	-155	-105	14	87.77	406
	20150114	12485	12535	12285	12370	12045	12115	12255	-420	-280	78	477.96	414
	20150115	12115	12255	12065	12315	12065	12230	12145	-25	-110	16	97.20	418
	20150116	12230	12145	12325	12450	12245	12390	12315	245	170	28	172.43	424
	20150119	12390	12315	12335	12540	12335	12530	12475	215	160	24	149.71	410
	20150120	12530	12475	12580	12580	12560	12560	12570	85	95	4	25.14	410
	20150121	12560	12570	12605	12630	12605	12630	12615	60	45	4	25.24	408
	20150122	12630	12615	12625	12795	12625	12765	12735	150	120	46	292.98	402
	20150123	12765	12735	12645	12645	12600	12600	12615	-135	-120	12	75.72	394
	20150126	12600	12615	12575	12590	12550	12550	12565	-65	-50	38	238.82	392
	20150127	12550	12565	12640	12640	12545	12545	12565	-20	0	42	263.90	392
	20150128	12545	12565	12525	12525	12525	12525	12525	-40	-40	2	12.53	394
	20150129	12525	12525				12525	12525	0	0	0	0.00	394
	20150130	12525	12525	12520	12520	12480	12480	12500	-45	-25	4	25.00	394
	20150202	12480	12500				12555	12555	55	55	0	0.00	394
	20150203	12555	12555	12570	12600	12570	12600	12590	45	35	8	50.37	394
	20150204	12600	12590	12630	12670	12630	12670	12640	80	50	6	37.93	396
	20150205	12670	12640				12640	12640	0	0	0	0.00	396
	20150206	12640	12640	12650	12650	12625	12630	12630	-10	-10	14	88.43	398
	20150209	12630	12630				12630	12630	0	0	0	0.00	398
	20150210	12630	12630	12660	12660	12660	12660	12660	30	30	6	37.98	394
	20150211	12660	12660	12550	12695	12525	12525	12565	-135	-95	10	62.85	388
	20150212	12525	12565	12490	12490	12385	12430	12420	-135	-145	8	49.69	390
	20150213	12430	12420	12480	12585	12480	12585	12500	165	80	20	125.01	392
	20150216	12585	12500	12615	12620	12590	12590	12605	90	105	30	189.14	382
	20150217	12590	12605	12535	12535	12500	12505	12505	-100	-100	76	475.22	370
	20150225	12505	12505	12350	12365	12350	12350	12355	-155	-150	10	61.78	368
	20150226	12350	12355	12280	12345	12280	12300	12310	-55	-45	16	98.48	366
	20150227	12300	12310	12370	12405	12285	12290	12320	-20	10	116	714.57	370
	20150302	12290	12320	12195	12260	12195	12260	12205	-60	-115	26	158.71	364
	20150303	12260	12205	12195	12215	12195	12215	12200	10	-5	14	85.43	374
	20150304	12215	12200	12170	12240	12170	12230	12200	30	0	66	402.68	378
	20150305	12230	12200	12230	12280	12210	12210	12220	10	20	20	122.22	380
	20150306	12210	12220	12285	12305	12225	12235	12250	15	30	50	306.32	378
	20150309	12235	12250	12215	12290	12215	12260	12250	10	0	18	110.25	382
	20150310	12260	12250	12295	12300	12290	12300	12295	50	45	42	258.24	404
	20150311	12300	12295	12105	12305	12100	12280	12260	-15	-35	70	429.19	420
	20150312	12280	12260	12255	12345	12255	12345	12300	85	40	4	24.60	420
	20150313	12345	12300	12380	12380	12315	12375	12360	75	60	14	86.53	418
	20150316	12375	12360	12230	12300	12225	12285	12275	-75	-85	16	98.21	420
	20150317	12285	12275	12225	12230	12180	12180	12210	-95	-65	50	305.31	462
	20150318	12180	12210	12160	12170	12145	12160	12160	-50	-50	20	121.61	470
	20150319	12160	12160	12110	12160	12110	12160	12155	0	-5	24	145.87	470
	20150320	12160	12155	12100	12145	12100	12145	12130	-10	-25	16	97.06	470
	20150323	12145	12130	12210	12345	12210	12330	12265	200	135	58	355.78	470
	20150324	12330	12265	12430	12470	12415	12470	12445	205	180	12	74.68	472
	20150325	12470	12445				12450	12450	5	5	0	0.00	472
	20150326	12450	12450	12445	12445	12445	12445	12445	-5	-5	10	62.23	468
	20150327	12445	12445	12420	12420	12420	12420	12420	-25	-25	4	24.84	468
	20150330	12420	12420	12390	12405	12390	12405	12400	-15	-20	8	49.61	468
	20150331	12405	12400	12380	12425	12350	12350	12405	-50	5	16	99.25	468
	20150401	12350	12405	12285	12430	12285	12430	12355	25	-50	34	210.09	468
	20150402	12430	12355	12420	12465	12420	12460	12435	105	80	16	99.49	470
	20150403	12460	12435	12455	12645	12455	12640	12555	205	120	32	200.92	470
	20150407	12640	12555	12660	12715	12660	12690	12690	135	135	32	203.04	478
	20150408	12690	12690	12755	12755	12625	12695	12670	5	-20	78	494.32	478
	20150409	12695	12670	12695	12780	12695	12780	12755	110	85	56	357.15	470
	20150410	12780	12755	12970	13265	12970	13265	13180	510	425	286	1,885.21	466
	20150413	13265	13180	13535	13550	13300	13360	13500	180	320	424	2,862.98	426
	20150414	13360	13500	13365	13365	12960	12985	13090	-515	-410	88	576.08	428
	20150415	12985	13090	13165	13250	13155	13235	13220	145	130	112	740.40	446
	20150416	13235	13220	13360	13400	13205	13350	13330	130	110	42	279.94	448
	20150417	13350	13330	13500	13730	13460	13730	13600	400	270	56	380.82	442
	20150420	13730	13600	13730	13730	13490	13580	13610	-20	10	38	258.67	428
	20150421	13580	13610	13520	13545	13480	13480	13515	-130	-95	12	81.11	422
	20150422	13480	13515	13625	13770	13625	13770	13700	255	185	86	589.11	432
	20150423	13770	13700	13655	13735	13430	13505	13575	-195	-125	78	529.48	446
	20150424	13505	13575	13500	13500	13500	13500	13500	-75	-75	2	13.50	448
	20150427	13500	13500	13685	13845	13670	13800	13765	300	265	336	2,312.65	580
	20150428	13800	13765	13805	13865	13685	13735	13745	-30	-20	266	1,828.40	644
	20150429	13735	13745	13755	13805	13680	13750	13715	5	-30	104	713.43	654
	20150430	13750	13715	13765	13865	13750	13800	13780	85	65	164	1,130.36	732
pb1511	20150105	12710	12705				12730	12730	25	25	0	0.00	12
	20150106	12730	12730				12730	12730	0	0	0	0.00	12
	20150107	12730	12730	12790	12790	12730	12730	12760	0	30	4	25.52	14
	20150108	12730	12760	12790	12790	12790	12790	12790	30	30	2	12.79	14
	20150109	12790	12790	12770	12775	12770	12775	12770	-15	-20	4	25.55	12
	20150112	12775	12770	12725	12725	12625	12625	12655	-145	-115	6	37.98	16
	20150113	12625	12655	12730	12730	12575	12575	12640	-80	-15	8	50.57	14
	20150114	12575	12640	12465	12465	12195	12195	12280	-445	-360	10	61.40	20
	20150115	12195	12280	12180	12240	12135	12240	12165	-40	-115	20	121.68	30
	20150116	12240	12165	12515	12515	12515	12515	12515	350	350	2	12.52	28
	20150119	12515	12515	12410	12690	12410	12535	12585	20	70	22	138.45	20
	20150120	12535	12585	12595	12595	12595	12595	12595	10	10	2	12.60	22
	20150121	12595	12595				12640	12640	45	45	0	0.00	22
	20150122	12640	12640	12655	12885	12655	12885	12805	245	165	14	89.64	22
	20150123	12885	12805	12810	12810	12710	12710	12780	-95	-25	10	63.92	20
	20150126	12710	12780				12780	12780	0	0	0	0.00	20
	20150127	12780	12780	12655	12655	12605	12605	12615	-175	-165	16	100.94	20
	20150128	12605	12615	12605	12605	12605	12605	12605	-10	-10	2	12.61	20
	20150129	12605	12605				12605	12605	0	0	0	0.00	20
	20150130	12605	12605				12575	12575	-30	-30	0	0.00	20
	20150202	12575	12575				12575	12575	0	0	0	0.00	20
	20150203	12575	12575				12575	12575	0	0	0	0.00	20
	20150204	12575	12575				12575	12575	0	0	0	0.00	20
	20150205	12575	12575				12545	12545	-30	-30	0	0.00	20
	20150206	12545	12545				12535	12535	-10	-10	0	0.00	20
	20150209	12535	12535	12730	12730	12730	12730	12730	195	195	2	12.73	22
	20150210	12730	12730	12645	12645	12640	12640	12640	-90	-90	6	37.93	22
	20150211	12640	12640				12545	12545	-95	-95	0	0.00	22
	20150212	12545	12545				12515	12515	-30	-30	0	0.00	22
	20150213	12515	12515	12390	12615	12390	12615	12565	100	50	10	62.83	20
	20150216	12615	12565				12565	12565	0	0	0	0.00	20
	20150217	12565	12565	12560	12560	12560	12560	12560	-5	-5	4	25.12	24
	20150225	12560	12560	12315	12340	12315	12340	12320	-220	-240	6	36.97	26
	20150226	12340	12320	12310	12400	12310	12400	12355	80	35	4	24.71	24
	20150227	12400	12355				12355	12355	0	0	0	0.00	24
	20150302	12355	12355				12355	12355	0	0	0	0.00	24
	20150303	12355	12355				12350	12350	-5	-5	0	0.00	24
	20150304	12350	12350	12235	12235	12235	12235	12235	-115	-115	2	12.24	22
	20150305	12235	12235				12240	12240	5	5	0	0.00	22
	20150306	12240	12240	12295	12295	12270	12270	12280	30	40	8	49.14	22
	20150309	12270	12280	12285	12285	12285	12285	12285	5	5	2	12.29	24
	20150310	12285	12285				12285	12285	0	0	0	0.00	24
	20150311	12285	12285				12250	12250	-35	-35	0	0.00	24
	20150312	12250	12250				12250	12250	0	0	0	0.00	24
	20150313	12250	12250				12310	12310	60	60	0	0.00	24
	20150316	12310	12310				12310	12310	0	0	0	0.00	24
	20150317	12310	12310				12250	12250	-60	-60	0	0.00	24
	20150318	12250	12250				12130	12130	-120	-120	0	0.00	24
	20150319	12130	12130				12130	12130	0	0	0	0.00	24
	20150320	12130	12130	12135	12135	12135	12135	12135	5	5	4	24.27	24
	20150323	12135	12135				12270	12270	135	135	0	0.00	24
	20150324	12270	12270	12310	12310	12310	12310	12310	40	40	2	12.31	24
	20150325	12310	12310				12380	12380	70	70	0	0.00	24
	20150326	12380	12380				12375	12375	-5	-5	0	0.00	24
	20150327	12375	12375	12425	12425	12425	12425	12425	50	50	2	12.43	26
	20150330	12425	12425	12390	12390	12390	12390	12390	-35	-35	2	12.39	26
	20150331	12390	12390				12395	12395	5	5	0	0.00	26
	20150401	12395	12395				12395	12395	0	0	0	0.00	26
	20150402	12395	12395				12475	12475	80	80	0	0.00	26
	20150403	12475	12475	12510	12510	12510	12510	12510	35	35	2	12.51	26
	20150407	12510	12510				12515	12515	5	5	0	0.00	26
	20150408	12515	12515				12495	12495	-20	-20	0	0.00	26
	20150409	12495	12495				12735	12735	240	240	0	0.00	26
	20150410	12735	12735	13165	13165	13165	13165	13165	430	430	2	13.17	24
	20150413	13165	13165	13435	13465	13435	13460	13450	295	285	6	40.36	18
	20150414	13460	13450	13055	13055	13055	13055	13055	-395	-395	2	13.06	20
	20150415	13055	13055	13095	13170	13095	13170	13130	115	75	4	26.27	16
	20150416	13170	13130	13295	13295	13290	13290	13290	160	160	6	39.88	14
	20150417	13290	13290				13555	13555	265	265	0	0.00	14
	20150420	13555	13555				13565	13565	10	10	0	0.00	14
	20150421	13565	13565				13470	13470	-95	-95	0	0.00	14
	20150422	13470	13470				13650	13650	180	180	0	0.00	14
	20150423	13650	13650				13525	13525	-125	-125	0	0.00	14
	20150424	13525	13525	13495	13495	13495	13495	13495	-30	-30	2	13.50	12
	20150427	13495	13495	13825	13825	13825	13825	13825	330	330	2	13.83	12
	20150428	13825	13825	13765	13765	13765	13765	13765	-60	-60	6	41.30	12
	20150429	13765	13765				13735	13735	-30	-30	0	0.00	12
	20150430	13735	13735				13800	13800	65	65	0	0.00	12
pb1512	20150105	12720	12720	12840	12840	12835	12835	12835	115	115	4	25.68	8
	20150106	12835	12835				12835	12835	0	0	0	0.00	8
	20150107	12835	12835				12865	12865	30	30	0	0.00	8
	20150108	12865	12865				12895	12895	30	30	0	0.00	8
	20150109	12895	12895				12875	12875	-20	-20	0	0.00	8
	20150112	12875	12875				12830	12830	-45	-45	0	0.00	8
	20150113	12830	12830	12650	12685	12650	12685	12665	-145	-165	4	25.34	6
	20150114	12685	12665	12505	12555	12275	12275	12400	-390	-265	8	49.61	10
	20150115	12275	12400	12245	12345	12155	12330	12245	-70	-155	26	159.24	22
	20150116	12330	12245				12595	12595	350	350	0	0.00	22
	20150119	12595	12595	12365	12520	12365	12520	12460	-75	-135	16	99.69	16
	20150120	12520	12460				12460	12460	0	0	0	0.00	16
	20150121	12460	12460				12505	12505	45	45	0	0.00	16
	20150122	12505	12505	12720	12885	12720	12885	12805	380	300	8	51.22	16
	20150123	12885	12805	12775	12775	12775	12775	12775	-30	-30	2	12.78	18
	20150126	12775	12775	12605	12605	12605	12605	12605	-170	-170	2	12.61	18
	20150127	12605	12605	12720	12720	12690	12690	12710	85	105	6	38.13	16
	20150128	12690	12710	12640	12705	12640	12655	12675	-55	-35	14	88.73	22
	20150129	12655	12675				12705	12705	30	30	0	0.00	22
	20150130	12705	12705				12675	12675	-30	-30	0	0.00	22
	20150202	12675	12675				12735	12735	60	60	0	0.00	22
	20150203	12735	12735	12650	12650	12650	12650	12650	-85	-85	4	25.30	24
	20150204	12650	12650				12700	12700	50	50	0	0.00	24
	20150205	12700	12700				12670	12670	-30	-30	0	0.00	24
	20150206	12670	12670				12660	12660	-10	-10	0	0.00	24
	20150209	12660	12660				12855	12855	195	195	0	0.00	24
	20150210	12855	12855				12765	12765	-90	-90	0	0.00	24
	20150211	12765	12765				12670	12670	-95	-95	0	0.00	24
	20150212	12670	12670				12545	12545	-125	-125	0	0.00	24
	20150213	12545	12545				12595	12595	50	50	0	0.00	24
	20150216	12595	12595				12705	12705	110	110	0	0.00	24
	20150217	12705	12705				12695	12695	-10	-10	0	0.00	24
	20150225	12695	12695				12455	12455	-240	-240	0	0.00	24
	20150226	12455	12455				12490	12490	35	35	0	0.00	24
	20150227	12490	12490	12405	12440	12400	12400	12425	-90	-65	18	111.85	38
	20150302	12400	12425	12310	12310	12310	12310	12310	-115	-115	2	12.31	40
	20150303	12310	12310				12305	12305	-5	-5	0	0.00	40
	20150304	12305	12305	12295	12315	12295	12315	12295	10	-10	12	73.79	44
	20150305	12315	12295	12370	12370	12370	12370	12370	75	75	4	24.74	44
	20150306	12370	12370	12360	12360	12245	12245	12325	-125	-45	8	49.31	50
	20150309	12245	12325				12325	12325	0	0	0	0.00	50
	20150310	12325	12325				12325	12325	0	0	0	0.00	50
	20150311	12325	12325				12290	12290	-35	-35	0	0.00	50
	20150312	12290	12290				12290	12290	0	0	0	0.00	50
	20150313	12290	12290				12350	12350	60	60	0	0.00	50
	20150316	12350	12350				12350	12350	0	0	0	0.00	50
	20150317	12350	12350				12250	12250	-100	-100	0	0.00	50
	20150318	12250	12250				12200	12200	-50	-50	0	0.00	50
	20150319	12200	12200	12070	12200	12070	12200	12180	0	-20	22	134.03	64
	20150320	12200	12180	12140	12140	12140	12140	12140	-40	-40	2	12.14	64
	20150323	12140	12140	12325	12360	12320	12320	12345	180	205	10	61.73	68
	20150324	12320	12345				12350	12350	5	5	0	0.00	68
	20150325	12350	12350	12470	12470	12290	12450	12380	100	30	40	247.61	60
	20150326	12450	12380	12490	12505	12425	12425	12470	45	90	26	162.13	52
	20150327	12425	12470	12435	12435	12390	12410	12410	-60	-60	14	86.88	38
	20150330	12410	12410	12365	12450	12365	12445	12390	35	-20	14	86.74	34
	20150331	12445	12390	12460	12460	12370	12370	12405	-20	15	6	37.23	34
	20150401	12370	12405	12300	12460	12300	12460	12405	55	0	6	37.22	36
	20150402	12460	12405	12425	12480	12405	12460	12445	55	40	12	74.69	32
	20150403	12460	12445	12540	12540	12540	12540	12540	95	95	2	12.54	32
	20150407	12540	12540	12675	12675	12675	12675	12675	135	135	4	25.35	34
	20150408	12675	12675				12655	12655	-20	-20	0	0.00	34
	20150409	12655	12655				12670	12670	15	15	0	0.00	34
	20150410	12670	12670	13090	13170	13090	13170	13130	500	460	12	78.79	26
	20150413	13170	13130	13485	13485	13465	13470	13475	340	345	8	53.91	20
	20150414	13470	13475	13300	13300	13055	13060	13105	-415	-370	10	65.53	24
	20150415	13060	13105	13195	13280	13195	13280	13225	175	120	6	39.68	24
	20150416	13280	13225	13385	13405	13290	13405	13340	180	115	8	53.38	28
	20150417	13405	13340	13580	13580	13580	13580	13580	240	240	4	27.16	26
	20150420	13580	13580	13750	13750	13750	13750	13750	170	170	2	13.75	28
	20150421	13750	13750				13655	13655	-95	-95	0	0.00	28
	20150422	13655	13655				13840	13840	185	185	0	0.00	28
	20150423	13840	13840				13715	13715	-125	-125	0	0.00	28
	20150424	13715	13715	13535	13590	13535	13590	13550	-125	-165	6	40.66	28
	20150427	13590	13550	13800	13800	13800	13800	13800	250	250	2	13.80	28
	20150428	13800	13800				13740	13740	-60	-60	0	0.00	28
	20150429	13740	13740				13710	13710	-30	-30	0	0.00	28
	20150430	13710	13710				13775	13775	65	65	0	0.00	28
pb1601	20150116	12245	12245				12595	12595	350	350	0	0.00	0
	20150119	12595	12595				12460	12460	-135	-135	0	0.00	0
	20150120	12460	12460				12460	12460	0	0	0	0.00	0
	20150121	12460	12460				12505	12505	45	45	0	0.00	0
	20150122	12505	12505	12640	12890	12640	12845	12800	340	295	8	51.22	4
	20150123	12845	12800				12770	12770	-30	-30	0	0.00	4
	20150126	12770	12770	12640	12640	12640	12640	12640	-130	-130	2	12.64	6
	20150127	12640	12640	12710	12710	12600	12645	12670	5	30	12	76.04	4
	20150128	12645	12670				12635	12635	-35	-35	0	0.00	4
	20150129	12635	12635				12665	12665	30	30	0	0.00	4
	20150130	12665	12665				12635	12635	-30	-30	0	0.00	4
	20150202	12635	12635				12695	12695	60	60	0	0.00	4
	20150203	12695	12695	12670	12670	12670	12670	12670	-25	-25	2	12.67	4
	20150204	12670	12670				12720	12720	50	50	0	0.00	4
	20150205	12720	12720				12690	12690	-30	-30	0	0.00	4
	20150206	12690	12690				12680	12680	-10	-10	0	0.00	4
	20150209	12680	12680				12875	12875	195	195	0	0.00	4
	20150210	12875	12875				12785	12785	-90	-90	0	0.00	4
	20150211	12785	12785	12645	12645	12645	12645	12645	-140	-140	2	12.65	4
	20150212	12645	12645				12540	12540	-105	-105	0	0.00	4
	20150213	12540	12540	12695	12695	12695	12695	12695	155	155	2	12.70	4
	20150216	12695	12695				12805	12805	110	110	0	0.00	4
	20150217	12805	12805	12655	12655	12645	12645	12650	-160	-155	14	88.56	16
	20150225	12645	12650				12410	12410	-240	-240	0	0.00	16
	20150226	12410	12410	12425	12425	12380	12380	12390	-30	-20	8	49.58	10
	20150227	12380	12390	12440	12440	12395	12395	12405	5	15	8	49.63	14
	20150302	12395	12405	12325	12325	12305	12310	12310	-95	-95	10	61.57	18
	20150303	12310	12310	12310	12380	12260	12380	12350	70	40	50	308.78	56
	20150304	12380	12350	12360	12360	12320	12335	12345	-15	-5	86	531.01	120
	20150305	12335	12345	12350	12350	12350	12350	12350	5	5	12	74.10	124
	20150306	12350	12350	12325	12325	12200	12200	12245	-150	-105	98	600.10	116
	20150309	12200	12245	12245	12250	12245	12250	12245	5	0	8	48.99	116
	20150310	12250	12245	12290	12315	12290	12315	12300	70	55	10	61.52	118
	20150311	12315	12300				12300	12300	0	0	0	0.00	118
	20150312	12300	12300				12340	12340	40	40	0	0.00	118
	20150313	12340	12340				12340	12340	0	0	0	0.00	118
	20150316	12340	12340	12210	12260	12100	12260	12170	-80	-170	172	1,046.72	198
	20150317	12260	12170	12220	12230	12195	12195	12210	25	40	32	195.42	212
	20150318	12195	12210	12190	12190	12190	12190	12190	-20	-20	2	12.19	210
	20150319	12190	12190				12170	12170	-20	-20	0	0.00	210
	20150320	12170	12170	12105	12105	12105	12105	12105	-65	-65	4	24.21	210
	20150323	12105	12105	12240	12330	12195	12300	12260	195	155	28	171.64	206
	20150324	12300	12260	12400	12440	12400	12410	12415	150	155	10	62.09	206
	20150325	12410	12415	12430	12435	12365	12420	12415	5	0	30	186.28	210
	20150326	12420	12415	12465	12465	12465	12465	12465	50	50	2	12.47	210
	20150327	12465	12465				12465	12465	0	0	0	0.00	210
	20150330	12465	12465	12390	12390	12390	12390	12390	-75	-75	2	12.39	210
	20150331	12390	12390	12360	12360	12360	12360	12360	-30	-30	2	12.36	210
	20150401	12360	12360	12310	12415	12305	12415	12350	55	-10	10	61.75	210
	20150402	12415	12350	12405	12405	12405	12405	12405	55	55	10	62.03	206
	20150403	12405	12405	12545	12545	12520	12520	12535	115	130	8	50.16	206
	20150407	12520	12535	12665	12665	12665	12665	12665	130	130	2	12.67	208
	20150408	12665	12665	12715	12715	12645	12645	12695	-20	30	8	50.79	210
	20150409	12645	12695	12715	12735	12715	12735	12725	40	30	14	89.11	214
	20150410	12735	12725	12855	13230	12855	13230	13110	505	385	18	118.02	216
	20150413	13230	13110	13490	13560	13375	13375	13525	265	415	98	662.79	144
	20150414	13375	13525	13345	13350	13050	13055	13325	-470	-200	150	999.49	106
	20150415	13055	13325	13160	13215	13160	13215	13190	-110	-135	6	39.58	106
	20150416	13215	13190	13295	13410	13295	13410	13355	220	165	10	66.80	104
	20150417	13410	13355	13600	13720	13600	13720	13640	365	285	24	163.68	100
	20150420	13720	13640	13615	13660	13615	13660	13635	20	-5	12	81.83	106
	20150421	13660	13635				13540	13540	-95	-95	0	0.00	106
	20150422	13540	13540	13660	13730	13660	13730	13675	190	135	8	54.71	100
	20150423	13730	13675	13580	13580	13580	13580	13580	-95	-95	10	67.90	100
	20150424	13580	13580	13550	13600	13550	13600	13575	20	-5	4	27.15	100
	20150427	13600	13575				13575	13575	0	0	0	0.00	100
	20150428	13575	13575	13860	13975	13860	13975	13925	400	350	26	181.06	86
	20150429	13975	13925	13775	13885	13775	13885	13800	-40	-125	8	55.21	84
	20150430	13885	13800	13885	13885	13885	13885	13885	85	85	4	27.77	80
pb1602	20150216	12695	12695				12805	12805	110	110	0	0.00	0
	20150217	12805	12805				12650	12650	-155	-155	0	0.00	0
	20150225	12650	12650				12500	12500	-150	-150	0	0.00	0
	20150226	12500	12500				12480	12480	-20	-20	0	0.00	0
	20150227	12480	12480				12480	12480	0	0	0	0.00	0
	20150302	12480	12480				12385	12385	-95	-95	0	0.00	0
	20150303	12385	12385				12425	12425	40	40	0	0.00	0
	20150304	12425	12425				12410	12410	-15	-15	0	0.00	0
	20150305	12410	12410	12390	12390	12225	12225	12305	-185	-105	4	24.62	2
	20150306	12225	12305				12305	12305	0	0	0	0.00	2
	20150309	12305	12305				12305	12305	0	0	0	0.00	2
	20150310	12305	12305				12305	12305	0	0	0	0.00	2
	20150311	12305	12305				12305	12305	0	0	0	0.00	2
	20150312	12305	12305				12345	12345	40	40	0	0.00	2
	20150313	12345	12345				12355	12355	10	10	0	0.00	2
	20150316	12355	12355	12040	12215	12000	12210	12095	-145	-260	196	1,185.43	100
	20150317	12210	12095	12150	12165	12150	12165	12150	70	55	8	48.62	100
	20150318	12165	12150				12130	12130	-20	-20	0	0.00	100
	20150319	12130	12130				12110	12110	-20	-20	0	0.00	100
	20150320	12110	12110				12130	12130	20	20	0	0.00	100
	20150323	12130	12130				12255	12255	125	125	0	0.00	100
	20150324	12255	12255				12450	12450	195	195	0	0.00	100
	20150325	12450	12450				12450	12450	0	0	0	0.00	100
	20150326	12450	12450	12470	12470	12470	12470	12470	20	20	2	12.47	100
	20150327	12470	12470				12470	12470	0	0	0	0.00	100
	20150330	12470	12470	12470	12470	12470	12470	12470	0	0	2	12.47	100
	20150331	12470	12470				12470	12470	0	0	0	0.00	100
	20150401	12470	12470				12435	12435	-35	-35	0	0.00	100
	20150402	12435	12435	12405	12405	12405	12405	12405	-30	-30	8	49.62	100
	20150403	12405	12405	12485	12485	12485	12485	12485	80	80	2	12.49	100
	20150407	12485	12485				12660	12660	175	175	0	0.00	100
	20150408	12660	12660	12770	12770	12745	12745	12750	85	90	6	38.26	100
	20150409	12745	12750				12750	12750	0	0	0	0.00	100
	20150410	12750	12750	12965	13260	12965	13260	13250	510	500	68	450.54	100
	20150413	13260	13250	13500	13500	13345	13345	13375	95	125	10	66.89	104
	20150414	13345	13375	13075	13075	13075	13075	13075	-300	-300	4	26.15	108
	20150415	13075	13075	13125	13125	13125	13125	13125	50	50	2	13.13	106
	20150416	13125	13125	13490	13500	13445	13445	13485	320	360	146	984.48	32
	20150417	13445	13485	13570	13780	13570	13780	13650	295	165	14	95.55	26
	20150420	13780	13650	13705	13710	13540	13540	13650	-110	0	6	40.96	24
	20150421	13540	13650				13555	13555	-95	-95	0	0.00	24
	20150422	13555	13555				13680	13680	125	125	0	0.00	24
	20150423	13680	13680				13580	13580	-100	-100	0	0.00	24
	20150424	13580	13580				13575	13575	-5	-5	0	0.00	24
	20150427	13575	13575				13825	13825	250	250	0	0.00	24
	20150428	13825	13825				14180	14180	355	355	0	0.00	24
	20150429	14180	14180	13720	13990	13720	13990	13855	-190	-325	4	27.71	24
	20150430	13990	13855	13865	13870	13865	13870	13865	15	10	4	27.74	22
pb1603	20150317	12095	12095				12095	12095	0	0	0	0.00	0
	20150318	12095	12095				12075	12075	-20	-20	0	0.00	0
	20150319	12075	12075				12055	12055	-20	-20	0	0.00	0
	20150320	12055	12055				11990	11990	-65	-65	0	0.00	0
	20150323	11990	11990				12250	12250	260	260	0	0.00	0
	20150324	12250	12250				12375	12375	125	125	0	0.00	0
	20150325	12375	12375				12375	12375	0	0	0	0.00	0
	20150326	12375	12375				12375	12375	0	0	0	0.00	0
	20150327	12375	12375	12575	12575	12575	12575	12575	200	200	2	12.58	2
	20150330	12575	12575	12505	12505	12505	12505	12505	-70	-70	2	12.51	4
	20150331	12505	12505				12505	12505	0	0	0	0.00	4
	20150401	12505	12505	12380	12380	12380	12380	12380	-125	-125	2	12.38	4
	20150402	12380	12380				12350	12350	-30	-30	0	0.00	4
	20150403	12350	12350				12425	12425	75	75	0	0.00	4
	20150407	12425	12425				12550	12550	125	125	0	0.00	4
	20150408	12550	12550	12775	12775	12775	12775	12775	225	225	2	12.78	6
	20150409	12775	12775	12805	12810	12785	12795	12795	20	20	8	51.20	8
	20150410	12795	12795	13010	13305	13010	13305	13210	510	415	12	79.27	18
	20150413	13305	13210	13420	13530	13420	13510	13475	300	265	20	134.77	20
	20150414	13510	13475	13100	13100	13100	13100	13100	-375	-375	4	26.20	20
	20150415	13100	13100	13120	13120	13120	13120	13120	20	20	6	39.36	18
	20150416	13120	13120	13390	13390	13390	13390	13390	270	270	2	13.39	16
	20150417	13390	13390				13525	13525	135	135	0	0.00	16
	20150420	13525	13525	13780	13780	13655	13655	13725	130	200	14	96.10	16
	20150421	13655	13725				13630	13630	-95	-95	0	0.00	16
	20150422	13630	13630	13675	13675	13675	13675	13675	45	45	2	13.68	16
	20150423	13675	13675				13580	13580	-95	-95	0	0.00	16
	20150424	13580	13580				13575	13575	-5	-5	0	0.00	16
	20150427	13575	13575				13825	13825	250	250	0	0.00	16
	20150428	13825	13825				14180	14180	355	355	0	0.00	16
	20150429	14180	14180				14180	14180	0	0	0	0.00	16
	20150430	14180	14180	13910	13910	13910	13910	13910	-270	-270	2	13.91	18
pb1604	20150416	13120	13120				13120	13120	0	0	0	0.00	0
	20150417	13120	13120				13280	13280	160	160	0	0.00	0
	20150420	13280	13280				13445	13445	165	165	0	0.00	0
	20150421	13445	13445				13350	13350	-95	-95	0	0.00	0
	20150422	13350	13350				13390	13390	40	40	0	0.00	0
	20150423	13390	13390				13295	13295	-95	-95	0	0.00	0
	20150424	13295	13295				13290	13290	-5	-5	0	0.00	0
	20150427	13290	13290				13535	13535	245	245	0	0.00	0
	20150428	13535	13535				13885	13885	350	350	0	0.00	0
	20150429	13885	13885	12800	13945	12800	13860	13555	-25	-330	26	176.24	0
	20150430	13860	13555				13645	13645	90	90	0	0.00	0
rb1501	20150105	2595	2607	2640	2640	2551	2580	2569	-27	-38	3556	9,138.35	23040
	20150106	2580	2569	2565	2620	2560	2620	2589	51	20	6300	16,312.38	21360
	20150107	2620	2589	2600	2600	2570	2580	2577	-9	-12	1860	4,793.34	19560
	20150108	2580	2577	2577	2590	2561	2561	2575	-16	-2	3000	7,727.16	16800
	20150109	2561	2575	2590	2590	2550	2550	2564	-25	-11	2640	6,770.28	14280
	20150112	2550	2564	2550	2560	2461	2461	2518	-103	-46	5040	12,692.70	11940
	20150113	2461	2518	2440	2499	2440	2480	2471	-38	-47	840	2,076.30	11700
	20150114	2480	2471	2498	2498	2372	2450	2457	-21	-14	1740	4,276.32	10860
	20150115	2450	2457	2370	2370	2370	2370	2370	-87	-87	120	284.40	10740
rb1502	20150105	2563	2567	2528	2554	2528	2554	2540	-13	-27	542	1,376.94	2090
	20150106	2554	2540	2552	2565	2535	2561	2553	21	13	1900	4,852.18	2382
	20150107	2561	2553	2538	2556	2511	2552	2541	-1	-12	694	1,763.67	1950
	20150108	2552	2541	2557	2557	2539	2547	2546	6	5	270	687.57	1804
	20150109	2547	2546	2544	2557	2525	2543	2537	-3	-9	368	933.63	1774
	20150112	2543	2537	2535	2535	2444	2444	2472	-93	-65	312	771.37	1972
	20150113	2444	2472	2445	2450	2433	2434	2444	-38	-28	608	1,486.12	2420
	20150114	2434	2444	2391	2455	2381	2386	2425	-58	-19	1406	3,410.53	2454
	20150115	2386	2425	2394	2416	2389	2412	2405	-13	-20	406	976.61	2494
	20150116	2412	2405	2395	2432	2363	2378	2388	-27	-17	506	1,208.53	2518
	20150119	2378	2388	2356	2358	2324	2342	2341	-46	-47	1244	2,913.13	2888
	20150120	2342	2341	2364	2364	2313	2317	2330	-24	-11	406	946.11	2890
	20150121	2317	2330	2327	2333	2302	2302	2323	-28	-7	268	622.83	2932
	20150122	2302	2323	2307	2313	2295	2295	2300	-28	-23	140	322.09	2928
	20150123	2295	2300	2306	2306	2291	2295	2296	-5	-4	386	886.52	2928
	20150126	2295	2296	2215	2300	2204	2205	2238	-91	-58	394	882.16	2924
	20150127	2205	2238	2215	2230	2200	2209	2220	-29	-18	512	1,136.82	2962
	20150128	2209	2220	2215	2217	2195	2209	2204	-11	-16	654	1,441.85	2962
	20150129	2209	2204	2218	2228	2201	2206	2212	2	8	568	1,256.92	2908
	20150130	2206	2212	2202	2220	2172	2175	2188	-37	-24	1572	3,440.42	2700
	20150202	2175	2188	2160	2190	2160	2190	2175	2	-13	420	913.80	2400
	20150203	2190	2175	2195	2200	2195	2200	2197	25	22	240	527.40	2400
	20150204	2200	2197	2214	2214	2202	2202	2208	5	11	960	2,120.34	2820
	20150205	2202	2208	2180	2181	2150	2170	2174	-38	-34	1440	3,131.46	2400
	20150206	2170	2174	2170	2180	2170	2180	2173	6	-1	1020	2,217.00	2400
	20150209	2180	2173	2180	2250	2180	2250	2201	77	28	1200	2,641.26	3120
	20150210	2250	2201	2200	2200	2200	2200	2200	-1	-1	60	132.00	3120
rb1503	20150105	2573	2595	2564	2564	2543	2555	2549	-40	-46	82	209.06	942
	20150106	2555	2549	2565	2619	2565	2612	2605	63	56	72	187.62	946
	20150107	2612	2605	2597	2599	2553	2562	2565	-43	-40	274	702.95	842
	20150108	2562	2565	2561	2573	2545	2553	2559	-12	-6	94	240.55	816
	20150109	2553	2559	2554	2561	2536	2550	2551	-9	-8	54	137.78	812
	20150112	2550	2551	2552	2578	2485	2485	2522	-66	-29	312	786.96	956
	20150113	2485	2522	2473	2486	2462	2467	2471	-55	-51	176	435.05	954
	20150114	2467	2471	2468	2481	2425	2450	2451	-21	-20	74	181.41	942
	20150115	2450	2451	2439	2455	2412	2441	2442	-10	-9	380	928.23	1012
	20150116	2441	2442	2442	2470	2405	2413	2432	-29	-10	558	1,357.38	1132
	20150119	2413	2432	2411	2411	2371	2405	2388	-27	-44	1796	4,290.26	2364
	20150120	2405	2388	2414	2414	2340	2340	2358	-48	-30	1250	2,948.47	3416
	20150121	2340	2358	2347	2363	2338	2347	2354	-11	-4	216	508.48	3424
	20150122	2347	2354	2354	2362	2317	2317	2339	-37	-15	148	346.26	3492
	20150123	2317	2339	2320	2350	2320	2338	2336	-1	-3	210	490.72	3460
	20150126	2338	2336	2330	2341	2265	2272	2301	-64	-35	1150	2,647.12	4050
	20150127	2272	2301	2289	2299	2281	2286	2289	-15	-12	550	1,259.41	4000
	20150128	2286	2289	2290	2294	2265	2270	2274	-19	-15	672	1,528.66	4288
	20150129	2270	2274	2275	2298	2271	2282	2282	8	8	320	730.31	4258
	20150130	2282	2282	2284	2292	2270	2272	2274	-10	-8	790	1,797.20	4694
	20150202	2272	2274	2288	2288	2251	2264	2265	-10	-9	436	987.97	4884
	20150203	2264	2265	2265	2265	2242	2242	2252	-23	-13	440	990.90	5008
	20150204	2242	2252	2234	2256	2224	2227	2241	-25	-11	1124	2,518.90	5404
	20150205	2227	2241	2237	2246	2229	2230	2232	-11	-9	356	794.82	5454
	20150206	2230	2232	2233	2239	2228	2232	2232	0	0	100	223.28	5454
	20150209	2232	2232	2235	2238	2210	2229	2229	-3	-3	222	494.85	5458
	20150210	2229	2229	2223	2254	2223	2243	2242	14	13	428	959.67	5210
	20150211	2243	2242	2237	2243	2233	2241	2242	-1	0	736	1,650.41	5230
	20150212	2241	2242	2236	2239	2231	2237	2233	-5	-9	238	531.55	5228
	20150213	2237	2233	2226	2248	2222	2238	2240	5	7	364	815.65	5228
	20150216	2238	2240	2236	2255	2233	2247	2247	7	7	332	746.30	5208
	20150217	2247	2247	2242	2255	2232	2255	2243	8	-4	440	987.24	5220
	20150225	2255	2243	2243	2243	2183	2220	2217	-23	-26	312	691.90	5172
	20150226	2220	2217	2212	2225	2212	2222	2221	5	4	1708	3,793.52	5192
	20150227	2222	2221	2201	2227	2109	2109	2208	-112	-13	4066	8,978.21	5160
	20150302	2109	2208	2131	2180	2115	2180	2132	-28	-76	2160	4,605.36	5160
	20150303	2180	2132	2131	2155	2131	2155	2141	23	9	240	513.84	5160
	20150304	2155	2141	2140	2178	2140	2152	2157	11	16	840	1,812.48	5160
	20150305	2152	2157	2148	2148	2148	2148	2148	-9	-9	120	257.76	5160
	20150306	2148	2148	2126	2126	2126	2126	2126	-22	-22	120	255.12	5160
	20150309	2126	2126	2152	2152	2134	2134	2139	8	13	300	641.70	5160
	20150310	2134	2139	2037	2124	2037	2120	2105	-19	-34	360	758.10	5160
	20150311	2120	2105	2115	2120	2100	2109	2111	4	6	780	1,646.88	5160
	20150312	2109	2111	2139	2160	2130	2160	2146	49	35	420	901.62	5160
	20150313	2160	2146	2160	2160	2160	2160	2160	14	14	480	1,036.80	4740
	20150316	2160	2160	2160	2200	2160	2200	2186	40	26	180	393.60	4680
rb1504	20150105	2600	2604	2578	2632	2501	2564	2560	-40	-44	1318	3,374.81	552
	20150106	2564	2560	2561	2629	2561	2626	2620	66	60	580	1,520.01	776
	20150107	2626	2620	2600	2600	2573	2586	2585	-34	-35	156	403.37	750
	20150108	2586	2585	2591	2601	2530	2569	2577	-16	-8	232	598.04	704
	20150109	2569	2577	2582	2584	2550	2560	2561	-17	-16	478	1,224.34	702
	20150112	2560	2561	2560	2570	2503	2503	2528	-58	-33	130	328.74	684
	20150113	2503	2528	2488	2507	2483	2496	2497	-32	-31	170	424.61	696
	20150114	2496	2497	2504	2510	2453	2481	2486	-16	-11	106	263.54	684
	20150115	2481	2486	2482	2513	2462	2512	2487	26	1	50	124.38	678
	20150116	2512	2487	2511	2511	2466	2499	2494	12	7	258	643.66	740
	20150119	2499	2494	2490	2501	2459	2500	2477	6	-17	536	1,327.95	878
	20150120	2500	2477	2495	2495	2468	2477	2478	0	1	52	128.88	880
	20150121	2477	2478	2468	2489	2451	2458	2471	-20	-7	202	499.31	962
	20150122	2458	2471	2460	2467	2451	2461	2461	-10	-10	136	334.71	986
	20150123	2461	2461	2459	2473	2447	2456	2457	-5	-4	1338	3,288.19	1382
	20150126	2456	2457	2450	2455	2367	2407	2415	-50	-42	1056	2,551.14	1798
	20150127	2407	2415	2411	2426	2409	2413	2415	-2	0	586	1,415.61	1904
	20150128	2413	2415	2415	2432	2398	2400	2411	-15	-4	626	1,509.31	1898
	20150129	2400	2411	2406	2436	2405	2435	2414	24	3	178	429.75	1894
	20150130	2435	2414	2430	2430	2410	2410	2411	-4	-3	58	139.88	1886
	20150202	2410	2411	2425	2437	2400	2424	2429	13	18	478	1,161.12	1848
	20150203	2424	2429	2413	2439	2413	2420	2426	-9	-3	248	601.86	1774
	20150204	2420	2426	2416	2439	2401	2401	2413	-25	-13	224	540.60	1724
	20150205	2401	2413	2413	2429	2400	2408	2405	-5	-8	100	240.53	1736
	20150206	2408	2405	2400	2416	2400	2405	2406	0	1	330	794.20	1720
	20150209	2405	2406	2406	2412	2375	2377	2390	-29	-16	742	1,773.44	1678
	20150210	2377	2390	2386	2394	2378	2391	2386	1	-4	486	1,159.99	1854
	20150211	2391	2386	2392	2404	2387	2396	2397	10	11	232	556.18	1826
	20150212	2396	2397	2410	2414	2387	2395	2396	-2	-1	46	110.25	1834
	20150213	2395	2396	2397	2438	2397	2431	2422	35	26	184	445.74	1784
	20150216	2431	2422	2433	2486	2433	2468	2474	46	52	428	1,059.07	1684
	20150217	2468	2474	2474	2484	2451	2451	2463	-23	-11	212	522.31	1758
	20150225	2451	2463	2428	2428	2410	2414	2414	-49	-49	428	1,033.38	1956
	20150226	2414	2414	2411	2429	2410	2421	2419	7	5	262	633.98	1822
	20150227	2421	2419	2410	2439	2370	2372	2402	-47	-17	778	1,869.31	1926
	20150302	2372	2402	2369	2369	2317	2355	2349	-47	-53	662	1,555.69	1800
	20150303	2355	2349	2368	2368	2329	2343	2346	-6	-3	40	93.86	1796
	20150304	2343	2346	2342	2368	2325	2364	2347	18	1	164	385.00	1850
	20150305	2364	2347	2364	2400	2346	2395	2380	48	33	2146	5,108.99	3078
	20150306	2395	2380	2390	2399	2368	2375	2382	-5	2	678	1,615.01	3152
	20150309	2375	2382	2374	2377	2321	2329	2344	-53	-38	1624	3,807.38	3898
	20150310	2329	2344	2329	2334	2266	2283	2303	-61	-41	698	1,608.09	4286
	20150311	2283	2303	2256	2283	2245	2270	2272	-33	-31	1962	4,458.69	3042
	20150312	2270	2272	2270	2270	2238	2242	2259	-30	-13	1586	3,584.17	2044
	20150313	2242	2259	2255	2274	2241	2258	2252	-1	-7	484	1,090.27	1706
	20150316	2258	2252	2260	2285	2251	2282	2267	30	15	256	580.46	1580
	20150317	2282	2267	2292	2306	2292	2293	2295	26	28	164	376.48	1518
	20150318	2293	2295	2288	2303	2279	2296	2289	1	-6	888	2,032.65	1082
	20150319	2296	2289	2304	2307	2282	2288	2296	-1	7	108	248.04	1032
	20150320	2288	2296	2387	2387	2288	2305	2299	9	3	236	542.74	824
	20150323	2305	2299	2326	2398	2304	2398	2344	99	45	182	426.74	784
	20150324	2398	2344	2366	2410	2300	2399	2353	55	9	264	621.33	784
	20150325	2399	2353	2377	2420	2367	2381	2382	28	29	74	176.29	804
	20150326	2381	2382	2407	2407	2362	2375	2380	-7	-2	98	233.30	790
	20150327	2375	2380	2373	2373	2346	2359	2355	-21	-25	74	174.34	756
	20150330	2359	2355	2361	2370	2350	2351	2355	-4	0	42	98.92	734
	20150331	2351	2355	2335	2456	2243	2280	2287	-75	-68	270	617.71	720
	20150401	2280	2287	2231	2299	2231	2299	2265	12	-22	120	271.80	720
	20150402	2299	2265	2300	2300	2300	2300	2300	35	35	60	138.00	720
	20150403	2300	2300				2300	2300	0	0	0	0.00	720
	20150407	2300	2300	2185	2220	2185	2220	2202	-80	-98	120	264.30	720
	20150408	2220	2202	2220	2220	2200	2200	2210	-2	8	180	397.80	720
	20150409	2200	2210				2210	2210	0	0	0	0.00	720
	20150410	2210	2210				2210	2210	0	0	0	0.00	720
	20150413	2210	2210	2199	2320	2199	2320	2259	110	49	120	271.14	600
	20150414	2320	2259				2259	2259	0	0	0	0.00	600
	20150415	2259	2259				2259	2259	0	0	0	0.00	600
rb1505	20150105	2594	2593	2550	2570	2540	2560	2556	-33	-37	2891694	7,392,201.18	2212768
	20150106	2560	2556	2551	2647	2548	2619	2612	63	56	7434538	19,424,786.65	2279112
	20150107	2619	2612	2615	2615	2568	2585	2586	-27	-26	4317868	11,168,586.00	2225372
	20150108	2585	2586	2585	2603	2563	2579	2580	-7	-6	3696668	9,540,228.68	2206252
	20150109	2579	2580	2584	2588	2546	2557	2564	-23	-16	3561070	9,131,130.60	2156408
	20150112	2557	2564	2557	2585	2501	2502	2537	-62	-27	5204600	13,208,517.54	2193666
	20150113	2502	2537	2498	2514	2483	2511	2503	-26	-34	3337222	8,356,297.32	2189134
	20150114	2511	2503	2499	2520	2456	2487	2487	-16	-16	5060470	12,588,773.60	2181418
	20150115	2487	2487	2483	2524	2472	2519	2495	32	8	4426394	11,047,746.80	2191982
	20150116	2519	2495	2519	2532	2497	2510	2512	15	17	3898388	9,795,426.26	2247512
	20150119	2510	2512	2499	2526	2470	2516	2501	4	-11	5840042	14,608,222.63	2161770
	20150120	2516	2501	2512	2528	2486	2488	2502	-13	1	3804648	9,520,675.83	2224690
	20150121	2488	2502	2485	2513	2470	2472	2493	-30	-9	4067256	10,141,292.76	2226796
	20150122	2472	2493	2461	2491	2460	2479	2481	-14	-12	3426746	8,502,286.05	2207310
	20150123	2479	2481	2478	2496	2471	2484	2483	3	2	3686640	9,156,203.18	2299782
	20150126	2484	2483	2482	2486	2441	2450	2462	-33	-21	4693054	11,554,369.38	2326654
	20150127	2450	2462	2454	2467	2449	2455	2457	-7	-5	2345892	5,764,806.60	2285488
	20150128	2455	2457	2463	2475	2454	2474	2465	17	8	2453880	6,049,075.64	2243590
	20150129	2474	2465	2472	2513	2470	2507	2495	42	30	3767108	9,402,684.99	2260960
	20150130	2507	2495	2514	2514	2491	2498	2500	3	5	2275316	5,690,309.31	2208752
	20150202	2498	2500	2503	2526	2486	2492	2496	-8	-4	2749940	6,866,410.75	2057418
	20150203	2492	2496	2496	2504	2473	2474	2488	-22	-8	2576944	6,412,353.91	1912324
	20150204	2474	2488	2480	2512	2466	2467	2484	-21	-4	2889450	7,177,962.91	1794316
	20150205	2467	2484	2480	2492	2472	2472	2480	-12	-4	1784504	4,426,105.30	1728068
	20150206	2472	2480	2476	2497	2475	2496	2487	16	7	1633356	4,062,875.92	1588346
	20150209	2496	2487	2495	2509	2465	2478	2480	-9	-7	1506170	3,736,233.84	1597580
	20150210	2478	2480	2477	2495	2476	2489	2486	9	6	826546	2,055,418.67	1507600
	20150211	2489	2486	2492	2495	2480	2490	2485	4	-1	605922	1,506,039.04	1471758
	20150212	2490	2485	2490	2495	2474	2489	2483	4	-2	691294	1,716,931.92	1460666
	20150213	2489	2483	2488	2520	2487	2514	2506	31	23	1430356	3,584,481.81	1521308
	20150216	2514	2506	2514	2549	2509	2524	2532	18	26	1218768	3,086,025.19	1552574
	20150217	2524	2532	2524	2530	2504	2521	2515	-11	-17	804402	2,023,451.39	1527150
	20150225	2521	2515	2513	2514	2475	2483	2489	-32	-26	890868	2,217,466.05	1463886
	20150226	2483	2489	2486	2509	2485	2505	2496	16	7	863160	2,154,759.47	1547910
	20150227	2505	2496	2510	2510	2462	2464	2487	-32	-9	1378260	3,428,690.05	1612236
	20150302	2464	2487	2462	2483	2426	2472	2456	-15	-31	2769934	6,804,134.06	1673788
	20150303	2472	2456	2466	2482	2452	2468	2466	12	10	1199714	2,959,643.28	1592766
	20150304	2468	2466	2464	2470	2454	2464	2461	-2	-5	693690	1,707,793.78	1584954
	20150305	2464	2461	2466	2467	2428	2447	2443	-14	-18	1213754	2,966,039.02	1519172
	20150306	2447	2443	2445	2448	2416	2418	2433	-25	-10	585192	1,423,962.71	1495696
	20150309	2418	2433	2417	2431	2385	2400	2406	-33	-27	1240642	2,985,725.89	1491716
	20150310	2400	2406	2400	2404	2352	2353	2377	-53	-29	887642	2,110,501.83	1527800
	20150311	2353	2377	2354	2375	2350	2369	2363	-8	-14	568076	1,342,703.24	1417234
	20150312	2369	2363	2371	2399	2362	2386	2382	23	19	643664	1,533,208.45	1304910
	20150313	2386	2382	2403	2403	2376	2388	2389	6	7	434066	1,037,246.73	1276322
	20150316	2388	2389	2388	2418	2380	2413	2398	24	9	506856	1,215,600.84	1217072
	20150317	2413	2398	2414	2422	2407	2410	2413	12	15	306086	738,869.32	1149468
	20150318	2410	2413	2408	2426	2400	2410	2411	-3	-2	650988	1,569,867.13	998638
	20150319	2410	2411	2407	2423	2401	2412	2412	1	1	290954	702,045.58	969330
	20150320	2412	2412	2415	2420	2408	2410	2414	-2	2	197098	475,865.82	938092
	20150323	2410	2414	2412	2470	2408	2469	2444	55	30	634862	1,552,233.55	765832
	20150324	2469	2444	2472	2485	2463	2468	2474	24	30	456390	1,129,542.94	662806
	20150325	2468	2474	2470	2475	2445	2446	2461	-28	-13	328812	809,279.11	608612
	20150326	2446	2461	2445	2452	2416	2418	2435	-43	-26	309356	753,477.10	577662
	20150327	2418	2435	2420	2428	2361	2426	2396	-9	-39	641282	1,536,833.07	518758
	20150330	2426	2396	2421	2441	2411	2419	2425	23	29	434688	1,054,318.83	482894
	20150331	2419	2425	2442	2442	2392	2392	2414	-33	-11	394652	953,054.86	424562
	20150401	2392	2414	2390	2401	2367	2371	2384	-43	-30	311098	741,675.94	380470
	20150402	2371	2384	2363	2404	2343	2351	2369	-33	-15	433616	1,027,436.62	312562
	20150403	2351	2369	2351	2379	2345	2352	2360	-17	-9	233458	550,969.48	294744
	20150407	2352	2360	2343	2352	2290	2290	2316	-70	-44	250514	580,416.55	292246
	20150408	2290	2316	2287	2307	2257	2297	2282	-19	-34	213354	486,981.61	267968
	20150409	2297	2282	2293	2296	2259	2261	2274	-21	-8	123868	281,712.85	255566
	20150410	2261	2274	2259	2265	2214	2222	2232	-52	-42	159028	355,029.78	237680
	20150413	2222	2232	2225	2274	2218	2269	2239	37	7	160718	359,995.99	223148
	20150414	2269	2239	2269	2280	2242	2266	2259	27	20	117402	265,232.85	205026
	20150415	2266	2259	2266	2278	2257	2267	2271	8	12	76132	172,905.80	190858
	20150416	2267	2271	2260	2285	2259	2281	2273	10	2	57704	131,198.42	178594
	20150417	2281	2273	2278	2300	2278	2296	2290	23	17	63026	144,352.97	162214
	20150420	2296	2290	2289	2298	2275	2280	2285	-10	-5	55504	126,853.35	153352
	20150421	2280	2285	2276	2278	2229	2239	2249	-46	-36	50348	113,267.86	148778
	20150422	2239	2249	2239	2280	2239	2275	2258	26	9	35952	81,186.77	139320
	20150423	2275	2258	2277	2278	2256	2260	2266	2	8	29746	67,409.71	131410
	20150424	2260	2266	2264	2315	2262	2297	2286	31	20	46050	105,314.92	114292
	20150427	2297	2286	2302	2310	2270	2283	2285	-3	-1	33762	77,164.38	103556
	20150428	2283	2285	2289	2290	2260	2269	2278	-16	-7	33644	76,666.67	89156
	20150429	2269	2278	2270	2272	2221	2230	2247	-48	-31	32588	73,253.41	76804
	20150430	2230	2247	2279	2279	2183	2198	2206	-49	-41	49800	109,901.91	48464
rb1506	20150105	2583	2579	2536	2562	2536	2552	2553	-27	-26	1620	4,136.67	2368
	20150106	2552	2553	2561	2654	2557	2612	2602	59	49	650	1,691.83	2314
	20150107	2612	2602	2594	2594	2567	2577	2582	-25	-20	20116	51,959.39	3524
	20150108	2577	2582	2580	2594	2559	2575	2574	-7	-8	1162	2,991.84	3350
	20150109	2575	2574	2576	2579	2545	2559	2556	-15	-18	906	2,315.87	3786
	20150112	2559	2556	2560	2578	2500	2503	2530	-53	-26	1948	4,929.63	3584
	20150113	2503	2530	2483	2514	2483	2503	2502	-27	-28	328	820.83	3570
	20150114	2503	2502	2506	2513	2448	2482	2479	-20	-23	1322	3,278.09	3782
	20150115	2482	2479	2482	2514	2469	2507	2491	28	12	1026	2,556.49	3768
	20150116	2507	2491	2513	2523	2489	2503	2507	12	16	402	1,008.00	3810
	20150119	2503	2507	2503	2524	2473	2518	2500	11	-7	894	2,235.01	3826
	20150120	2518	2500	2501	2523	2487	2488	2507	-12	7	670	1,679.75	3876
	20150121	2488	2507	2489	2509	2479	2479	2489	-28	-18	598	1,488.62	4000
	20150122	2479	2489	2471	2493	2471	2483	2487	-6	-2	674	1,676.58	3980
	20150123	2483	2487	2486	2500	2476	2484	2489	-3	2	416	1,035.55	3946
	20150126	2484	2489	2480	2491	2450	2457	2464	-32	-25	872	2,149.44	3964
	20150127	2457	2464	2466	2474	2459	2466	2464	2	0	142	349.90	3962
	20150128	2466	2464	2473	2476	2462	2475	2467	11	3	620	1,530.09	4148
	20150129	2475	2467	2478	2504	2470	2499	2488	32	21	476	1,184.70	4138
	20150130	2499	2488	2503	2503	2488	2490	2491	2	3	328	817.28	4154
	20150202	2490	2491	2492	2502	2482	2486	2489	-5	-2	322	801.63	4176
	20150203	2486	2489	2491	2498	2475	2479	2486	-10	-3	530	1,317.65	4284
	20150204	2479	2486	2486	2509	2472	2472	2483	-14	-3	432	1,073.03	4312
	20150205	2472	2483	2505	2511	2479	2479	2488	-4	5	662	1,647.38	4362
	20150206	2479	2488	2489	2498	2486	2497	2494	9	6	528	1,316.84	4102
	20150209	2497	2494	2497	2510	2476	2488	2490	-6	-4	608	1,513.95	4274
	20150210	2488	2490	2487	2497	2487	2490	2491	0	1	590	1,470.24	4218
	20150211	2490	2491	2491	2494	2483	2488	2488	-3	-3	296	736.55	4188
	20150212	2488	2488	2490	2493	2481	2490	2487	2	-1	252	626.77	4154
	20150213	2490	2487	2488	2518	2488	2515	2501	28	14	582	1,456.13	4154
	20150216	2515	2501	2516	2545	2513	2528	2532	27	31	1136	2,876.55	4280
	20150217	2528	2532	2528	2528	2502	2519	2511	-13	-21	354	889.13	4218
	20150225	2519	2511	2502	2502	2480	2488	2486	-23	-25	412	1,024.29	4178
	20150226	2488	2486	2490	2508	2488	2504	2494	18	8	742	1,851.18	4188
	20150227	2504	2494	2505	2510	2466	2466	2490	-28	-4	1048	2,609.61	4520
	20150302	2466	2490	2465	2488	2443	2480	2462	-10	-28	1806	4,447.46	4784
	20150303	2480	2462	2483	2488	2463	2477	2474	15	12	570	1,410.52	4864
	20150304	2477	2474	2475	2477	2465	2473	2471	-1	-3	466	1,151.49	4862
	20150305	2473	2471	2468	2468	2440	2450	2452	-21	-19	732	1,794.90	5018
	20150306	2450	2452	2447	2452	2424	2430	2442	-22	-10	756	1,846.79	5130
	20150309	2430	2442	2417	2434	2394	2410	2412	-32	-30	1018	2,455.47	5438
	20150310	2410	2412	2410	2411	2356	2361	2380	-51	-32	876	2,085.57	5660
	20150311	2361	2380	2358	2382	2357	2376	2369	-4	-11	792	1,876.35	5750
	20150312	2376	2369	2372	2404	2369	2396	2384	27	15	426	1,015.86	5670
	20150313	2396	2384	2409	2409	2388	2397	2398	13	14	334	800.94	5726
	20150316	2397	2398	2398	2427	2390	2422	2412	24	14	442	1,066.24	5692
	20150317	2422	2412	2419	2448	2401	2424	2421	12	9	1618	3,918.52	5698
	20150318	2424	2421	2427	2433	2409	2415	2419	-6	-2	360	870.85	5572
	20150319	2415	2419	2416	2427	2410	2418	2418	-1	-1	814	1,968.96	5734
	20150320	2418	2418	2416	2429	2416	2419	2422	1	4	280	678.28	5552
	20150323	2419	2422	2415	2471	2415	2469	2453	47	31	1052	2,581.55	5374
	20150324	2469	2453	2475	2500	2469	2476	2479	23	26	1450	3,595.61	5090
	20150325	2476	2479	2474	2481	2456	2456	2467	-23	-12	622	1,534.76	4862
	20150326	2456	2467	2430	2466	2430	2441	2454	-26	-13	654	1,605.50	4620
	20150327	2441	2454	2438	2450	2366	2450	2410	-4	-44	950	2,289.99	4342
	20150330	2450	2410	2465	2465	2428	2440	2441	30	31	394	962.04	4316
	20150331	2440	2441	2448	2449	2407	2412	2426	-29	-15	500	1,213.12	4338
	20150401	2412	2426	2405	2415	2382	2382	2399	-44	-27	510	1,223.87	4180
	20150402	2382	2399	2374	2410	2360	2363	2380	-36	-19	796	1,895.14	4118
	20150403	2363	2380	2364	2387	2364	2370	2369	-10	-11	556	1,317.69	4066
	20150407	2370	2369	2360	2360	2326	2330	2341	-39	-28	1062	2,486.93	3864
	20150408	2330	2341	2324	2340	2314	2327	2326	-14	-15	1014	2,359.24	3438
	20150409	2327	2326	2337	2337	2300	2300	2313	-26	-13	522	1,207.69	3298
	20150410	2300	2313	2276	2292	2223	2246	2267	-67	-46	772	1,750.69	3010
	20150413	2246	2267	2248	2305	2248	2302	2276	35	9	476	1,083.69	2998
	20150414	2302	2276	2309	2327	2291	2304	2314	28	38	1422	3,290.90	3252
	20150415	2304	2314	2303	2309	2292	2293	2297	-21	-17	456	1,047.77	3032
	20150416	2293	2297	2282	2299	2280	2293	2286	-4	-11	658	1,504.27	3142
	20150417	2293	2286	2292	2309	2287	2292	2294	6	8	532	1,220.82	3154
	20150420	2292	2294	2301	2303	2251	2256	2277	-38	-17	768	1,749.36	3292
	20150421	2256	2277	2254	2254	2223	2228	2238	-49	-39	442	989.47	3376
	20150422	2228	2238	2227	2282	2227	2270	2255	32	17	778	1,754.86	3442
	20150423	2270	2255	2245	2273	2179	2268	2264	13	9	536	1,213.87	3596
	20150424	2268	2264	2263	2307	2263	2301	2291	37	27	1090	2,497.55	3498
	20150427	2301	2291	2302	2315	2287	2315	2302	24	11	504	1,160.64	3510
	20150428	2315	2302	2322	2323	2293	2300	2306	-2	4	824	1,900.17	3600
	20150429	2300	2306	2308	2314	2236	2245	2278	-61	-28	782	1,781.50	3594
	20150430	2245	2278	2242	2276	2240	2249	2256	-29	-22	628	1,417.28	3692
rb1507	20150105	2609	2596	2504	2591	2504	2556	2563	-40	-33	64	164.07	422
	20150106	2556	2563	2614	2657	2613	2632	2630	69	67	30	78.91	398
	20150107	2632	2630	2603	2603	2575	2589	2592	-41	-38	54	139.99	396
	20150108	2589	2592	2595	2595	2572	2580	2576	-12	-16	26	66.99	394
	20150109	2580	2576	2579	2589	2558	2574	2562	-2	-14	116	297.23	330
	20150112	2574	2562	2462	2580	2462	2530	2555	-32	-7	212	541.83	338
	20150113	2530	2555	2521	2523	2521	2523	2522	-32	-33	6	15.13	338
	20150114	2523	2522	2526	2526	2483	2501	2497	-21	-25	28	69.94	344
	20150115	2501	2497	2502	2530	2493	2530	2512	33	15	18	45.23	336
	20150116	2530	2512	2519	2522	2517	2520	2519	8	7	60	151.17	336
	20150119	2520	2519	2495	2524	2487	2524	2504	5	-15	18	45.08	334
	20150120	2524	2504	2510	2524	2504	2504	2507	0	3	42	105.30	320
	20150121	2504	2507	2510	2522	2502	2502	2508	-5	1	28	70.24	310
	20150122	2502	2508	2498	2504	2494	2496	2498	-12	-10	32	79.96	312
	20150123	2496	2498	2510	2510	2506	2508	2508	10	10	10	25.08	310
	20150126	2508	2508	2495	2500	2468	2472	2479	-36	-29	60	148.75	302
	20150127	2472	2479	2476	2489	2476	2485	2483	6	4	34	84.44	316
	20150128	2485	2483	2487	2494	2482	2494	2486	11	3	30	74.58	310
	20150129	2494	2486	2499	2530	2499	2519	2518	33	32	80	201.44	296
	20150130	2519	2518	2517	2525	2510	2516	2513	-2	-5	50	125.68	264
	20150202	2516	2513	2532	2532	2504	2511	2511	-2	-2	50	125.59	266
	20150203	2511	2511	2513	2519	2498	2502	2508	-9	-3	40	100.35	254
	20150204	2502	2508	2508	2508	2497	2497	2501	-11	-7	34	85.06	260
	20150205	2497	2501	2514	2515	2504	2510	2510	9	9	246	617.51	472
	20150206	2510	2510	2515	2521	2514	2514	2517	4	7	36	90.63	452
	20150209	2514	2517	2517	2517	2503	2517	2511	0	-6	22	55.26	460
	20150210	2517	2511	2517	2518	2511	2514	2513	3	2	76	191.03	450
	20150211	2514	2513	2510	2515	2510	2515	2511	2	-2	28	70.33	448
	20150212	2515	2511	2505	2515	2486	2515	2505	4	-6	18	45.10	440
	20150213	2515	2505	2513	2549	2510	2541	2532	36	27	54	136.74	452
	20150216	2541	2532	2556	2569	2545	2550	2559	18	27	84	214.99	440
	20150217	2550	2559	2543	2544	2534	2544	2539	-15	-20	8	20.32	440
	20150225	2544	2539				2515	2515	-24	-24	0	0.00	440
	20150226	2515	2515	2512	2529	2512	2529	2518	14	3	14	35.25	434
	20150227	2529	2518	2528	2528	2505	2505	2516	-13	-2	98	246.62	522
	20150302	2505	2516	2502	2538	2478	2523	2509	7	-7	322	808.15	510
	20150303	2523	2509	2521	2533	2511	2518	2517	9	8	72	181.29	516
	20150304	2518	2517	2511	2516	2503	2509	2506	-8	-11	132	330.84	552
	20150305	2509	2506	2491	2493	2474	2487	2482	-19	-24	218	541.21	656
	20150306	2487	2482	2487	2488	2465	2466	2477	-16	-5	48	118.93	662
	20150309	2466	2477	2454	2454	2434	2446	2449	-31	-28	24	58.80	660
	20150310	2446	2449	2449	2449	2407	2410	2422	-39	-27	72	174.40	718
	20150311	2410	2422	2409	2423	2401	2416	2415	-6	-7	38	91.78	716
	20150312	2416	2415	2415	2442	2409	2428	2429	13	14	46	111.76	710
	20150313	2428	2429	2428	2436	2425	2431	2430	2	1	70	170.16	716
	20150316	2431	2430	2433	2450	2432	2447	2444	17	14	70	171.10	670
	20150317	2447	2444	2445	2452	2445	2451	2449	7	5	6	14.70	670
	20150318	2451	2449	2426	2452	2424	2452	2441	3	-8	28	68.37	672
	20150319	2452	2441	2453	2457	2445	2446	2447	5	6	32	78.32	658
	20150320	2446	2447	2444	2460	2444	2459	2458	12	11	56	137.66	696
	20150323	2459	2458	2457	2500	2457	2500	2481	42	23	44	109.20	674
	20150324	2500	2481	2510	2525	2510	2510	2515	29	34	28	70.42	680
	20150325	2510	2515	2504	2517	2474	2474	2502	-41	-13	144	360.30	660
	20150326	2474	2502	2486	2490	2460	2465	2470	-37	-32	76	187.74	680
	20150327	2465	2470	2460	2465	2413	2465	2434	-5	-36	164	399.32	648
	20150330	2465	2434	2487	2487	2439	2466	2463	32	29	104	256.21	640
	20150331	2466	2463	2453	2477	2441	2441	2462	-22	-1	94	231.43	668
	20150401	2441	2462	2417	2437	2417	2417	2427	-45	-35	36	87.38	672
	20150402	2417	2427	2398	2424	2378	2387	2400	-40	-27	82	196.84	692
	20150403	2387	2400	2391	2411	2379	2392	2391	-8	-9	54	129.14	696
	20150407	2392	2391	2366	2366	2332	2340	2347	-51	-44	94	220.67	696
	20150408	2340	2347	2329	2343	2314	2343	2325	-4	-22	86	200.01	696
	20150409	2343	2325	2324	2344	2324	2344	2337	19	12	6	14.02	702
	20150410	2344	2337	2303	2304	2222	2281	2263	-56	-74	164	371.26	674
	20150413	2281	2263	2273	2318	2268	2318	2286	55	23	136	310.94	636
	20150414	2318	2286	2312	2341	2308	2326	2316	40	30	122	282.66	680
	20150415	2326	2316	2315	2336	2315	2315	2326	-1	10	136	316.43	664
	20150416	2315	2326	2320	2329	2310	2321	2320	-5	-6	74	171.74	636
	20150417	2321	2320	2342	2342	2324	2324	2332	4	12	38	88.65	626
	20150420	2324	2332	2306	2334	2306	2323	2319	-9	-13	12	27.83	624
	20150421	2323	2319	2282	2313	2280	2280	2289	-39	-30	44	100.73	616
	20150422	2280	2289	2288	2323	2286	2305	2294	16	5	62	142.24	602
	20150423	2305	2294				2294	2294	0	0	0	0.00	602
	20150424	2294	2294	2324	2358	2320	2330	2324	36	30	128	297.48	570
	20150427	2330	2324	2360	2371	2316	2325	2329	1	5	162	377.32	576
	20150428	2325	2329	2349	2388	2337	2339	2355	10	26	108	254.37	566
	20150429	2339	2355	2326	2356	2251	2251	2328	-104	-27	206	479.57	630
	20150430	2251	2328	2297	2321	2274	2276	2288	-52	-40	138	315.80	626
rb1508	20150105	2600	2598	2546	2597	2501	2584	2551	-14	-47	756	1,928.63	212
	20150106	2584	2551	2565	2653	2565	2617	2620	66	69	138	361.59	192
	20150107	2617	2620	2585	2612	2585	2601	2600	-19	-20	10	26.00	192
	20150108	2601	2600	2601	2603	2594	2594	2600	-6	0	16	41.61	200
	20150109	2594	2600	2602	2602	2601	2601	2601	1	1	4	10.41	202
	20150112	2601	2601	2587	2608	2534	2534	2558	-67	-43	62	158.64	230
	20150113	2534	2558	2527	2527	2527	2527	2527	-31	-31	2	5.05	228
	20150114	2527	2527	2537	2547	2505	2505	2514	-22	-13	74	186.09	288
	20150115	2505	2514	2530	2530	2530	2530	2530	16	16	2	5.06	288
	20150116	2530	2530	2554	2554	2533	2549	2546	19	16	14	35.65	290
	20150119	2549	2546	2532	2556	2523	2556	2537	10	-9	18	45.68	288
	20150120	2556	2537	2550	2550	2519	2536	2532	-1	-5	56	141.81	282
	20150121	2536	2532	2520	2540	2520	2529	2527	-3	-5	12	30.33	280
	20150122	2529	2527	2518	2518	2496	2515	2510	-12	-17	40	100.44	264
	20150123	2515	2510	2515	2517	2510	2515	2514	5	4	10	25.14	264
	20150126	2515	2514	2490	2490	2490	2490	2490	-24	-24	20	49.80	264
	20150127	2490	2490	2496	2496	2496	2496	2496	6	6	2	4.99	264
	20150128	2496	2496	2485	2496	2485	2496	2490	0	-6	22	54.78	274
	20150129	2496	2490				2490	2490	0	0	0	0.00	274
	20150130	2490	2490	2522	2522	2521	2521	2521	31	31	16	40.35	284
	20150202	2521	2521	2602	2602	2497	2514	2534	-7	13	8	20.28	284
	20150203	2514	2534				2534	2534	0	0	0	0.00	284
	20150204	2534	2534	2519	2519	2518	2518	2518	-16	-16	10	25.19	280
	20150205	2518	2518				2518	2518	0	0	0	0.00	280
	20150206	2518	2518				2518	2518	0	0	0	0.00	280
	20150209	2518	2518	2558	2559	2530	2531	2544	13	26	44	111.94	280
	20150210	2531	2544				2544	2544	0	0	0	0.00	280
	20150211	2544	2544				2544	2544	0	0	0	0.00	280
	20150212	2544	2544				2535	2535	-9	-9	0	0.00	280
	20150213	2535	2535				2535	2535	0	0	0	0.00	280
	20150216	2535	2535	2586	2598	2586	2598	2588	63	53	12	31.06	268
	20150217	2598	2588	2572	2579	2563	2576	2573	-12	-15	80	205.88	288
	20150225	2576	2573	2527	2535	2527	2535	2531	-38	-42	4	10.12	286
	20150226	2535	2531	2556	2556	2547	2547	2551	16	20	6	15.31	284
	20150227	2547	2551	2545	2569	2543	2543	2565	-8	14	234	600.39	466
	20150302	2543	2565	2530	2559	2500	2556	2539	-9	-26	74	187.91	484
	20150303	2556	2539	2578	2578	2547	2548	2555	9	16	56	143.09	458
	20150304	2548	2555				2555	2555	0	0	0	0.00	458
	20150305	2555	2555	2535	2535	2515	2515	2522	-40	-33	50	126.13	460
	20150306	2515	2522	2519	2519	2480	2480	2498	-42	-24	224	559.68	388
	20150309	2480	2498	2477	2477	2456	2456	2474	-42	-24	72	178.13	438
	20150310	2456	2474	2476	2476	2445	2445	2472	-29	-2	30	74.17	468
	20150311	2445	2472	2460	2477	2459	2477	2463	5	-9	58	142.88	452
	20150312	2477	2463	2481	2481	2481	2481	2481	18	18	20	49.62	432
	20150313	2481	2481				2481	2481	0	0	0	0.00	432
	20150316	2481	2481	2517	2517	2517	2517	2517	36	36	14	35.24	438
	20150317	2517	2517	2517	2540	2517	2522	2525	5	8	22	55.55	438
	20150318	2522	2525	2504	2518	2491	2494	2504	-31	-21	22	55.09	444
	20150319	2494	2504	2488	2498	2488	2498	2493	-6	-11	30	74.80	440
	20150320	2498	2493	2499	2503	2487	2500	2495	7	2	44	109.80	442
	20150323	2500	2495	2518	2521	2517	2521	2519	26	24	10	25.19	440
	20150324	2521	2519	2547	2547	2547	2547	2547	28	28	4	10.19	436
	20150325	2547	2547	2531	2532	2531	2532	2531	-15	-16	8	20.25	438
	20150326	2532	2531	2519	2519	2496	2496	2511	-35	-20	8	20.09	438
	20150327	2496	2511	2486	2486	2448	2471	2477	-40	-34	24	59.45	440
	20150330	2471	2477	2471	2499	2450	2475	2470	-2	-7	866	2,139.19	460
	20150331	2475	2470	2481	2481	2458	2458	2465	-12	-5	36	88.74	436
	20150401	2458	2465	2459	2459	2424	2424	2441	-41	-24	18	43.94	434
	20150402	2424	2441	2404	2413	2371	2371	2398	-70	-43	230	551.58	598
	20150403	2371	2398	2395	2395	2370	2370	2388	-28	-10	18	42.99	598
	20150407	2370	2388	2381	2381	2351	2351	2361	-37	-27	60	141.69	588
	20150408	2351	2361	2341	2341	2323	2341	2340	-20	-21	44	102.97	588
	20150409	2341	2340	2345	2345	2331	2331	2338	-9	-2	12	28.06	590
	20150410	2331	2338	2311	2326	2281	2299	2302	-39	-36	134	308.55	586
	20150413	2299	2302	2286	2364	2278	2344	2295	42	-7	80	183.61	556
	20150414	2344	2295				2303	2303	8	8	0	0.00	556
	20150415	2303	2303	2334	2349	2283	2311	2320	8	17	62	143.86	506
	20150416	2311	2320	2309	2335	2309	2335	2325	15	5	26	60.45	496
	20150417	2335	2325	2312	2335	2312	2323	2322	-2	-3	44	102.18	468
	20150420	2323	2322	2303	2343	2295	2295	2315	-27	-7	44	101.88	454
	20150421	2295	2315	2289	2318	2281	2281	2296	-34	-19	6	13.78	454
	20150422	2281	2296	2303	2330	2303	2330	2313	34	17	6	13.88	450
	20150423	2330	2313	2340	2348	2314	2337	2337	24	24	38	88.83	428
	20150424	2337	2337	2353	2363	2350	2363	2353	26	16	16	37.65	428
	20150427	2363	2353	2396	2396	2386	2386	2391	33	38	12	28.70	430
	20150428	2386	2391	2424	2424	2369	2399	2410	8	19	90	216.95	460
	20150429	2399	2410	2378	2395	2338	2362	2372	-48	-38	128	303.73	460
	20150430	2362	2372	2369	2375	2355	2368	2370	-4	-2	52	123.26	480
rb1509	20150105	2625	2624	2601	2608	2584	2592	2599	-32	-25	1260	3,275.56	3430
	20150106	2592	2599	2590	2658	2588	2647	2639	48	40	2246	5,928.25	3440
	20150107	2647	2639	2630	2679	2605	2623	2619	-16	-20	2102	5,505.77	3536
	20150108	2623	2619	2626	2633	2600	2615	2613	-4	-6	594	1,552.52	3498
	20150109	2615	2613	2619	2619	2589	2597	2600	-16	-13	1992	5,179.80	2984
	20150112	2597	2600	2593	2617	2543	2543	2569	-57	-31	998	2,564.67	3120
	20150113	2543	2569	2542	2554	2529	2545	2541	-24	-28	1350	3,431.47	3068
	20150114	2545	2541	2536	2551	2494	2530	2523	-11	-18	1450	3,658.61	3042
	20150115	2530	2523	2506	2554	2506	2552	2527	29	4	552	1,394.97	3058
	20150116	2552	2527	2558	2563	2523	2550	2536	23	9	2236	5,672.31	3044
	20150119	2550	2536	2539	2557	2515	2546	2536	10	0	1514	3,840.36	2930
	20150120	2546	2536	2544	2550	2522	2528	2531	-8	-5	2942	7,447.34	2930
	20150121	2528	2531	2528	2545	2514	2514	2530	-17	-1	594	1,503.25	2988
	20150122	2514	2530	2514	2529	2507	2516	2520	-14	-10	952	2,399.73	2554
	20150123	2516	2520	2521	2530	2510	2510	2521	-10	1	662	1,669.33	2636
	20150126	2510	2521	2520	2521	2491	2493	2505	-28	-16	832	2,084.49	2382
	20150127	2493	2505	2496	2515	2496	2506	2505	1	0	670	1,678.48	2620
	20150128	2506	2505	2509	2515	2499	2511	2506	6	1	506	1,268.44	2340
	20150129	2511	2506	2513	2555	2511	2541	2537	35	31	892	2,263.66	2208
	20150130	2541	2537	2540	2550	2531	2533	2539	-4	2	238	604.46	2116
	20150202	2533	2539	2541	2548	2523	2545	2538	6	-1	504	1,279.31	2244
	20150203	2545	2538	2542	2559	2531	2544	2544	6	6	1778	4,524.98	2266
	20150204	2544	2544	2545	2581	2542	2545	2560	1	16	868	2,222.81	2420
	20150205	2545	2560	2559	2571	2552	2553	2560	-7	0	1700	4,353.24	3042
	20150206	2553	2560	2553	2572	2544	2563	2558	3	-2	1144	2,926.93	2922
	20150209	2563	2558	2559	2587	2530	2554	2549	-4	-9	7266	18,524.46	3230
	20150210	2554	2549	2555	2569	2553	2566	2558	17	9	1266	3,239.44	2894
	20150211	2566	2558	2564	2564	2555	2563	2560	5	2	354	906.27	2760
	20150212	2563	2560	2565	2565	2544	2555	2551	-5	-9	330	841.95	2774
	20150213	2555	2551	2559	2577	2551	2576	2563	25	12	396	1,015.30	2732
	20150216	2576	2563	2569	2607	2569	2593	2590	30	27	756	1,958.72	2656
	20150217	2593	2590	2593	2594	2574	2586	2583	-4	-7	878	2,268.17	2826
	20150225	2586	2583	2579	2579	2549	2557	2560	-26	-23	464	1,188.15	2800
	20150226	2557	2560	2564	2587	2562	2587	2577	27	17	4784	12,330.80	3784
	20150227	2587	2577	2584	2596	2557	2557	2577	-20	0	1868	4,814.99	3152
	20150302	2557	2577	2556	2588	2532	2588	2557	11	-20	4686	11,984.54	3328
	20150303	2588	2557	2588	2598	2561	2575	2582	18	25	3486	9,001.24	3576
	20150304	2575	2582	2580	2581	2563	2570	2572	-12	-10	1942	4,996.28	3012
	20150305	2570	2572	2561	2564	2521	2528	2533	-44	-39	2280	5,777.22	3416
	20150306	2528	2533	2522	2538	2490	2490	2514	-43	-19	1740	4,375.01	3486
	20150309	2490	2514	2486	2508	2455	2494	2489	-20	-25	4078	10,151.40	3886
	20150310	2494	2489	2490	2500	2457	2462	2484	-27	-5	1662	4,129.68	4426
	20150311	2462	2484	2460	2483	2453	2476	2467	-8	-17	1216	3,000.93	4260
	20150312	2476	2467	2516	2516	2474	2502	2496	35	29	2996	7,479.66	4248
	20150313	2502	2496	2502	2523	2491	2500	2506	4	10	1210	3,032.90	4114
	20150316	2500	2506	2496	2536	2423	2527	2503	21	-3	5356	13,409.82	3636
	20150317	2527	2503	2524	2556	2515	2519	2523	16	20	1542	3,891.00	3778
	20150318	2519	2523	2525	2541	2483	2492	2506	-31	-17	2442	6,120.19	4090
	20150319	2492	2506	2485	2508	2484	2492	2495	-14	-11	2702	6,741.99	4112
	20150320	2492	2495	2489	2506	2489	2496	2496	1	1	1436	3,585.04	4406
	20150323	2496	2496	2497	2566	2487	2555	2527	59	31	3204	8,098.05	4266
	20150324	2555	2527	2551	2580	2550	2553	2562	26	35	3666	9,395.49	3902
	20150325	2553	2562	2554	2557	2517	2522	2539	-40	-23	1100	2,793.47	4104
	20150326	2522	2539	2515	2526	2505	2510	2514	-29	-25	1756	4,415.53	4708
	20150327	2510	2514	2510	2511	2431	2495	2472	-19	-42	3174	7,846.78	4588
	20150330	2495	2472	2492	2515	2465	2485	2491	13	19	2394	5,964.88	5152
	20150331	2485	2491	2493	2507	2455	2471	2478	-20	-13	2298	5,695.44	5736
	20150401	2471	2478	2453	2466	2420	2425	2442	-53	-36	6668	16,287.09	5932
	20150402	2425	2442	2401	2433	2386	2388	2406	-54	-36	4304	10,357.50	6682
	20150403	2388	2406	2394	2418	2389	2393	2401	-13	-5	6020	14,457.73	6978
	20150407	2393	2401	2420	2420	2363	2364	2382	-37	-19	6704	15,970.71	8326
	20150408	2364	2382	2357	2384	2341	2374	2363	-8	-19	4250	10,046.31	8112
	20150409	2374	2363	2368	2372	2326	2340	2346	-23	-17	3414	8,011.12	8218
	20150410	2340	2346	2398	2398	2305	2305	2333	-41	-13	2964	6,915.86	8014
	20150413	2305	2333	2296	2368	2295	2366	2330	33	-3	4412	10,283.23	8236
	20150414	2366	2330	2359	2375	2340	2360	2354	30	24	3388	7,978.20	7818
	20150415	2360	2354	2364	2364	2335	2335	2352	-19	-2	1648	3,876.11	8008
	20150416	2335	2352	2328	2365	2328	2355	2345	3	-7	2372	5,564.55	7978
	20150417	2355	2345	2359	2368	2345	2346	2354	1	9	2084	4,907.50	8096
	20150420	2346	2354	2333	2349	2321	2325	2335	-29	-19	3738	8,729.66	8192
	20150421	2325	2335	2334	2334	2315	2326	2322	-9	-13	1478	3,432.91	8254
	20150422	2326	2322	2326	2376	2324	2370	2350	48	28	4812	11,312.00	8300
	20150423	2370	2350	2368	2373	2350	2359	2363	9	13	3988	9,423.96	8252
	20150424	2359	2363	2369	2402	2355	2400	2386	37	23	5202	12,417.01	8000
	20150427	2400	2386	2400	2424	2392	2419	2407	33	21	5900	14,202.91	7958
	20150428	2419	2407	2421	2435	2403	2414	2419	7	12	4086	9,884.74	8438
	20150429	2414	2419	2410	2419	2355	2363	2391	-56	-28	5008	11,975.48	9018
	20150430	2363	2391	2365	2393	2364	2380	2378	-11	-13	4222	10,042.16	8972
rb1510	20150105	2617	2616	2583	2598	2574	2589	2587	-27	-29	159400	412,456.39	373514
	20150106	2589	2587	2586	2658	2582	2639	2632	52	45	381522	1,004,522.46	412966
	20150107	2639	2632	2640	2640	2596	2609	2610	-23	-22	244838	639,248.97	426810
	20150108	2609	2610	2612	2626	2590	2602	2604	-8	-6	191572	499,027.11	431114
	20150109	2602	2604	2605	2610	2572	2579	2588	-25	-16	226614	586,526.19	420142
	20150112	2579	2588	2579	2603	2521	2521	2551	-67	-37	322214	822,111.02	416204
	20150113	2521	2551	2512	2529	2504	2520	2519	-31	-32	182992	460,969.00	416720
	20150114	2520	2519	2514	2532	2472	2506	2499	-13	-20	299684	749,170.34	415966
	20150115	2506	2499	2506	2534	2491	2531	2511	32	12	246296	618,657.06	435844
	20150116	2531	2511	2535	2541	2513	2528	2526	17	15	189006	477,544.87	439356
	20150119	2528	2526	2519	2538	2494	2528	2520	2	-6	341826	861,623.96	447466
	20150120	2528	2520	2525	2534	2503	2504	2515	-16	-5	200508	504,292.61	460264
	20150121	2504	2515	2503	2524	2496	2496	2510	-19	-5	225174	565,322.93	471244
	20150122	2496	2510	2493	2510	2487	2502	2501	-8	-9	188644	471,880.09	472922
	20150123	2502	2501	2503	2517	2500	2506	2508	5	7	262406	658,185.36	490984
	20150126	2506	2508	2500	2510	2480	2485	2493	-23	-15	297910	742,756.35	485628
	20150127	2485	2493	2485	2510	2483	2495	2497	2	4	187090	467,277.69	500418
	20150128	2495	2497	2500	2509	2491	2502	2502	5	5	158610	396,865.89	517100
	20150129	2502	2502	2504	2550	2502	2536	2531	34	29	318434	806,049.04	555280
	20150130	2536	2531	2538	2544	2524	2525	2532	-6	1	200216	506,951.19	593046
	20150202	2525	2532	2525	2545	2519	2538	2530	6	-2	301502	762,921.23	647554
	20150203	2538	2530	2537	2554	2532	2540	2541	10	11	474088	1,205,060.44	707214
	20150204	2540	2541	2544	2577	2538	2538	2554	-3	13	797746	2,037,856.21	808856
	20150205	2538	2554	2549	2565	2542	2542	2551	-12	-3	559858	1,428,274.98	829098
	20150206	2542	2551	2542	2562	2532	2556	2548	5	-3	642274	1,636,905.97	831102
	20150209	2556	2548	2557	2581	2536	2546	2553	-2	5	737512	1,883,592.60	869678
	20150210	2546	2553	2547	2562	2544	2558	2555	5	2	339944	868,559.89	853104
	20150211	2558	2555	2556	2561	2548	2558	2554	3	-1	259518	662,820.87	845356
	20150212	2558	2554	2560	2560	2538	2548	2545	-6	-9	422212	1,074,909.82	857632
	20150213	2548	2545	2549	2568	2543	2567	2557	22	12	651856	1,667,130.00	831120
	20150216	2567	2557	2565	2603	2563	2586	2585	29	28	657396	1,699,696.13	869244
	20150217	2586	2585	2589	2589	2565	2580	2574	-5	-11	371536	956,559.46	877762
	20150225	2580	2574	2574	2574	2546	2552	2555	-22	-19	335242	856,816.85	871382
	20150226	2552	2555	2555	2578	2553	2578	2565	23	10	454852	1,166,997.86	933490
	20150227	2578	2565	2578	2591	2553	2555	2572	-10	7	902284	2,321,450.68	1004416
	20150302	2555	2572	2556	2584	2527	2583	2554	11	-18	2084120	5,324,353.14	1247070
	20150303	2583	2554	2582	2597	2561	2573	2579	19	25	1818088	4,690,399.24	1216020
	20150304	2573	2579	2573	2579	2559	2565	2569	-14	-10	1204940	3,096,401.44	1253304
	20150305	2565	2569	2563	2568	2514	2523	2533	-46	-36	2670808	6,766,091.00	1449742
	20150306	2523	2533	2523	2535	2484	2485	2509	-48	-24	1954442	4,903,706.11	1552054
	20150309	2485	2509	2478	2506	2462	2486	2484	-23	-25	3254646	8,084,825.08	1562434
	20150310	2486	2484	2483	2493	2449	2453	2471	-31	-13	2391878	5,912,255.50	1599006
	20150311	2453	2471	2451	2478	2449	2471	2464	0	-7	2204398	5,433,760.79	1579462
	20150312	2471	2464	2474	2507	2464	2496	2487	32	23	2646136	6,581,305.07	1572834
	20150313	2496	2487	2505	2516	2485	2493	2500	6	13	2484292	6,212,286.99	1594010
	20150316	2493	2500	2491	2524	2480	2520	2503	20	3	2887758	7,228,065.01	1765824
	20150317	2520	2503	2520	2524	2505	2512	2514	9	11	2039234	5,127,979.87	1737060
	20150318	2512	2514	2511	2522	2473	2483	2498	-31	-16	4334196	10,828,133.19	1725474
	20150319	2483	2498	2480	2502	2474	2482	2486	-16	-12	2041408	5,076,307.99	1706378
	20150320	2482	2486	2482	2498	2477	2481	2487	-5	1	1774980	4,415,284.14	1725054
	20150323	2481	2487	2483	2549	2471	2548	2519	61	32	4785718	12,058,488.01	1922120
	20150324	2548	2519	2550	2574	2538	2542	2552	23	33	4221476	10,774,189.44	2103290
	20150325	2542	2552	2538	2547	2505	2507	2526	-45	-26	3109514	7,856,298.36	2088390
	20150326	2507	2526	2502	2514	2488	2491	2500	-35	-26	2949506	7,375,938.66	2092662
	20150327	2491	2500	2495	2495	2407	2477	2455	-23	-45	6043130	14,839,073.54	2110134
	20150330	2477	2455	2472	2498	2450	2451	2469	-4	14	4261190	10,522,839.72	2159268
	20150331	2451	2469	2471	2477	2414	2431	2445	-38	-24	5247554	12,831,535.38	2429446
	20150401	2431	2445	2423	2428	2381	2390	2406	-55	-39	5869210	14,122,211.11	2739722
	20150402	2390	2406	2377	2399	2339	2342	2367	-64	-39	7905188	18,717,646.31	3041786
	20150403	2342	2367	2343	2374	2336	2341	2353	-26	-14	6098706	14,352,467.11	3145268
	20150407	2341	2353	2330	2343	2309	2311	2324	-42	-29	4374424	10,167,361.87	3624170
	20150408	2311	2324	2306	2335	2284	2324	2308	0	-16	7162492	16,536,844.96	3625926
	20150409	2324	2308	2323	2326	2287	2290	2302	-18	-6	4823818	11,106,639.94	3685426
	20150410	2290	2302	2291	2298	2266	2266	2280	-36	-22	4749620	10,833,324.55	3800820
	20150413	2266	2280	2263	2334	2262	2329	2292	49	12	8377910	19,209,854.64	3799408
	20150414	2329	2292	2335	2341	2302	2324	2321	32	29	7287328	16,914,577.40	3703712
	20150415	2324	2321	2327	2331	2294	2297	2315	-24	-6	4532636	10,496,776.07	3771342
	20150416	2297	2315	2296	2329	2291	2318	2312	3	-3	5042842	11,663,976.35	3630552
	20150417	2318	2312	2317	2335	2309	2311	2319	-1	7	4649630	10,784,192.27	3584152
	20150420	2311	2319	2305	2314	2278	2279	2297	-40	-22	6266020	14,393,744.76	3845800
	20150421	2279	2297	2277	2291	2270	2281	2280	-16	-17	4252402	9,697,866.22	3929950
	20150422	2281	2280	2282	2334	2282	2327	2308	47	28	6974766	16,103,729.87	3866734
	20150423	2327	2308	2328	2332	2306	2323	2322	15	14	5507632	12,790,372.41	3594430
	20150424	2323	2322	2325	2388	2324	2378	2365	56	43	9322642	22,052,713.44	3359744
	20150427	2378	2365	2384	2413	2366	2408	2389	43	24	8738302	20,884,537.93	3280756
	20150428	2408	2389	2417	2430	2384	2398	2406	9	17	5879950	14,151,798.90	3175130
	20150429	2398	2406	2398	2412	2331	2340	2373	-66	-33	7285772	17,294,530.16	3156726
	20150430	2340	2373	2346	2377	2341	2365	2360	-8	-13	5412820	12,779,328.19	3017818
rb1511	20150105	2612	2611	2584	2588	2576	2578	2583	-33	-28	72	186.01	972
	20150106	2578	2583	2587	2648	2584	2630	2619	47	36	326	853.93	1084
	20150107	2630	2619	2614	2614	2595	2601	2604	-18	-15	30	78.14	1066
	20150108	2601	2604	2625	2625	2590	2602	2596	-2	-8	250	649.07	1094
	20150109	2602	2596	2599	2601	2574	2583	2580	-13	-16	186	480.01	1106
	20150112	2583	2580	2592	2593	2516	2522	2542	-58	-38	226	574.61	1224
	20150113	2522	2542	2509	2522	2509	2510	2515	-32	-27	94	236.49	1242
	20150114	2510	2515	2510	2526	2469	2497	2492	-18	-23	264	658.14	1222
	20150115	2497	2492	2495	2529	2486	2529	2499	37	7	54	134.98	1230
	20150116	2529	2499	2527	2527	2516	2516	2520	17	21	16	40.33	1220
	20150119	2516	2520	2504	2529	2498	2529	2508	9	-12	50	125.41	1236
	20150120	2529	2508	2512	2519	2503	2503	2510	-5	2	24	60.24	1238
	20150121	2503	2510	2500	2515	2495	2501	2501	-9	-9	124	310.22	1232
	20150122	2501	2501	2501	2504	2497	2498	2499	-3	-2	58	144.96	1248
	20150123	2498	2499	2508	2515	2498	2504	2502	5	3	32	80.07	1230
	20150126	2504	2502	2504	2510	2482	2482	2497	-20	-5	44	109.90	1230
	20150127	2482	2497	2500	2500	2495	2500	2498	3	1	8	19.99	1224
	20150128	2500	2498	2502	2513	2502	2509	2505	11	7	16	40.09	1216
	20150129	2509	2505	2506	2544	2502	2534	2530	29	25	88	222.68	1176
	20150130	2534	2530	2538	2540	2519	2519	2523	-11	-7	84	211.98	1238
	20150202	2519	2523	2533	2533	2517	2531	2524	8	1	106	267.55	1244
	20150203	2531	2524	2533	2533	2532	2532	2532	8	8	6	15.19	1244
	20150204	2532	2532	2548	2570	2536	2536	2552	4	20	58	148.06	1222
	20150205	2536	2552	2543	2555	2541	2541	2547	-11	-5	32	81.53	1230
	20150206	2541	2547	2541	2552	2531	2550	2547	3	0	52	132.47	1230
	20150209	2550	2547	2559	2559	2541	2541	2549	-6	2	86	219.25	1248
	20150210	2541	2549	2549	2560	2549	2560	2554	11	5	148	378.07	1264
	20150211	2560	2554	2562	2562	2552	2558	2553	4	-1	116	296.19	1356
	20150212	2558	2553	2549	2549	2545	2545	2545	-8	-8	22	56.00	1362
	20150213	2545	2545	2544	2585	2544	2585	2566	40	21	320	821.21	1462
	20150216	2585	2566	2577	2615	2572	2592	2588	26	22	124	321.02	1384
	20150217	2592	2588	2577	2580	2572	2580	2577	-8	-11	40	103.10	1364
	20150225	2580	2577	2554	2564	2554	2564	2556	-13	-21	8	20.45	1360
	20150226	2564	2556	2565	2567	2563	2567	2564	11	8	30	76.94	1356
	20150227	2567	2564	2575	2575	2554	2566	2567	2	3	10	25.67	1362
	20150302	2566	2567	2550	2579	2550	2579	2565	12	-2	236	605.49	1552
	20150303	2579	2565	2595	2599	2569	2583	2583	18	18	428	1,105.89	1336
	20150304	2583	2583	2565	2575	2561	2565	2566	-18	-17	62	159.15	1320
	20150305	2565	2566	2547	2549	2520	2524	2536	-42	-30	168	426.12	1412
	20150306	2524	2536	2520	2533	2494	2494	2512	-42	-24	54	135.66	1398
	20150309	2494	2512	2469	2494	2462	2494	2472	-18	-40	172	425.34	1386
	20150310	2494	2472	2491	2497	2451	2451	2465	-21	-7	120	295.80	1368
	20150311	2451	2465	2500	2500	2461	2477	2465	12	0	60	147.90	1376
	20150312	2477	2465	2478	2500	2475	2500	2483	35	18	196	486.71	1310
	20150313	2500	2483	2502	2510	2490	2495	2503	12	20	98	245.35	1350
	20150316	2495	2503	2495	2520	2495	2520	2509	17	6	6	15.06	1350
	20150317	2520	2509	2523	2523	2507	2509	2514	0	5	108	271.62	1416
	20150318	2509	2514	2507	2524	2480	2490	2503	-24	-11	158	395.58	1404
	20150319	2490	2503	2484	2497	2480	2489	2493	-14	-10	234	583.54	1538
	20150320	2489	2493	2498	2501	2498	2501	2499	8	6	10	24.99	1538
	20150323	2501	2499	2490	2545	2490	2545	2509	46	10	214	537.13	1526
	20150324	2545	2509	2559	2570	2536	2543	2556	34	47	182	465.27	1482
	20150325	2543	2556	2533	2533	2509	2509	2517	-47	-39	54	135.97	1482
	20150326	2509	2517	2512	2516	2503	2505	2509	-12	-8	126	316.14	1428
	20150327	2505	2509	2488	2491	2404	2490	2448	-19	-61	290	710.15	1402
	20150330	2490	2448	2497	2497	2460	2482	2483	34	35	38	94.38	1404
	20150331	2482	2483	2467	2478	2440	2453	2456	-30	-27	292	717.16	1434
	20150401	2453	2456	2426	2439	2404	2404	2424	-52	-32	82	198.81	1420
	20150402	2404	2424	2383	2409	2351	2351	2387	-73	-37	1186	2,831.11	1492
	20150403	2351	2387	2366	2380	2343	2370	2373	-17	-14	1054	2,501.57	2368
	20150407	2370	2373	2357	2357	2340	2348	2349	-25	-24	454	1,066.49	2542
	20150408	2348	2349	2337	2363	2325	2357	2343	8	-6	204	478.15	2556
	20150409	2357	2343	2355	2355	2328	2339	2340	-4	-3	130	304.23	2526
	20150410	2339	2340	2329	2338	2306	2309	2320	-31	-20	266	617.18	2516
	20150413	2309	2320	2309	2365	2305	2365	2312	45	-8	920	2,127.44	2596
	20150414	2365	2312	2352	2374	2339	2356	2356	44	44	138	325.22	2590
	20150415	2356	2356	2357	2357	2335	2335	2349	-21	-7	56	131.54	2590
	20150416	2335	2349	2339	2361	2337	2350	2350	1	1	108	253.90	2550
	20150417	2350	2350	2357	2369	2340	2344	2344	-6	-6	556	1,303.71	2506
	20150420	2344	2344	2333	2340	2313	2313	2328	-31	-16	204	474.94	2524
	20150421	2313	2328	2292	2308	2280	2301	2294	-27	-34	298	683.86	2618
	20150422	2301	2294	2297	2347	2297	2344	2315	50	21	354	819.68	2838
	20150423	2344	2315	2340	2342	2327	2337	2333	22	18	278	648.77	2846
	20150424	2337	2333	2314	2400	2314	2394	2375	61	42	792	1,881.19	2902
	20150427	2394	2375	2398	2433	2384	2426	2403	51	28	562	1,350.59	2928
	20150428	2426	2403	2430	2439	2410	2417	2421	14	18	432	1,045.89	2810
	20150429	2417	2421	2410	2430	2360	2372	2404	-49	-17	248	596.25	2862
	20150430	2372	2404	2382	2401	2377	2388	2386	-16	-18	142	338.82	2854
rb1512	20150105	2622	2619	2613	2613	2578	2598	2598	-21	-21	14	36.38	46
	20150106	2598	2598				2598	2598	0	0	0	0.00	46
	20150107	2598	2598	2600	2604	2600	2604	2602	6	4	4	10.41	44
	20150108	2604	2602	2608	2608	2598	2598	2601	-4	-1	6	15.61	46
	20150109	2598	2601	2602	2608	2588	2599	2598	-2	-3	30	77.96	56
	20150112	2599	2598	2596	2614	2540	2540	2575	-58	-23	50	128.75	64
	20150113	2540	2575	2535	2547	2530	2530	2534	-45	-41	66	167.28	96
	20150114	2530	2534	2522	2550	2488	2510	2508	-24	-26	76	190.62	106
	20150115	2510	2508	2508	2529	2484	2528	2518	20	10	16	40.29	102
	20150116	2528	2518	2544	2544	2534	2541	2540	23	22	10	25.41	104
	20150119	2541	2540				2539	2539	-1	-1	0	0.00	104
	20150120	2539	2539	2550	2550	2523	2540	2534	1	-5	28	70.95	104
	20150121	2540	2534	2539	2542	2513	2541	2532	7	-2	36	91.17	104
	20150122	2541	2532	2529	2529	2487	2521	2513	-11	-19	196	492.72	108
	20150123	2521	2513				2513	2513	0	0	0	0.00	108
	20150126	2513	2513	2507	2507	2493	2507	2503	-6	-10	8	20.03	108
	20150127	2507	2503	2523	2523	2523	2523	2523	20	20	2	5.05	108
	20150128	2523	2523	2527	2527	2527	2527	2527	4	4	2	5.05	108
	20150129	2527	2527	2530	2554	2529	2554	2542	27	15	14	35.59	106
	20150130	2554	2542	2544	2544	2544	2544	2544	2	2	6	15.26	106
	20150202	2544	2544	2625	2625	2515	2539	2553	-5	9	22	56.17	110
	20150203	2539	2553	2562	2567	2543	2560	2557	7	4	34	86.96	126
	20150204	2560	2557	2550	2575	2550	2565	2566	8	9	32	82.13	118
	20150205	2565	2566	2582	2582	2573	2573	2577	7	11	4	10.31	118
	20150206	2573	2577	2573	2573	2573	2573	2573	-4	-4	2	5.15	120
	20150209	2573	2573	2545	2545	2545	2545	2545	-28	-28	4	10.18	118
	20150210	2545	2545				2545	2545	0	0	0	0.00	118
	20150211	2545	2545				2557	2557	12	12	0	0.00	118
	20150212	2557	2557				2557	2557	0	0	0	0.00	118
	20150213	2557	2557	2546	2566	2546	2564	2563	7	6	24	61.52	120
	20150216	2564	2563	2595	2596	2595	2596	2595	33	32	10	25.95	120
	20150217	2596	2595				2584	2584	-11	-11	0	0.00	120
	20150225	2584	2584	2574	2587	2539	2556	2561	-28	-23	492	1,260.41	134
	20150226	2556	2561	2570	2571	2570	2571	2570	10	9	34	87.38	108
	20150227	2571	2570	2571	2571	2571	2571	2571	1	1	2	5.14	108
	20150302	2571	2571	2584	2584	2573	2573	2574	2	3	24	61.79	108
	20150303	2573	2574	2590	2597	2578	2583	2582	9	8	26	67.16	108
	20150304	2583	2582				2576	2576	-6	-6	0	0.00	108
	20150305	2576	2576	2538	2547	2532	2547	2539	-29	-37	8	20.32	108
	20150306	2547	2539	2535	2535	2535	2535	2535	-4	-4	4	10.14	108
	20150309	2535	2535	2482	2515	2482	2515	2509	-20	-26	12	30.11	120
	20150310	2515	2509	2484	2484	2475	2475	2477	-34	-32	16	39.64	122
	20150311	2475	2477	2465	2465	2465	2465	2465	-12	-12	2	4.93	124
	20150312	2465	2465	2492	2503	2492	2503	2496	38	31	10	24.97	124
	20150313	2503	2496	2499	2511	2499	2508	2507	12	11	8	20.06	124
	20150316	2508	2507	2476	2520	2476	2520	2506	13	-1	24	60.15	128
	20150317	2520	2506	2526	2526	2513	2520	2517	14	11	38	95.68	130
	20150318	2520	2517	2502	2512	2488	2488	2498	-29	-19	54	134.90	144
	20150319	2488	2498	2490	2514	2490	2505	2502	7	4	188	470.45	294
	20150320	2505	2502	2502	2518	2502	2509	2511	7	9	30	75.35	296
	20150323	2509	2511	2512	2544	2512	2543	2535	32	24	70	177.52	296
	20150324	2543	2535	2566	2575	2555	2560	2565	25	30	14	35.92	290
	20150325	2560	2565	2554	2554	2530	2530	2530	-35	-35	86	217.63	368
	20150326	2530	2530	2530	2530	2504	2504	2515	-26	-15	88	221.38	406
	20150327	2504	2515	2513	2513	2443	2506	2472	-9	-43	180	445.02	470
	20150330	2506	2472	2517	2520	2493	2497	2504	25	32	24	60.10	458
	20150331	2497	2504	2488	2503	2473	2491	2487	-13	-17	188	467.69	508
	20150401	2491	2487	2445	2466	2436	2457	2447	-30	-40	320	783.22	644
	20150402	2457	2447	2403	2424	2392	2398	2400	-49	-47	172	412.96	648
	20150403	2398	2400	2396	2419	2362	2390	2392	-10	-8	868	2,076.68	648
	20150407	2390	2392	2385	2385	2353	2365	2370	-27	-22	54	128.02	676
	20150408	2365	2370	2361	2382	2343	2374	2357	4	-13	124	292.30	696
	20150409	2374	2357	2372	2372	2342	2349	2353	-8	-4	102	240.02	708
	20150410	2349	2353	2337	2339	2307	2307	2323	-46	-30	184	427.59	746
	20150413	2307	2323	2308	2360	2306	2360	2317	37	-6	146	338.37	724
	20150414	2360	2317	2355	2360	2332	2354	2355	37	38	134	315.58	774
	20150415	2354	2355	2353	2356	2340	2340	2349	-15	-6	28	65.80	776
	20150416	2340	2349	2348	2368	2345	2368	2352	19	3	48	112.93	780
	20150417	2368	2352	2358	2365	2350	2357	2362	5	10	124	292.94	864
	20150420	2357	2362	2353	2356	2335	2335	2344	-27	-18	92	215.70	874
	20150421	2335	2344	2327	2328	2318	2321	2321	-23	-23	136	315.75	838
	20150422	2321	2321	2336	2373	2336	2373	2366	52	45	34	80.44	846
	20150423	2373	2366	2366	2372	2352	2361	2362	-5	-4	12	28.34	844
	20150424	2361	2362	2386	2427	2377	2424	2403	62	41	220	528.79	794
	20150427	2424	2403	2430	2452	2416	2452	2431	49	28	156	379.32	708
	20150428	2452	2431	2462	2462	2433	2440	2452	9	21	112	274.64	734
	20150429	2440	2452	2433	2450	2400	2400	2431	-52	-21	104	252.90	786
	20150430	2400	2431	2417	2426	2408	2418	2416	-13	-15	50	120.82	792
rb1601	20150116	2518	2518	2545	2568	2533	2550	2546	32	28	96	244.47	66
	20150119	2550	2546	2534	2558	2515	2541	2533	-5	-13	486	1,231.17	212
	20150120	2541	2533	2554	2554	2521	2529	2532	-4	-1	134	339.29	286
	20150121	2529	2532	2520	2540	2516	2516	2528	-16	-4	294	743.27	410
	20150122	2516	2528	2519	2530	2515	2521	2522	-7	-6	310	782.11	576
	20150123	2521	2522	2523	2540	2521	2524	2528	2	6	276	697.82	680
	20150126	2524	2528	2519	2534	2503	2503	2513	-25	-15	352	884.73	782
	20150127	2503	2513	2501	2532	2500	2520	2521	7	8	298	751.34	842
	20150128	2520	2521	2520	2534	2510	2520	2523	-1	2	252	636.02	882
	20150129	2520	2523	2525	2564	2525	2555	2550	32	27	608	1,550.77	1066
	20150130	2555	2550	2555	2557	2513	2533	2531	-17	-19	2028	5,134.89	2042
	20150202	2533	2531	2533	2550	2521	2545	2539	14	8	952	2,417.34	2198
	20150203	2545	2539	2548	2567	2547	2560	2556	21	17	730	1,866.54	2418
	20150204	2560	2556	2561	2590	2556	2556	2573	0	17	2152	5,537.98	3584
	20150205	2556	2573	2565	2576	2557	2557	2565	-16	-8	920	2,359.83	3868
	20150206	2557	2565	2550	2573	2543	2570	2561	5	-4	808	2,070.05	4068
	20150209	2570	2561	2579	2594	2551	2559	2565	-2	4	1136	2,914.67	4132
	20150210	2559	2565	2564	2575	2560	2569	2568	4	3	944	2,424.70	4618
	20150211	2569	2568	2568	2574	2561	2574	2567	6	-1	732	1,879.64	4594
	20150212	2574	2567	2575	2575	2555	2563	2562	-4	-5	1012	2,592.91	4562
	20150213	2563	2562	2563	2580	2561	2578	2571	16	9	908	2,335.35	4956
	20150216	2578	2571	2577	2613	2577	2588	2589	17	18	3786	9,805.48	6942
	20150217	2588	2589	2588	2593	2568	2584	2573	-5	-16	2336	6,011.49	7578
	20150225	2584	2573	2570	2575	2552	2555	2560	-18	-13	766	1,961.63	7716
	20150226	2555	2560	2561	2579	2561	2576	2566	16	6	3584	9,198.20	9408
	20150227	2576	2566	2575	2594	2560	2561	2574	-5	8	3544	9,125.22	10814
	20150302	2561	2574	2563	2595	2540	2587	2571	13	-3	9006	23,158.41	15138
	20150303	2587	2571	2586	2606	2572	2573	2586	2	15	12400	32,069.49	20338
	20150304	2573	2586	2574	2585	2567	2572	2577	-14	-9	8880	22,889.63	20758
	20150305	2572	2577	2571	2573	2528	2535	2545	-42	-32	8348	21,250.50	21134
	20150306	2535	2545	2533	2546	2500	2505	2524	-40	-21	7226	18,245.46	21218
	20150309	2505	2524	2501	2521	2482	2494	2502	-30	-22	13620	34,079.78	26148
	20150310	2494	2502	2498	2503	2476	2477	2488	-25	-14	6268	15,596.91	26006
	20150311	2477	2488	2481	2496	2471	2488	2484	0	-4	4912	12,203.89	25338
	20150312	2488	2484	2489	2520	2480	2500	2502	16	18	18558	46,446.56	37054
	20150313	2500	2502	2507	2520	2496	2504	2507	2	5	8560	21,464.82	37194
	20150316	2504	2507	2498	2529	2489	2525	2513	18	6	11284	28,359.73	40062
	20150317	2525	2513	2524	2528	2511	2517	2520	4	7	4932	12,429.85	40412
	20150318	2517	2520	2510	2526	2481	2495	2501	-25	-19	16412	41,058.98	39324
	20150319	2495	2501	2488	2510	2486	2494	2496	-7	-5	5386	13,445.18	39562
	20150320	2494	2496	2495	2508	2490	2496	2498	0	2	5458	13,638.06	39818
	20150323	2496	2498	2494	2554	2485	2553	2532	55	34	22140	56,077.54	44128
	20150324	2553	2532	2557	2579	2548	2553	2561	21	29	15654	40,104.26	47030
	20150325	2553	2561	2553	2556	2520	2521	2542	-40	-19	11234	28,562.70	48202
	20150326	2521	2542	2520	2528	2500	2506	2511	-36	-31	14810	37,200.83	52346
	20150327	2506	2511	2508	2508	2436	2493	2474	-18	-37	30906	76,469.16	54812
	20150330	2493	2474	2488	2509	2462	2472	2482	-2	8	17412	43,224.20	56104
	20150331	2472	2482	2495	2495	2443	2455	2459	-27	-23	37662	92,641.49	61474
	20150401	2455	2459	2450	2450	2398	2411	2424	-48	-35	26934	65,289.14	65786
	20150402	2411	2424	2391	2415	2362	2366	2385	-58	-39	44184	105,411.36	73468
	20150403	2366	2385	2360	2398	2360	2365	2377	-20	-8	35634	84,720.29	79374
	20150407	2365	2377	2350	2371	2345	2347	2355	-30	-22	35944	84,653.63	88650
	20150408	2347	2355	2350	2366	2317	2358	2342	3	-13	53660	125,709.55	96660
	20150409	2358	2342	2356	2359	2326	2327	2338	-15	-4	31864	74,525.56	101316
	20150410	2327	2338	2325	2332	2300	2302	2312	-36	-26	35310	81,664.38	105180
	20150413	2302	2312	2305	2357	2291	2353	2322	41	10	93388	216,938.13	119450
	20150414	2353	2322	2352	2361	2325	2344	2342	22	20	73444	172,067.50	122374
	20150415	2344	2342	2345	2353	2319	2322	2336	-20	-6	47252	110,421.45	128430
	20150416	2322	2336	2315	2350	2315	2339	2336	3	0	55552	129,806.39	132086
	20150417	2339	2336	2340	2362	2332	2335	2344	-1	8	59534	139,554.65	139772
	20150420	2335	2344	2333	2342	2310	2310	2325	-34	-19	96368	224,060.91	147514
	20150421	2310	2325	2306	2315	2298	2306	2307	-19	-18	92386	213,186.22	161454
	20150422	2306	2307	2305	2360	2304	2352	2335	45	28	154994	362,042.40	167074
	20150423	2352	2335	2352	2358	2333	2356	2349	21	14	122634	288,169.94	174772
	20150424	2356	2349	2355	2415	2355	2405	2395	56	46	220176	527,339.35	188336
	20150427	2405	2395	2415	2455	2400	2454	2426	59	31	252906	613,591.91	204176
	20150428	2454	2426	2458	2468	2423	2434	2448	8	22	215394	527,439.21	220968
	20150429	2434	2448	2437	2448	2370	2381	2409	-67	-39	223094	537,529.99	235220
	20150430	2381	2409	2385	2415	2380	2399	2400	-10	-9	153990	369,700.96	234944
rb1602	20150216	2571	2571	2540	2646	2540	2600	2606	29	35	10	26.07	2
	20150217	2600	2606	2580	2595	2580	2595	2587	-11	-19	4	10.35	2
	20150225	2595	2587	2580	2580	2543	2558	2560	-29	-27	10	25.60	8
	20150226	2558	2560	2550	2568	2550	2568	2553	8	-7	540	1,379.14	472
	20150227	2568	2553	2568	2577	2559	2560	2569	7	16	492	1,264.01	838
	20150302	2560	2569	2552	2594	2543	2594	2563	25	-6	306	784.30	882
	20150303	2594	2563	2589	2600	2580	2580	2588	17	25	266	688.58	878
	20150304	2580	2588	2580	2581	2559	2569	2567	-19	-21	276	708.65	878
	20150305	2569	2567	2561	2561	2529	2534	2539	-33	-28	104	264.08	878
	20150306	2534	2539	2532	2535	2494	2496	2523	-43	-16	730	1,841.92	1368
	20150309	2496	2523	2500	2510	2480	2490	2486	-33	-37	330	820.61	1486
	20150310	2490	2486	2494	2495	2472	2473	2480	-13	-6	556	1,379.40	1754
	20150311	2473	2480	2475	2485	2471	2483	2474	3	-6	622	1,538.92	2198
	20150312	2483	2474	2486	2510	2448	2497	2485	23	11	596	1,481.33	2430
	20150313	2497	2485	2506	2512	2485	2495	2502	10	17	98	245.24	2464
	20150316	2495	2502	2491	2517	2489	2517	2508	15	6	402	1,008.36	2608
	20150317	2517	2508	2519	2521	2501	2514	2513	6	5	96	241.31	2586
	20150318	2514	2513	2497	2515	2482	2486	2490	-27	-23	1720	4,284.10	3244
	20150319	2486	2490	2483	2499	2480	2485	2484	-5	-6	104	258.41	3218
	20150320	2485	2484	2485	2493	2483	2490	2489	6	5	278	692.19	3382
	20150323	2490	2489	2483	2543	2483	2543	2521	54	32	404	1,018.87	3336
	20150324	2543	2521	2547	2559	2541	2548	2551	27	30	110	280.61	3328
	20150325	2548	2551	2542	2547	2511	2511	2533	-40	-18	114	288.81	3330
	20150326	2511	2533	2511	2518	2496	2496	2506	-37	-27	128	320.87	3356
	20150327	2496	2506	2495	2495	2423	2483	2452	-23	-54	598	1,466.88	3546
	20150330	2483	2452	2481	2481	2447	2456	2466	4	14	184	453.91	3558
	20150331	2456	2466	2462	2470	2429	2441	2451	-25	-15	282	691.30	3612
	20150401	2441	2451	2428	2428	2396	2396	2410	-55	-41	184	443.54	3636
	20150402	2396	2410	2372	2399	2326	2360	2373	-50	-37	328	778.47	3682
	20150403	2360	2373	2353	2377	2348	2348	2361	-25	-12	316	746.33	3688
	20150407	2348	2361	2351	2351	2329	2329	2337	-32	-24	112	261.81	3710
	20150408	2329	2337	2332	2362	2307	2345	2322	8	-15	374	868.67	3714
	20150409	2345	2322	2336	2343	2316	2316	2324	-6	2	150	348.71	3770
	20150410	2316	2324	2315	2316	2297	2297	2303	-27	-21	386	889.01	3796
	20150413	2297	2303	2299	2352	2292	2352	2311	49	8	270	624.08	3786
	20150414	2352	2311	2344	2361	2324	2352	2342	41	31	510	1,194.49	3668
	20150415	2352	2342	2342	2348	2313	2317	2335	-25	-7	278	649.14	3848
	20150416	2317	2335	2313	2346	2313	2339	2334	4	-1	90	210.07	3812
	20150417	2339	2334	2332	2354	2327	2332	2337	-2	3	448	1,047.29	3758
	20150420	2332	2337	2325	2336	2314	2314	2323	-23	-14	192	446.13	3746
	20150421	2314	2323	2313	2325	2304	2310	2311	-13	-12	190	439.11	3830
	20150422	2310	2311	2220	2356	2220	2350	2331	39	20	520	1,212.25	4108
	20150423	2350	2331	2356	2356	2341	2352	2349	21	18	270	634.47	4150
	20150424	2352	2349	2358	2406	2354	2400	2396	51	47	780	1,869.29	4140
	20150427	2400	2396	2405	2448	2399	2448	2424	52	28	782	1,896.14	4182
	20150428	2448	2424	2451	2470	2432	2432	2442	8	18	818	1,997.79	4450
	20150429	2432	2442	2440	2449	2380	2388	2421	-54	-21	202	489.05	4444
	20150430	2388	2421	2396	2419	2396	2408	2406	-13	-15	78	187.69	4462
rb1603	20150317	2508	2508	2501	2551	2501	2511	2512	3	4	76	190.97	64
	20150318	2511	2512	2510	2511	2485	2488	2501	-24	-11	320	800.47	286
	20150319	2488	2501	2479	2495	2479	2493	2486	-8	-15	542	1,347.60	680
	20150320	2493	2486	2490	2496	2480	2495	2490	9	4	258	642.55	804
	20150323	2495	2490	2486	2541	2484	2541	2516	51	26	368	925.98	910
	20150324	2541	2516	2543	2569	2543	2548	2553	32	37	238	607.64	930
	20150325	2548	2553	2548	2552	2521	2522	2532	-31	-21	212	536.88	948
	20150326	2522	2532	2514	2524	2497	2497	2508	-35	-24	166	416.36	1042
	20150327	2497	2508	2503	2503	2424	2489	2473	-19	-35	430	1,063.60	1184
	20150330	2489	2473	2490	2502	2458	2469	2474	-4	1	290	717.53	1318
	20150331	2469	2474	2468	2477	2428	2445	2438	-29	-36	928	2,263.02	1982
	20150401	2445	2438	2426	2426	2396	2403	2412	-35	-26	478	1,152.99	2088
	20150402	2403	2412	2365	2491	2360	2364	2374	-48	-38	1278	3,034.61	2178
	20150403	2364	2374	2365	2389	2340	2353	2362	-21	-12	574	1,356.13	2366
	20150407	2353	2362	2360	2364	2343	2344	2354	-18	-8	690	1,624.67	2496
	20150408	2344	2354	2350	2369	2318	2356	2330	2	-24	678	1,580.39	2900
	20150409	2356	2330	2416	2445	2301	2330	2332	0	2	566	1,320.40	3044
	20150410	2330	2332	2314	2323	2296	2300	2307	-32	-25	296	683.16	3106
	20150413	2300	2307	2297	2354	2295	2354	2310	47	3	486	1,122.93	3214
	20150414	2354	2310	2341	2365	2330	2352	2342	42	32	1064	2,492.53	3324
	20150415	2352	2342	2356	2356	2319	2319	2337	-23	-5	790	1,846.50	3782
	20150416	2319	2337	2320	2353	2318	2345	2342	8	5	264	618.53	3698
	20150417	2345	2342	2340	2357	2335	2337	2343	-5	1	406	951.50	3690
	20150420	2337	2343	2331	2343	2321	2326	2328	-17	-15	394	917.39	3826
	20150421	2326	2328	2324	2336	2316	2336	2322	8	-6	174	404.18	3906
	20150422	2336	2322	2330	2373	2330	2363	2357	41	35	554	1,306.33	3972
	20150423	2363	2357	2310	2373	2310	2362	2358	5	1	606	1,428.99	4110
	20150424	2362	2358	2362	2423	2362	2409	2393	51	35	2020	4,835.26	4916
	20150427	2409	2393	2420	2450	2408	2450	2423	57	30	506	1,226.44	5032
	20150428	2450	2423	2457	2467	2437	2447	2454	24	31	510	1,251.96	5218
	20150429	2447	2454	2441	2459	2384	2398	2420	-56	-34	352	852.13	5252
	20150430	2398	2420	2398	2433	2398	2416	2417	-4	-3	242	585.11	5272
rb1604	20150416	2337	2337				2342	2342	5	5	0	0.00	0
	20150417	2342	2342	2337	2382	2337	2346	2360	4	18	54	127.47	22
	20150420	2346	2360	2351	2376	2331	2353	2358	-7	-2	46	108.48	46
	20150421	2353	2358	2336	2342	2328	2335	2336	-23	-22	28	65.42	54
	20150422	2335	2336	2343	2395	2343	2383	2371	47	35	168	398.41	196
	20150423	2383	2371	2383	2399	2382	2399	2391	28	20	56	133.91	220
	20150424	2399	2391	2408	2463	2400	2438	2439	47	48	166	405.02	316
	20150427	2438	2439	2456	2482	2424	2469	2453	30	14	196	480.90	348
	20150428	2469	2453	2483	2487	2444	2464	2477	11	24	168	416.27	482
	20150429	2464	2477	2469	2476	2426	2433	2455	-44	-22	214	525.50	630
	20150430	2433	2455	2421	2454	2421	2451	2442	-4	-13	88	214.98	632
ru1501	20150105	13640	13870	13650	13850	13580	13805	13760	-65	-110	4376	60,217.16	22104
	20150106	13805	13760	13800	14430	13760	14335	14155	575	395	3876	54,876.92	21674
	20150107	14335	14155	14300	14555	14300	14305	14470	150	315	4294	62,154.63	20700
	20150108	14305	14470	14220	14220	13600	13605	13815	-865	-655	3270	45,181.12	19354
	20150109	13605	13815	13560	14140	13325	14065	13800	250	-15	1850	25,534.94	19278
	20150112	14065	13800	13920	14540	13920	14425	14255	625	455	2008	28,625.32	18346
	20150113	14425	14255	14600	14605	14155	14155	14375	-100	120	406	5,837.48	18046
	20150114	14155	14375	14190	14200	13800	13975	13975	-400	-400	276	3,857.95	18066
	20150115	13975	13975	14150	14200	13150	13800	13780	-175	-195	206	2,838.72	18074
ru1503	20150105	13660	13715	13595	13665	13440	13530	13530	-185	-185	116	1,569.74	300
	20150106	13530	13530	13525	13960	13410	13885	13745	355	215	154	2,117.24	326
	20150107	13885	13745	13700	13945	13625	13700	13705	-45	-40	182	2,494.44	356
	20150108	13700	13705	13520	13700	13350	13450	13515	-255	-190	162	2,189.54	360
	20150109	13450	13515	13405	13865	13400	13700	13555	185	40	180	2,440.15	440
	20150112	13700	13555	13720	13755	13605	13675	13710	120	155	108	1,481.02	466
	20150113	13675	13710	13595	13595	13335	13480	13455	-230	-255	144	1,938.11	510
	20150114	13480	13455	13350	13450	12970	12970	13155	-485	-300	296	3,894.49	452
	20150115	12970	13155	13095	13500	13095	13420	13365	265	210	246	3,287.80	574
	20150116	13420	13365	13445	13865	13325	13515	13555	150	190	632	8,568.48	788
	20150119	13515	13555	13500	13570	13325	13400	13455	-155	-100	122	1,641.92	784
	20150120	13400	13455	13255	13525	13100	13360	13425	-95	-30	142	1,906.65	816
	20150121	13360	13425	13355	13685	13290	13685	13515	260	90	110	1,487.14	842
	20150122	13685	13515	13570	13810	13570	13700	13705	185	190	462	6,333.96	1052
	20150123	13700	13705	13605	13695	13435	13640	13610	-65	-95	120	1,633.69	1022
	20150126	13640	13610	13600	13695	13005	13225	13215	-385	-395	340	4,493.58	954
	20150127	13225	13215	13375	13595	13350	13525	13445	310	230	172	2,313.29	986
	20150128	13525	13445	13430	13635	13360	13360	13450	-85	5	470	6,322.01	946
	20150129	13360	13450	13335	13415	13200	13300	13270	-150	-180	104	1,380.48	944
	20150130	13300	13270	13000	13135	12990	13010	13065	-260	-205	388	5,070.95	880
	20150202	13010	13065	12995	13380	12965	13315	13155	250	90	192	2,525.87	870
	20150203	13315	13155	13370	13480	13260	13310	13345	155	190	140	1,868.32	824
	20150204	13310	13345	13335	13780	13300	13500	13605	155	260	208	2,830.13	892
	20150205	13500	13605	13545	13600	13325	13325	13495	-280	-110	222	2,996.99	878
	20150206	13325	13495	13390	13670	13340	13670	13460	175	-35	212	2,853.65	868
	20150209	13670	13460	13565	13800	13430	13610	13600	150	140	108	1,469.30	872
	20150210	13610	13600	13600	13620	13430	13525	13545	-75	-55	50	677.46	856
	20150211	13525	13545	13450	13650	13450	13630	13595	85	50	138	1,876.24	828
	20150212	13630	13595	13530	13530	13530	13530	13530	-65	-65	2	27.06	828
	20150213	13530	13530	13600	13800	13600	13800	13730	270	200	92	1,263.21	826
	20150216	13800	13730	13775	14000	13775	13945	13930	215	200	84	1,170.37	804
	20150217	13945	13930	13970	13985	13705	13705	13800	-225	-130	130	1,794.44	808
	20150225	13705	13800	13830	13855	13830	13850	13845	50	45	40	553.89	802
	20150226	13850	13845	13830	14030	13830	13990	13935	145	90	272	3,791.13	898
	20150227	13990	13935	14100	14100	13820	13970	13985	35	50	178	2,489.48	906
	20150302	13970	13985	14020	14020	13680	13680	13805	-305	-180	148	2,043.38	808
	20150303	13680	13805	13720	13775	13385	13440	13515	-365	-290	116	1,567.89	838
	20150304	13440	13515	13435	13450	13300	13300	13390	-215	-125	154	2,062.09	924
	20150305	13300	13390	13145	13215	13025	13100	13065	-290	-325	96	1,254.58	980
	20150306	13100	13065	13175	13250	13050	13050	13105	-15	40	148	1,940.07	952
	20150309	13050	13105	12990	13320	12990	13205	13175	100	70	88	1,159.41	924
	20150310	13205	13175	13250	13250	12600	12600	13050	-575	-125	194	2,532.11	916
	20150311	12600	13050	12820	13130	12550	12925	12945	-125	-105	148	1,916.51	916
	20150312	12925	12945	13030	13245	13000	13115	13085	170	140	46	601.97	928
	20150313	13115	13085	13050	13050	13050	13050	13050	-35	-35	60	783.00	908
	20150316	13050	13050	13050	13050	12710	12890	12885	-160	-165	12	154.64	910
ru1504	20150105	13600	13610	13505	13505	13365	13365	13435	-245	-175	40	537.40	144
	20150106	13365	13435	13800	13815	13710	13815	13760	380	325	20	275.23	142
	20150107	13815	13760	13635	13635	13425	13530	13535	-230	-225	32	433.17	150
	20150108	13530	13535	13520	13520	13245	13245	13390	-290	-145	18	241.09	144
	20150109	13245	13390	13110	13460	13110	13300	13345	-90	-45	10	133.48	140
	20150112	13300	13345				13500	13500	155	155	0	0.00	140
	20150113	13500	13500				13250	13250	-250	-250	0	0.00	140
	20150114	13250	13250	12995	12995	12625	12625	12675	-625	-575	14	177.49	150
	20150115	12625	12675	12845	12870	12770	12860	12820	185	145	10	128.24	146
	20150116	12860	12820	12865	12865	12865	12865	12865	45	45	2	25.73	146
	20150119	12865	12865	13060	13070	13000	13000	13035	135	170	26	338.98	126
	20150120	13000	13035	13165	13210	13040	13100	13135	65	100	26	341.54	126
	20150121	13100	13135	13055	13325	12960	13325	13035	190	-100	44	573.63	114
	20150122	13325	13035	13265	13560	13250	13455	13460	420	425	196	2,638.86	104
	20150123	13455	13460	13450	13495	13245	13380	13375	-80	-85	26	347.77	100
	20150126	13380	13375	13460	13545	12950	13265	13095	-110	-280	108	1,414.36	88
	20150127	13265	13095	13420	13490	13340	13490	13420	395	325	36	483.17	92
	20150128	13490	13420	13310	13485	13295	13405	13390	-15	-30	36	482.19	80
	20150129	13405	13390	13235	13255	13110	13255	13220	-135	-170	20	264.49	72
	20150130	13255	13220	13175	13345	12885	12885	13165	-335	-55	48	632.02	70
	20150202	12885	13165	12910	13315	12910	13300	13055	135	-110	38	496.10	64
	20150203	13300	13055	13635	13635	13270	13305	13320	250	265	36	479.67	60
	20150204	13305	13320	13320	13780	13320	13600	13600	280	280	82	1,115.54	62
	20150205	13600	13600	13540	13540	13430	13430	13475	-170	-125	34	458.24	50
	20150206	13430	13475	13440	13550	13440	13550	13495	75	20	8	107.98	46
	20150209	13550	13495				13550	13550	55	55	0	0.00	46
	20150210	13550	13550	13570	13635	13570	13635	13600	85	50	4	54.41	46
	20150211	13635	13600	13555	13555	13555	13555	13555	-45	-45	4	54.22	46
	20150212	13555	13555	13535	13535	13535	13535	13535	-20	-20	2	27.07	46
	20150213	13535	13535	13660	13760	13570	13760	13665	225	130	14	191.31	48
	20150216	13760	13665	13960	14100	13785	14080	14010	415	345	26	364.33	48
	20150217	14080	14010	14025	14025	14000	14000	14015	-10	5	6	84.10	44
	20150225	14000	14015	13885	13885	13715	13715	13800	-300	-215	4	55.20	44
	20150226	13715	13800	13895	14120	13890	14065	14055	265	255	18	253.03	48
	20150227	14065	14055	14060	14060	14060	14060	14060	5	5	2	28.12	46
	20150302	14060	14060				14060	14060	0	0	0	0.00	46
	20150303	14060	14060	13620	13785	13400	13400	13600	-660	-460	8	108.80	46
	20150304	13400	13600	13425	13425	13300	13300	13355	-300	-245	10	133.56	44
	20150305	13300	13355	13130	13130	13125	13125	13125	-230	-230	4	52.51	44
	20150306	13125	13125	13420	13420	13050	13050	13140	-75	15	76	998.80	76
	20150309	13050	13140				13140	13140	0	0	0	0.00	76
	20150310	13140	13140	13135	13155	12905	12985	12990	-155	-150	20	259.84	76
	20150311	12985	12990	13010	13010	13010	13010	13010	20	20	2	26.02	76
	20150312	13010	13010				13150	13150	140	140	0	0.00	76
	20150313	13150	13150				13110	13110	-40	-40	0	0.00	76
	20150316	13110	13110	12930	12930	12930	12930	12930	-180	-180	10	129.30	66
	20150317	12930	12930	13050	13050	12950	13050	12995	120	65	30	389.96	78
	20150318	13050	12995	12920	12950	12920	12920	12930	-75	-65	6	77.58	80
	20150319	12920	12930	12990	12990	12970	12970	12975	40	45	6	77.86	84
	20150320	12970	12975	12995	12995	12840	12855	12910	-120	-65	20	258.22	84
	20150323	12855	12910	13130	13350	13130	13350	13245	440	335	10	132.48	90
	20150324	13350	13245	13485	13600	13405	13405	13510	160	265	54	729.73	84
	20150325	13405	13510	13435	13435	13300	13300	13335	-210	-175	16	213.39	76
	20150326	13300	13335	13550	13550	13550	13550	13550	215	215	4	54.20	76
	20150327	13550	13550	13300	13300	13260	13260	13270	-290	-280	14	185.80	90
	20150330	13260	13270	13280	13280	13275	13275	13275	5	5	4	53.11	90
	20150331	13275	13275	13300	13300	13215	13215	13255	-60	-20	4	53.03	88
	20150401	13215	13255				13050	13050	-205	-205	0	0.00	88
	20150402	13050	13050				13050	13050	0	0	0	0.00	88
	20150403	13050	13050	12920	12920	12920	12920	12920	-130	-130	4	51.68	88
	20150407	12920	12920	12895	12895	12895	12895	12895	-25	-25	2	25.79	86
	20150408	12895	12895	12800	12800	12635	12635	12715	-260	-180	8	101.74	90
	20150409	12635	12715				12635	12635	-80	-80	0	0.00	90
	20150410	12635	12635	12400	12400	12325	12400	12390	-235	-245	26	322.25	66
	20150413	12400	12390				12390	12390	0	0	0	0.00	66
	20150414	12390	12390	12600	12710	12600	12680	12690	290	300	16	203.08	80
	20150415	12680	12690	12830	12830	12700	12800	12755	110	65	8	102.07	78
ru1505	20150105	13590	13525	13520	13535	13230	13365	13365	-160	-160	459516	6,142,825.42	183484
	20150106	13365	13365	13245	13770	13245	13625	13600	260	235	658940	8,962,961.61	188338
	20150107	13625	13600	13545	13695	13270	13350	13440	-250	-160	647204	8,699,493.23	181178
	20150108	13350	13440	13375	13400	13065	13200	13225	-240	-215	592762	7,841,060.83	185218
	20150109	13200	13225	13245	13475	12960	13250	13195	25	-30	695478	9,179,398.19	181638
	20150112	13250	13195	13255	13485	13235	13285	13340	90	145	563020	7,510,955.56	182754
	20150113	13285	13340	13220	13225	12900	12920	13045	-420	-295	559164	7,294,340.34	183636
	20150114	12920	13045	12820	12965	12350	12425	12625	-620	-420	793010	10,012,276.52	191250
	20150115	12425	12625	12485	12730	12415	12625	12580	0	-45	523152	6,582,769.32	193388
	20150116	12625	12580	12655	12915	12510	12650	12680	70	100	587562	7,450,721.95	187658
	20150119	12650	12680	12600	12820	12535	12750	12705	70	25	543434	6,906,654.50	183454
	20150120	12750	12705	12630	12870	12620	12675	12755	-30	50	440242	5,617,184.38	187296
	20150121	12675	12755	12715	13085	12465	12985	12795	230	40	679548	8,696,499.99	194262
	20150122	12985	12795	12980	13425	12945	13215	13215	420	420	683898	9,039,936.13	190046
	20150123	13215	13215	13215	13290	13020	13190	13145	-25	-70	529154	6,957,261.70	188226
	20150126	13190	13145	13220	13325	12815	13070	13025	-75	-120	667780	8,697,884.42	180394
	20150127	13070	13025	13115	13445	13115	13320	13305	295	280	618306	8,228,782.21	191416
	20150128	13320	13305	13265	13455	13100	13280	13305	-25	0	584432	7,775,914.11	189116
	20150129	13280	13305	13255	13320	13050	13145	13165	-160	-140	426992	5,623,334.83	176252
	20150130	13145	13165	13105	13245	12855	12875	13035	-290	-130	482776	6,293,379.28	174456
	20150202	12875	13035	12935	13320	12815	13255	13055	220	20	514914	6,723,548.75	189078
	20150203	13255	13055	13265	13415	13215	13280	13300	225	245	452360	6,016,780.69	193652
	20150204	13280	13300	13365	13825	13270	13500	13585	200	285	669098	9,089,753.48	186778
	20150205	13500	13585	13565	13575	13300	13325	13430	-260	-155	479518	6,442,248.27	174930
	20150206	13325	13430	13370	13750	13345	13745	13595	315	165	518732	7,053,148.50	185254
	20150209	13745	13595	13700	13960	13540	13680	13680	85	85	468302	6,407,625.31	181632
	20150210	13680	13680	13650	13710	13480	13560	13580	-120	-100	350566	4,761,709.31	171986
	20150211	13560	13580	13500	13720	13445	13650	13620	70	40	331666	4,518,926.35	178424
	20150212	13650	13620	13625	13715	13475	13620	13585	0	-35	344582	4,682,847.22	167544
	20150213	13620	13585	13655	13995	13605	13925	13805	340	220	486006	6,711,613.00	170324
	20150216	13925	13805	13930	14150	13855	14090	14025	285	220	384198	5,389,695.97	155830
	20150217	14090	14025	14095	14155	13720	13875	13890	-150	-135	331690	4,607,588.45	132162
	20150225	13875	13890	13775	14035	13755	13880	13895	-10	5	196478	2,730,998.76	139156
	20150226	13880	13895	13895	14240	13870	14195	14050	300	155	313800	4,410,446.80	157422
	20150227	14195	14050	14200	14300	13970	14095	14140	45	90	289830	4,099,420.67	150416
	20150302	14095	14140	14110	14250	13760	13925	13965	-215	-175	398354	5,563,678.48	144794
	20150303	13925	13965	13895	13980	13500	13595	13710	-370	-255	308024	4,224,235.98	133434
	20150304	13595	13710	13600	13665	13400	13400	13550	-310	-160	204896	2,776,953.38	128626
	20150305	13400	13550	13400	13430	13105	13260	13280	-290	-270	197888	2,628,453.64	121650
	20150306	13260	13280	13280	13490	13155	13320	13345	40	65	190962	2,548,989.06	112874
	20150309	13320	13345	13305	13470	13130	13385	13300	40	-45	162778	2,165,637.25	108650
	20150310	13385	13300	13365	13420	13085	13110	13270	-190	-30	132476	1,758,068.93	103174
	20150311	13110	13270	13105	13365	13055	13250	13205	-20	-65	124132	1,639,174.65	97816
	20150312	13250	13205	13265	13415	13175	13365	13300	160	95	73328	975,370.03	96862
	20150313	13365	13300	13365	13400	13240	13315	13300	15	0	62818	835,786.90	95470
	20150316	13315	13300	13275	13280	12990	13140	13135	-160	-165	73584	966,790.19	92136
	20150317	13140	13135	13135	13215	13055	13065	13125	-70	-10	61612	808,733.98	90758
	20150318	13065	13125	13005	13095	12935	13020	13015	-105	-110	56972	741,617.33	87220
	20150319	13020	13015	13005	13175	12970	13095	13080	80	65	49748	650,743.27	82042
	20150320	13095	13080	13075	13120	12840	13050	13005	-30	-75	86288	1,122,510.64	79348
	20150323	13050	13005	13095	13530	13090	13435	13340	430	335	85398	1,139,596.39	71288
	20150324	13435	13340	13430	13690	13415	13500	13525	160	185	67658	915,158.71	65530
	20150325	13500	13525	13450	13510	13330	13380	13400	-145	-125	44278	593,421.22	66420
	20150326	13380	13400	13400	13625	13380	13550	13495	150	95	63144	852,319.63	60142
	20150327	13550	13495	13495	13555	13175	13410	13360	-85	-135	67092	896,503.37	54684
	20150330	13410	13360	13400	13450	13210	13225	13290	-135	-70	44460	590,952.48	51212
	20150331	13225	13290	13235	13305	13150	13180	13235	-110	-55	41258	546,142.66	47134
	20150401	13180	13235	13175	13240	12930	12935	13085	-300	-150	48988	641,071.71	37216
	20150402	12935	13085	12925	13135	12900	13050	13050	-35	-35	30284	395,275.32	34166
	20150403	13050	13050	13045	13100	12950	13050	13035	0	-15	19240	250,806.75	31462
	20150407	13050	13035	13100	13250	12995	13020	13080	-15	45	14300	187,096.03	29420
	20150408	13020	13080	13000	13030	12715	12780	12840	-300	-240	19888	255,375.65	26896
	20150409	12780	12840	12660	12735	12300	12405	12475	-435	-365	23026	287,286.02	24418
	20150410	12405	12475	12450	12485	12365	12425	12415	-50	-60	10660	132,381.86	22640
	20150413	12425	12415	12490	12990	12490	12925	12840	510	425	20238	259,887.55	20500
	20150414	12925	12840	13000	13015	12755	12875	12875	35	35	10202	131,393.93	18182
	20150415	12875	12875	12850	12990	12830	12875	12905	0	30	7334	94,681.18	17438
	20150416	12875	12905	12850	13050	12805	12990	12970	85	65	6118	79,357.46	16006
	20150417	12990	12970	13000	13050	12850	12930	12955	-40	-15	5616	72,775.99	14566
	20150420	12930	12955	12905	12965	12855	12880	12910	-75	-45	4144	53,515.61	13312
	20150421	12880	12910	12850	13065	12760	13040	12970	130	60	7714	100,082.65	10530
	20150422	13040	12970	13090	13120	12955	13015	13040	45	70	3602	46,975.46	8934
	20150423	13015	13040	13040	13180	12990	13055	13065	15	25	3126	40,852.38	7950
	20150424	13055	13065	13095	13115	13000	13080	13040	15	-25	1598	20,845.50	7266
	20150427	13080	13040	13115	13820	13050	13820	13500	780	460	5436	73,388.96	5858
	20150428	13820	13500	13900	14145	13710	13835	13970	335	470	2596	36,266.46	5074
	20150429	13835	13970	13820	13905	13590	13670	13740	-300	-230	1602	22,013.45	4392
	20150430	13670	13740	13675	14085	13675	14010	13945	270	205	1646	22,957.22	3950
ru1506	20150105	13255	13285	12920	13175	12920	13050	13025	-235	-260	74	964.15	1370
	20150106	13050	13025	12970	13320	12930	13195	13170	170	145	290	3,820.44	1508
	20150107	13195	13170	13030	13165	12800	12800	12990	-370	-180	244	3,169.76	1574
	20150108	12800	12990	12865	12890	12630	12790	12775	-200	-215	68	868.83	1574
	20150109	12790	12775	12665	13065	12650	12900	12840	125	65	76	975.96	1574
	20150112	12900	12840	13200	13200	12130	12875	12925	35	85	106	1,370.33	1576
	20150113	12875	12925	12695	12780	12435	12500	12635	-425	-290	56	707.61	1572
	20150114	12500	12635	12500	12500	11950	12055	12240	-580	-395	182	2,228.28	1576
	20150115	12055	12240	12105	12340	12035	12240	12195	0	-45	86	1,048.77	1578
	20150116	12240	12195	12300	12585	12245	12370	12415	175	220	558	6,929.00	1584
	20150119	12370	12415	12335	12470	12300	12350	12375	-65	-40	86	1,064.59	1574
	20150120	12350	12375	12430	12445	12305	12305	12385	-70	10	44	545.15	1574
	20150121	12305	12385	12350	12610	12210	12550	12450	165	65	202	2,514.95	1576
	20150122	12550	12450	12615	12880	12165	12685	12705	235	255	358	4,549.51	1668
	20150123	12685	12705	12685	12685	12500	12590	12575	-115	-130	110	1,383.61	1666
	20150126	12590	12575	12645	12720	12265	12500	12470	-75	-105	152	1,895.92	1664
	20150127	12500	12470	12690	12885	12645	12810	12770	340	300	540	6,898.23	1680
	20150128	12810	12770	12780	12920	12625	12770	12795	0	25	162	2,073.35	1674
	20150129	12770	12795	12800	12800	12540	12670	12645	-125	-150	64	809.43	1668
	20150130	12670	12645	12655	12700	12375	12415	12555	-230	-90	216	2,711.93	1668
	20150202	12415	12555	12320	12800	12315	12790	12600	235	45	316	3,982.16	1676
	20150203	12790	12600	12730	12915	12715	12830	12830	230	230	236	3,028.85	1676
	20150204	12830	12830	12835	13310	12820	13085	13125	255	295	174	2,284.03	1680
	20150205	13085	13125	12975	13110	12940	12940	13020	-185	-105	200	2,604.83	1676
	20150206	12940	13020	13005	13310	12980	13310	13185	290	165	60	791.35	1678
	20150209	13310	13185	13310	13435	13170	13220	13235	35	50	130	1,720.70	1674
	20150210	13220	13235	13150	13210	13060	13090	13100	-145	-135	110	1,441.06	1668
	20150211	13090	13100	13040	13200	12970	13170	13045	70	-55	170	2,218.01	1666
	20150212	13170	13045	13200	13235	13000	13115	13110	70	65	38	498.31	1666
	20150213	13115	13110	13160	13450	13145	13360	13250	250	140	182	2,411.98	1670
	20150216	13360	13250	13780	13780	13290	13290	13365	40	115	122	1,630.97	1676
	20150217	13290	13365	13320	13345	13065	13145	13155	-220	-210	72	947.17	1674
	20150225	13145	13155	13165	13195	13125	13125	13155	-30	0	16	210.51	1680
	20150226	13125	13155	13180	13550	13180	13550	13305	395	150	80	1,064.65	1682
	20150227	13550	13305	13545	13610	13400	13445	13505	140	200	254	3,431.05	1706
	20150302	13445	13505	13450	13510	13110	13170	13210	-335	-295	178	2,352.13	1690
	20150303	13170	13210	13200	13215	12745	12850	12990	-360	-220	178	2,312.55	1712
	20150304	12850	12990	12845	13025	12845	12850	12945	-140	-45	198	2,563.80	1670
	20150305	12850	12945	12880	13220	12650	12755	12800	-190	-145	554	7,093.92	1680
	20150306	12755	12800	12755	12830	12550	12685	12705	-115	-95	252	3,202.68	1726
	20150309	12685	12705	12580	12780	12535	12765	12675	60	-30	254	3,220.27	1684
	20150310	12765	12675	12680	12700	12425	12425	12610	-250	-65	122	1,538.77	1674
	20150311	12425	12610	12425	12750	12325	12630	12555	20	-55	112	1,406.17	1676
	20150312	12630	12555	12665	12890	12525	12815	12715	260	160	154	1,958.82	1684
	20150313	12815	12715	12725	12745	12645	12655	12695	-60	-20	92	1,168.38	1678
	20150316	12655	12695	12565	12615	12350	12470	12435	-225	-260	534	6,642.22	1732
	20150317	12470	12435	12540	12585	12435	12445	12495	10	60	118	1,474.56	1690
	20150318	12445	12495	12445	12465	12335	12400	12400	-95	-95	36	446.47	1686
	20150319	12400	12400	12255	12540	12255	12485	12435	85	35	64	796.02	1676
	20150320	12485	12435	12465	12485	12310	12425	12390	-10	-45	188	2,330.17	1686
	20150323	12425	12390	12500	12880	12500	12850	12685	460	295	286	3,628.65	1674
	20150324	12850	12685	12870	13075	12855	12925	12940	240	255	86	1,113.02	1674
	20150325	12925	12940	12820	12880	12765	12800	12800	-140	-140	50	640.06	1674
	20150326	12800	12800	12840	13030	12840	12920	12935	120	135	88	1,138.42	1674
	20150327	12920	12935	12855	12935	12485	12720	12785	-215	-150	340	4,348.35	1678
	20150330	12720	12785	12605	12680	12540	12545	12615	-240	-170	152	1,917.48	1686
	20150331	12545	12615	12565	12610	12405	12430	12510	-185	-105	62	775.80	1674
	20150401	12430	12510	12400	12955	12400	12425	12515	-85	5	262	3,279.15	1684
	20150402	12425	12515	12475	12675	12465	12580	12600	65	85	228	2,872.88	1682
	20150403	12580	12600	12550	12635	12485	12590	12550	-10	-50	52	652.74	1676
	20150407	12590	12550	12595	12740	12595	12660	12695	110	145	242	3,073.26	1684
	20150408	12660	12695	12635	12695	12365	12365	12495	-330	-200	124	1,549.76	1674
	20150409	12365	12495	12400	12430	12040	12050	12195	-445	-300	108	1,317.34	1672
	20150410	12050	12195	12080	12170	12070	12135	12110	-60	-85	98	1,187.08	1640
	20150413	12135	12110	12250	12505	12210	12410	12365	300	255	272	3,363.82	1620
	20150414	12410	12365	12410	12500	12325	12400	12380	35	15	120	1,486.19	1556
	20150415	12400	12380	12490	12550	12455	12485	12500	105	120	132	1,650.18	1532
	20150416	12485	12500	12410	12650	12395	12580	12505	80	5	188	2,351.80	1502
	20150417	12580	12505	12650	12675	12505	12640	12595	135	90	56	705.45	1466
	20150420	12640	12595	12605	12650	12530	12560	12565	-35	-30	494	6,208.31	1436
	20150421	12560	12565	12505	13020	12500	12975	12755	410	190	600	7,653.41	1212
	20150422	12975	12755	13005	13155	12905	13000	13035	245	280	328	4,276.95	1120
	20150423	13000	13035	13060	13265	13005	13095	13110	60	75	70	918.01	1130
	20150424	13095	13110	13105	13190	13015	13140	13140	30	30	82	1,077.78	1132
	20150427	13140	13140	13160	13925	13140	13900	13710	760	570	102	1,398.60	1144
	20150428	13900	13710	14055	14225	13830	13900	13980	190	270	188	2,628.93	1110
	20150429	13900	13980	14000	14020	13575	13720	13810	-260	-170	252	3,480.90	1086
	20150430	13720	13810	13935	14165	13935	14080	14055	270	245	546	7,674.97	1108
ru1507	20150105	13245	13240	12935	13025	12935	13025	12980	-215	-260	8	103.84	184
	20150106	13025	12980	13130	13395	13130	13315	13270	335	290	32	424.76	190
	20150107	13315	13270	13170	13210	12920	12920	13175	-350	-95	22	289.94	192
	20150108	12920	13175	12920	12920	12920	12920	12920	-255	-255	2	25.84	190
	20150109	12920	12920	12785	12945	12690	12945	12840	25	-80	14	179.79	192
	20150112	12945	12840	13050	13050	13050	13050	13050	210	210	2	26.10	192
	20150113	13050	13050	12800	12800	12625	12625	12680	-425	-370	10	126.82	188
	20150114	12625	12680	12495	12495	12495	12495	12495	-185	-185	2	24.99	190
	20150115	12495	12495	12230	12230	12230	12230	12230	-265	-265	2	24.46	192
	20150116	12230	12230	12545	12545	12305	12305	12445	75	215	42	522.79	206
	20150119	12305	12445	12410	12460	12240	12300	12335	-145	-110	44	542.79	204
	20150120	12300	12335	12390	12500	12390	12500	12415	165	80	10	124.18	198
	20150121	12500	12415	12345	12570	12345	12570	12455	155	40	4	49.83	194
	20150122	12570	12455	12715	12715	12715	12715	12715	260	260	2	25.43	194
	20150123	12715	12715	12580	12580	12580	12580	12580	-135	-135	2	25.16	192
	20150126	12580	12580	12675	12675	12675	12675	12675	95	95	4	50.70	192
	20150127	12675	12675	12675	12940	12675	12940	12805	265	130	4	51.23	190
	20150128	12940	12805	12805	12850	12690	12740	12775	-65	-30	10	127.78	192
	20150129	12740	12775				12775	12775	0	0	0	0.00	192
	20150130	12775	12775				12680	12680	-95	-95	0	0.00	192
	20150202	12680	12680				12750	12750	70	70	0	0.00	192
	20150203	12750	12750	12760	12915	12715	12795	12810	45	60	88	1,127.70	202
	20150204	12795	12810	12850	13180	12850	13010	13100	200	290	40	524.04	190
	20150205	13010	13100	12975	13020	12955	12960	12990	-140	-110	26	337.74	184
	20150206	12960	12990	12890	13210	12890	13210	13060	220	70	8	104.51	182
	20150209	13210	13060	13155	13290	13155	13175	13220	115	160	18	237.98	178
	20150210	13175	13220				13220	13220	0	0	0	0.00	178
	20150211	13220	13220				13220	13220	0	0	0	0.00	178
	20150212	13220	13220	13005	13085	13005	13050	13025	-170	-195	14	182.40	182
	20150213	13050	13025	13230	13370	13230	13370	13285	345	260	10	132.86	184
	20150216	13370	13285	13165	13385	13165	13385	13285	100	0	12	159.46	182
	20150217	13385	13285	13315	13315	13185	13185	13270	-100	-15	6	79.63	180
	20150225	13185	13270				13270	13270	0	0	0	0.00	180
	20150226	13270	13270				13420	13420	150	150	0	0.00	180
	20150227	13420	13420				13620	13620	200	200	0	0.00	180
	20150302	13620	13620	13275	13385	13125	13170	13250	-450	-370	12	159.01	178
	20150303	13170	13250	13165	13165	12830	12910	12930	-340	-320	138	1,784.71	238
	20150304	12910	12930	12885	13030	12885	13030	12965	100	35	32	415.01	238
	20150305	13030	12965	12870	12870	12600	12700	12685	-265	-280	154	1,953.55	198
	20150306	12700	12685	12770	12825	12580	12580	12740	-105	55	40	509.71	176
	20150309	12580	12740	12520	12780	12480	12780	12670	40	-70	32	405.54	172
	20150310	12780	12670	12675	12690	12425	12425	12645	-245	-25	26	328.77	172
	20150311	12425	12645	12515	12715	12515	12650	12605	5	-40	20	252.18	178
	20150312	12650	12605	12630	12740	12530	12740	12630	135	25	16	202.11	176
	20150313	12740	12630				12630	12630	0	0	0	0.00	176
	20150316	12630	12630	12500	12515	12395	12485	12495	-145	-135	18	224.94	182
	20150317	12485	12495				12495	12495	0	0	0	0.00	182
	20150318	12495	12495	12395	12395	12370	12370	12375	-125	-120	10	123.75	182
	20150319	12370	12375	12350	12540	12350	12530	12495	155	120	20	249.94	180
	20150320	12530	12495	12380	12380	12380	12380	12380	-115	-115	2	24.76	178
	20150323	12380	12380	12455	12870	12455	12845	12720	465	340	6	76.34	180
	20150324	12845	12720	13020	13020	12925	12925	12965	205	245	6	77.81	176
	20150325	12925	12965	12845	12885	12845	12885	12850	-80	-115	42	539.87	174
	20150326	12885	12850	12795	13050	12795	13045	12985	195	135	8	103.88	168
	20150327	13045	12985	12615	12690	12610	12610	12630	-375	-355	10	126.32	166
	20150330	12610	12630	12550	12550	12550	12550	12550	-80	-80	2	25.10	166
	20150331	12550	12550	12565	12625	12505	12505	12565	-45	15	6	75.39	166
	20150401	12505	12565	12500	12500	12500	12500	12500	-65	-65	4	50.00	166
	20150402	12500	12500	12620	12705	12550	12680	12640	180	140	10	126.44	166
	20150403	12680	12640				12640	12640	0	0	0	0.00	166
	20150407	12640	12640	12695	12695	12695	12695	12695	55	55	2	25.39	166
	20150408	12695	12695	12460	12460	12460	12460	12460	-235	-235	2	24.92	166
	20150409	12460	12460	12150	12150	12150	12150	12150	-310	-310	2	24.30	168
	20150410	12150	12150				12065	12065	-85	-85	0	0.00	168
	20150413	12065	12065	12300	12510	12300	12495	12440	430	375	10	124.42	168
	20150414	12495	12440	12320	12320	12320	12320	12320	-120	-120	2	24.64	168
	20150415	12320	12320	12400	12400	12400	12400	12400	80	80	2	24.80	170
	20150416	12400	12400	12675	12675	12675	12675	12675	275	275	4	50.70	170
	20150417	12675	12675	12500	12500	12500	12500	12500	-175	-175	10	125.00	170
	20150420	12500	12500	12615	12615	12615	12615	12615	115	115	4	50.46	170
	20150421	12615	12615	12520	12980	12520	12980	12880	365	265	14	180.33	166
	20150422	12980	12880	12985	13085	12985	13050	13030	170	150	12	156.40	164
	20150423	13050	13030	13145	13325	13095	13115	13145	85	115	30	394.45	146
	20150424	13115	13145	13185	13310	13185	13195	13235	50	90	16	211.81	146
	20150427	13195	13235	13250	14020	13250	14000	13595	765	360	26	353.58	144
	20150428	14000	13595	14410	14410	13960	14000	14025	405	430	82	1,150.14	114
	20150429	14000	14025	14040	14040	13770	13785	13925	-240	-100	70	974.90	120
	20150430	13785	13925	14265	14335	14190	14230	14245	305	320	48	683.98	116
ru1508	20150105	13240	13315	13105	13195	13000	13080	13070	-235	-245	34	444.47	34
	20150106	13080	13070	13235	13375	13235	13375	13305	305	235	4	53.22	34
	20150107	13375	13305	12955	12980	12955	12980	12965	-325	-340	4	51.87	36
	20150108	12980	12965	12955	12955	12815	12910	12880	-55	-85	8	103.05	36
	20150109	12910	12880				12800	12800	-80	-80	0	0.00	36
	20150112	12800	12800	12950	13065	12950	13065	13010	265	210	6	78.08	32
	20150113	13065	13010	12785	12845	12785	12845	12815	-165	-195	4	51.26	32
	20150114	12845	12815	12515	12515	12125	12180	12235	-635	-580	8	97.89	36
	20150115	12180	12235				12235	12235	0	0	0	0.00	36
	20150116	12235	12235				12450	12450	215	215	0	0.00	36
	20150119	12450	12450				12340	12340	-110	-110	0	0.00	36
	20150120	12340	12340				12420	12420	80	80	0	0.00	36
	20150121	12420	12420	12380	12650	12380	12650	12470	230	50	6	74.84	38
	20150122	12650	12470	12700	12870	12700	12870	12800	400	330	12	153.63	34
	20150123	12870	12800	12785	12785	12685	12710	12725	-90	-75	6	76.36	36
	20150126	12710	12725	12765	12765	12575	12575	12670	-150	-55	4	50.68	38
	20150127	12575	12670	12900	12900	12900	12900	12900	230	230	16	206.40	40
	20150128	12900	12900	12905	12905	12905	12905	12905	5	5	2	25.81	40
	20150129	12905	12905				12830	12830	-75	-75	0	0.00	40
	20150130	12830	12830				12460	12460	-370	-370	0	0.00	40
	20150202	12460	12460	12560	12600	12560	12600	12580	140	120	4	50.32	40
	20150203	12600	12580	12770	12770	12770	12770	12770	190	190	2	25.54	40
	20150204	12770	12770	12960	13220	12960	13140	13100	370	330	42	550.28	44
	20150205	13140	13100	13075	13125	12960	13110	13080	10	-20	22	287.79	38
	20150206	13110	13080	13150	13180	13150	13180	13165	100	85	4	52.66	34
	20150209	13180	13165	13235	13235	13235	13235	13235	70	70	2	26.47	34
	20150210	13235	13235				13235	13235	0	0	0	0.00	34
	20150211	13235	13235	13155	13155	13155	13155	13155	-80	-80	2	26.31	34
	20150212	13155	13155	13100	13140	13100	13140	13125	-15	-30	6	78.75	36
	20150213	13140	13125	13190	13460	13190	13330	13345	205	220	12	160.16	34
	20150216	13330	13345	13425	13425	13215	13375	13345	30	0	32	427.06	42
	20150217	13375	13345	13360	13360	13185	13185	13260	-160	-85	6	79.57	40
	20150225	13185	13260				13260	13260	0	0	0	0.00	40
	20150226	13260	13260	13155	13520	13155	13520	13295	260	35	18	239.32	38
	20150227	13520	13295	13340	13340	13340	13340	13340	45	45	4	53.36	38
	20150302	13340	13340	13405	13405	13180	13185	13260	-155	-80	10	132.63	38
	20150303	13185	13260	13165	13165	12880	12880	12985	-380	-275	6	77.92	42
	20150304	12880	12985	12920	13015	12845	13000	12940	15	-45	20	258.84	38
	20150305	13000	12940	12750	12750	12750	12750	12750	-190	-190	2	25.50	38
	20150306	12750	12750	12855	12855	12630	12630	12700	-120	-50	24	304.91	40
	20150309	12630	12700				12700	12700	0	0	0	0.00	40
	20150310	12700	12700	12675	12675	12675	12675	12675	-25	-25	2	25.35	38
	20150311	12675	12675	12760	12760	12645	12645	12710	-30	35	40	508.46	38
	20150312	12645	12710	12750	12750	12740	12745	12745	35	35	42	535.38	56
	20150313	12745	12745	12835	12835	12775	12780	12795	35	50	6	76.78	56
	20150316	12780	12795	12490	12490	12490	12490	12490	-305	-305	2	24.98	56
	20150317	12490	12490	12560	12560	12480	12480	12520	-10	30	4	50.08	60
	20150318	12480	12520	12455	12455	12455	12455	12455	-65	-65	4	49.82	56
	20150319	12455	12455	12465	12590	12375	12500	12450	45	-5	16	199.22	58
	20150320	12500	12450	12530	12530	12430	12430	12445	-20	-5	26	323.59	76
	20150323	12430	12445	12675	12845	12675	12845	12795	400	350	76	972.43	84
	20150324	12845	12795	13050	13170	12995	13005	13085	210	290	30	392.68	78
	20150325	13005	13085	13015	13015	12870	12870	12945	-215	-140	8	103.58	76
	20150326	12870	12945	13100	13100	13045	13065	13060	120	115	14	182.88	76
	20150327	13065	13060				12700	12700	-360	-360	0	0.00	76
	20150330	12700	12700	12560	12760	12560	12670	12655	-30	-45	8	101.24	76
	20150331	12670	12655	12645	12715	12385	12385	12425	-270	-230	580	7,208.24	588
	20150401	12385	12425	12450	12640	12450	12540	12510	115	85	86	1,076.21	510
	20150402	12540	12510	12725	12725	12705	12705	12715	195	205	4	50.86	510
	20150403	12705	12715				12715	12715	0	0	0	0.00	510
	20150407	12715	12715	12815	12825	12780	12780	12805	65	90	6	76.84	510
	20150408	12780	12805	12775	12870	12505	12505	12750	-300	-55	60	765.05	512
	20150409	12505	12750	12490	12490	12120	12195	12220	-555	-530	16	195.55	512
	20150410	12195	12220	12170	12225	12100	12225	12155	5	-65	12	145.87	512
	20150413	12225	12155	12335	12555	12335	12535	12510	380	355	52	650.66	512
	20150414	12535	12510	12525	12590	12425	12510	12485	0	-25	118	1,473.31	532
	20150415	12510	12485	12615	12660	12600	12600	12630	115	145	68	858.91	522
	20150416	12600	12630	12720	12720	12620	12620	12670	-10	40	4	50.68	522
	20150417	12620	12670	12550	12550	12550	12550	12550	-120	-120	2	25.10	520
	20150420	12550	12550				12550	12550	0	0	0	0.00	520
	20150421	12550	12550	12550	13060	12515	12960	12725	410	175	30	381.82	524
	20150422	12960	12725	13175	13180	13050	13180	13105	455	380	58	760.28	524
	20150423	13180	13105	13155	13430	13155	13250	13280	145	175	50	664.20	526
	20150424	13250	13280	13300	13375	13220	13225	13300	-55	20	44	585.31	524
	20150427	13225	13300	13325	14095	13325	14095	13980	795	680	186	2,600.51	370
	20150428	14095	13980	14275	14315	14155	14155	14270	175	290	16	228.33	372
	20150429	14155	14270	14220	14220	14065	14125	14125	-145	-145	8	113.02	372
	20150430	14125	14125	14295	14295	14265	14265	14280	140	155	4	57.12	372
ru1509	20150105	13245	13210	13145	13170	12895	12985	13000	-225	-210	97468	1,267,290.16	94904
	20150106	12985	13000	12935	13350	12870	13240	13180	240	180	112964	1,489,238.52	98282
	20150107	13240	13180	13120	13275	12885	12915	13035	-265	-145	136746	1,783,004.59	96412
	20150108	12915	13035	12905	12970	12690	12845	12835	-190	-200	124588	1,599,371.80	95730
	20150109	12845	12835	12900	13170	12700	12960	12915	125	80	135928	1,755,566.83	91276
	20150112	12960	12915	12980	13155	12910	12945	13035	30	120	118690	1,547,575.01	95794
	20150113	12945	13035	12850	12900	12565	12590	12725	-445	-310	114524	1,457,823.36	91498
	20150114	12590	12725	12480	12600	12050	12170	12310	-555	-415	180928	2,227,225.14	94064
	20150115	12170	12310	12215	12470	12155	12370	12320	60	10	121674	1,499,258.41	95990
	20150116	12370	12320	12390	12640	12255	12370	12410	50	90	146978	1,824,251.51	94748
	20150119	12370	12410	12360	12550	12305	12460	12450	50	40	139246	1,733,991.40	96714
	20150120	12460	12450	12340	12565	12340	12410	12465	-40	15	109980	1,371,231.61	99796
	20150121	12410	12465	12470	12730	12230	12695	12520	230	55	179664	2,249,721.83	98748
	20150122	12695	12520	12620	12975	12620	12830	12855	310	335	186256	2,394,339.75	101820
	20150123	12830	12855	12840	12880	12650	12810	12750	-45	-105	157244	2,005,502.30	107528
	20150126	12810	12750	12860	12925	12480	12725	12675	-25	-75	170578	2,162,796.44	110612
	20150127	12725	12675	12800	13050	12775	12905	12920	230	245	159222	2,057,558.55	114178
	20150128	12905	12920	12860	13015	12735	12845	12890	-75	-30	142328	1,834,746.89	113602
	20150129	12845	12890	12845	12890	12645	12740	12755	-150	-135	118672	1,514,024.82	113374
	20150130	12740	12755	12700	12825	12440	12450	12610	-305	-145	148260	1,869,841.44	114480
	20150202	12450	12610	12510	12850	12400	12810	12615	200	5	167528	2,113,791.65	121460
	20150203	12810	12615	12850	12980	12770	12880	12865	265	250	153084	1,969,964.96	124312
	20150204	12880	12865	12930	13395	12870	13060	13150	195	285	214938	2,827,446.80	131426
	20150205	13060	13150	13150	13230	12980	12990	13105	-160	-45	209248	2,743,223.35	131470
	20150206	12990	13105	13060	13375	13010	13365	13225	260	120	186648	2,469,064.23	135416
	20150209	13365	13225	13340	13535	13190	13275	13315	50	90	170974	2,276,715.71	133028
	20150210	13275	13315	13255	13340	13150	13200	13230	-115	-85	114880	1,520,181.14	135476
	20150211	13200	13230	13160	13310	13060	13290	13225	60	-5	124884	1,652,057.09	135996
	20150212	13290	13225	13285	13350	13105	13240	13225	15	0	132466	1,752,390.82	137678
	20150213	13240	13225	13310	13515	13230	13400	13380	175	155	202412	2,709,095.77	143108
	20150216	13400	13380	13400	13470	13205	13335	13335	-45	-45	150770	2,011,029.59	136918
	20150217	13335	13335	13350	13350	13110	13155	13200	-180	-135	105752	1,396,082.50	136252
	20150225	13155	13200	13010	13235	13010	13135	13140	-65	-60	84522	1,110,860.11	140484
	20150226	13135	13140	13150	13605	13115	13575	13380	435	240	197874	2,648,034.55	161980
	20150227	13575	13380	13600	13635	13385	13440	13510	60	130	198616	2,684,050.53	164456
	20150302	13440	13510	13450	13595	13170	13250	13325	-260	-185	357876	4,769,329.52	171696
	20150303	13250	13325	13250	13300	12800	12895	12985	-430	-340	329946	4,285,844.86	182574
	20150304	12895	12985	12900	13135	12855	12935	13030	-50	45	353704	4,609,082.60	194532
	20150305	12935	13030	12920	12970	12680	12810	12835	-220	-195	366192	4,700,554.23	189844
	20150306	12810	12835	12830	12925	12600	12700	12780	-135	-55	367544	4,697,913.17	197236
	20150309	12700	12780	12695	12885	12530	12815	12725	35	-55	428198	5,450,119.90	195742
	20150310	12815	12725	12765	12815	12485	12490	12680	-235	-45	414842	5,260,918.67	208668
	20150311	12490	12680	12480	12860	12450	12705	12660	25	-20	446474	5,652,443.03	196484
	20150312	12705	12660	12735	12915	12660	12865	12795	205	135	358682	4,590,414.03	197518
	20150313	12865	12795	12865	12895	12720	12735	12785	-60	-10	363380	4,647,466.45	205068
	20150316	12735	12785	12700	12705	12345	12580	12560	-205	-225	370350	4,651,969.51	212408
	20150317	12580	12560	12595	12720	12495	12555	12595	-5	35	403490	5,083,383.99	223090
	20150318	12555	12595	12515	12590	12380	12495	12490	-100	-105	381424	4,765,315.53	222378
	20150319	12495	12490	12465	12670	12430	12540	12555	50	65	329890	4,142,979.08	228938
	20150320	12540	12555	12555	12635	12405	12560	12530	5	-25	389678	4,883,475.77	224660
	20150323	12560	12530	12610	13080	12580	12990	12855	460	325	587922	7,559,256.09	218798
	20150324	12990	12855	13050	13275	12950	13050	13100	195	245	554488	7,264,363.70	225788
	20150325	13050	13100	13050	13100	12880	12930	12980	-170	-120	438542	5,693,829.77	225884
	20150326	12930	12980	12980	13215	12915	13065	13050	85	70	498130	6,502,182.37	237340
	20150327	13065	13050	13030	13095	12590	12815	12810	-235	-240	557798	7,146,752.67	227124
	20150330	12815	12810	12840	12845	12620	12640	12720	-170	-90	410000	5,215,480.29	233920
	20150331	12640	12720	12650	12750	12510	12540	12635	-180	-85	383832	4,851,240.97	234768
	20150401	12540	12635	12500	12720	12500	12595	12620	-40	-15	327708	4,136,902.85	228208
	20150402	12595	12620	12605	12880	12590	12770	12765	150	145	410134	5,237,080.79	225222
	20150403	12770	12765	12760	12840	12630	12775	12745	10	-20	361444	4,608,187.59	220616
	20150407	12775	12745	12775	12990	12730	12880	12885	135	140	270574	3,487,347.67	225542
	20150408	12880	12885	12860	12920	12545	12630	12695	-255	-190	471072	5,980,655.01	243950
	20150409	12630	12695	12610	12620	12205	12300	12375	-395	-320	446250	5,523,407.19	264350
	20150410	12300	12375	12320	12375	12230	12350	12315	-25	-60	290056	3,572,334.95	252222
	20150413	12350	12315	12355	12790	12355	12655	12595	340	280	436216	5,495,406.73	230882
	20150414	12655	12595	12705	12730	12485	12670	12590	75	-5	346978	4,369,911.59	230160
	20150415	12670	12590	12670	12815	12620	12645	12710	55	120	393332	4,999,991.61	228768
	20150416	12645	12710	12645	12885	12560	12760	12780	50	70	403752	5,160,917.17	231006
	20150417	12760	12780	12780	12880	12650	12725	12775	-55	-5	455754	5,823,474.30	223514
	20150420	12725	12775	12700	12840	12685	12715	12755	-60	-20	315406	4,024,450.18	223424
	20150421	12715	12755	12675	13240	12620	13230	13015	475	260	645466	8,402,208.76	249908
	20150422	13230	13015	13230	13320	13130	13225	13225	210	210	407624	5,392,165.04	255596
	20150423	13225	13225	13230	13580	13200	13335	13380	110	155	590976	7,909,206.63	259878
	20150424	13335	13380	13380	13475	13320	13460	13395	80	15	350252	4,693,200.66	260612
	20150427	13460	13395	13520	14195	13400	14195	13835	800	440	565400	7,825,135.69	282960
	20150428	14195	13835	14250	14580	14120	14280	14370	445	535	753416	10,829,310.99	278014
	20150429	14280	14370	14320	14350	13855	14060	14165	-310	-205	631070	8,941,112.12	276042
	20150430	14060	14165	14135	14525	14060	14470	14360	305	195	666368	9,570,319.66	286622
ru1510	20150105	13215	13315	13040	13110	12800	12800	12870	-515	-445	576	7,414.33	684
	20150106	12800	12870	12865	13050	12780	12780	12935	-90	65	658	8,512.39	636
	20150107	12780	12935	12700	12940	12700	12790	12800	-145	-135	134	1,715.44	644
	20150108	12790	12800	12800	12835	12610	12740	12715	-60	-85	232	2,950.74	646
	20150109	12740	12715	12740	12945	12740	12850	12870	135	155	14	180.23	642
	20150112	12850	12870	12990	12995	12900	12970	12950	100	80	60	777.29	646
	20150113	12970	12950	12800	12890	12590	12625	12700	-325	-250	64	812.83	636
	20150114	12625	12700	12410	12500	12115	12170	12375	-530	-325	42	519.94	644
	20150115	12170	12375	12110	12350	12110	12350	12210	-25	-165	20	244.26	648
	20150116	12350	12210	12400	12425	12240	12290	12325	80	115	20	246.56	642
	20150119	12290	12325	12460	12490	12275	12390	12385	65	60	34	421.21	638
	20150120	12390	12385	12395	12490	12395	12490	12455	105	70	16	199.31	638
	20150121	12490	12455	12280	12625	12280	12600	12405	145	-50	46	570.74	638
	20150122	12600	12405	12560	12800	12560	12620	12730	215	325	94	1,196.78	678
	20150123	12620	12730	12560	12625	12560	12565	12580	-165	-150	14	176.15	678
	20150126	12565	12580	12725	12725	12335	12485	12490	-95	-90	30	374.71	678
	20150127	12485	12490	12685	12800	12645	12750	12765	260	275	102	1,302.32	696
	20150128	12750	12765	12700	12800	12545	12705	12695	-60	-70	118	1,498.58	756
	20150129	12705	12695	12660	12680	12530	12605	12640	-90	-55	42	531.08	718
	20150130	12605	12640	12640	12640	12335	12335	12410	-305	-230	38	471.61	712
	20150202	12335	12410	12380	12730	12265	12730	12495	320	85	24	299.95	710
	20150203	12730	12495	12700	12780	12700	12780	12730	285	235	20	254.64	710
	20150204	12780	12730	12880	13180	12780	13005	13010	275	280	78	1,015.09	716
	20150205	13005	13010	12990	13075	12900	12900	12990	-110	-20	84	1,091.46	714
	20150206	12900	12990	13020	13210	12960	13210	13125	220	135	200	2,625.22	742
	20150209	13210	13125	13220	13320	13075	13095	13150	-30	25	108	1,420.41	724
	20150210	13095	13150	13050	13120	12930	12970	13005	-180	-145	76	988.39	708
	20150211	12970	13005	12975	13025	12900	13005	12975	0	-30	50	648.97	708
	20150212	13005	12975	13030	13040	12900	12970	12955	-5	-20	48	622.05	702
	20150213	12970	12955	13025	13205	13025	13160	13100	205	145	68	890.86	700
	20150216	13160	13100	13090	13275	13030	13250	13145	150	45	524	6,889.46	920
	20150217	13250	13145	13195	13210	13045	13045	13125	-100	-20	72	945.26	924
	20150225	13045	13125	13020	13100	12980	13040	13040	-85	-85	54	704.42	902
	20150226	13040	13040	13045	13470	13045	13470	13230	430	190	94	1,243.85	862
	20150227	13470	13230	13505	13525	13400	13520	13505	290	275	588	7,943.76	1374
	20150302	13520	13505	13490	13580	13250	13270	13415	-235	-90	92	1,234.51	1338
	20150303	13270	13415	13265	13265	12970	12995	13025	-420	-390	60	781.54	1340
	20150304	12995	13025	12960	13180	12900	13165	13050	140	25	38	496.03	1328
	20150305	13165	13050	12565	13010	12540	12860	12835	-190	-215	124	1,591.84	1322
	20150306	12860	12835	12895	12960	12640	12680	12865	-155	30	80	1,029.24	1310
	20150309	12680	12865	12640	12915	12640	12810	12745	-55	-120	50	637.31	1306
	20150310	12810	12745	12795	12800	12660	12660	12765	-85	20	20	255.31	1304
	20150311	12660	12765	12520	12790	12520	12680	12715	-85	-50	422	5,365.83	1064
	20150312	12680	12715	12670	12735	12665	12735	12695	20	-20	694	8,813.71	756
	20150313	12735	12695	12715	12715	12600	12620	12650	-75	-45	18	227.75	760
	20150316	12620	12650	12510	12540	12320	12475	12480	-175	-170	48	599.21	790
	20150317	12475	12480	12850	12850	12415	12460	12505	-20	25	18	225.09	788
	20150318	12460	12505	12450	12450	12290	12350	12395	-155	-110	46	570.22	790
	20150319	12350	12395	12315	12545	12315	12420	12440	25	45	46	572.24	788
	20150320	12420	12440	12445	12530	12360	12450	12435	10	-5	28	348.31	788
	20150323	12450	12435	12500	12935	12480	12870	12660	435	225	64	810.36	788
	20150324	12870	12660	12925	13145	12910	12920	12990	260	330	82	1,065.19	786
	20150325	12920	12990	12900	12945	12855	12860	12900	-130	-90	66	851.59	790
	20150326	12860	12900	12980	13135	12860	13020	13000	120	100	118	1,534.18	832
	20150327	13020	13000	12900	12900	12610	12635	12665	-365	-335	14	177.33	824
	20150330	12635	12665	12715	12730	12600	12700	12690	35	25	50	634.66	814
	20150331	12700	12690	12665	12665	12485	12485	12585	-205	-105	20	251.75	804
	20150401	12485	12585	12555	12665	12490	12590	12565	5	-20	26	326.79	792
	20150402	12590	12565	12770	12800	12710	12800	12760	235	195	58	740.35	800
	20150403	12800	12760	12740	12800	12680	12800	12745	40	-15	42	535.48	794
	20150407	12800	12745	12870	12870	12570	12760	12805	15	60	98	1,254.96	800
	20150408	12760	12805	12715	12765	12475	12540	12555	-265	-250	80	1,004.75	790
	20150409	12540	12555	12515	12515	12170	12240	12305	-315	-250	58	713.76	784
	20150410	12240	12305	12210	12260	12180	12200	12210	-105	-95	82	1,001.49	810
	20150413	12200	12210	12400	12565	12330	12535	12465	325	255	64	797.96	782
	20150414	12535	12465	12465	12505	12380	12505	12450	40	-15	184	2,290.82	820
	20150415	12505	12450	12510	12615	12505	12510	12560	60	110	96	1,206.14	782
	20150416	12510	12560	12655	12720	12650	12685	12670	125	110	20	253.48	776
	20150417	12685	12670	12715	12715	12575	12685	12660	15	-10	72	911.87	786
	20150420	12685	12660	12460	12705	12460	12660	12610	0	-50	22	277.51	780
	20150421	12660	12610	12600	13040	12505	13040	12970	430	360	108	1,401.01	766
	20150422	13040	12970	13055	13160	13015	13095	13075	125	105	48	627.81	770
	20150423	13095	13075	13160	13370	13160	13250	13290	175	215	1052	13,981.44	1466
	20150424	13250	13290	13310	13410	13285	13285	13355	-5	65	228	3,046.06	1574
	20150427	13285	13355	13370	14155	13370	14145	13975	790	620	154	2,152.39	1520
	20150428	14145	13975	14270	14485	14085	14180	14280	205	305	180	2,571.11	1456
	20150429	14180	14280	14165	14270	13840	13980	14085	-300	-195	100	1,408.58	1434
	20150430	13980	14085	14035	14380	14020	14320	14200	235	115	38	539.77	1422
ru1511	20150105	13205	13230	12880	13105	12820	12840	12875	-390	-355	572	7,366.57	1658
	20150106	12840	12875	12755	13045	12755	12950	12955	75	80	1660	21,508.80	1882
	20150107	12950	12955	12800	13060	12800	12860	12920	-95	-35	812	10,492.78	2036
	20150108	12860	12920	12915	12915	12640	12785	12775	-135	-145	404	5,162.38	2120
	20150109	12785	12775	12745	13090	12680	12910	12810	135	35	536	6,866.93	2240
	20150112	12910	12810	12950	13120	12890	12910	13000	100	190	436	5,668.07	2368
	20150113	12910	13000	12750	12825	12560	12575	12670	-425	-330	670	8,490.52	2628
	20150114	12575	12670	12500	12565	12015	12180	12275	-490	-395	258	3,167.16	2662
	20150115	12180	12275	12160	12400	12105	12320	12250	45	-25	78	955.70	2646
	20150116	12320	12250	12450	12600	12245	12350	12385	100	135	284	3,517.79	2660
	20150119	12350	12385	12455	12475	12340	12400	12410	15	25	76	943.44	2662
	20150120	12400	12410	12370	12500	12320	12370	12380	-40	-30	124	1,535.32	2656
	20150121	12370	12380	12370	12630	12225	12600	12460	220	80	344	4,287.40	2722
	20150122	12600	12460	12600	12875	12585	12690	12750	230	290	352	4,488.68	2806
	20150123	12690	12750	12700	12725	12570	12615	12625	-135	-125	204	2,576.22	2788
	20150126	12615	12625	12720	12830	12400	12565	12580	-60	-45	198	2,490.91	2768
	20150127	12565	12580	12650	12940	12650	12815	12815	235	235	248	3,178.16	2768
	20150128	12815	12815	12720	12895	12695	12715	12785	-100	-30	220	2,813.65	2790
	20150129	12715	12785	12775	12775	12590	12660	12665	-125	-120	160	2,026.88	2820
	20150130	12660	12665	12620	12740	12400	12400	12580	-265	-85	1182	14,872.85	2922
	20150202	12400	12580	12445	12800	12350	12780	12555	200	-25	418	5,249.32	2902
	20150203	12780	12555	12780	12915	12735	12840	12830	285	275	398	5,106.83	3014
	20150204	12840	12830	12845	13275	12805	13010	13145	180	315	2074	27,263.66	4124
	20150205	13010	13145	13055	13170	12935	12975	13055	-170	-90	1182	15,431.18	4462
	20150206	12975	13055	13005	13290	13005	13290	13215	235	160	518	6,846.81	4638
	20150209	13290	13215	13255	13415	13065	13080	13200	-135	-15	2322	30,655.45	4534
	20150210	13080	13200	13045	13145	12980	13005	13055	-195	-145	826	10,784.80	4624
	20150211	13005	13055	12985	13110	12900	13100	13060	45	5	274	3,578.63	4650
	20150212	13100	13060	13075	13125	12950	13050	13055	-10	-5	398	5,196.21	4718
	20150213	13050	13055	13130	13275	13070	13180	13165	125	110	904	11,905.59	5060
	20150216	13180	13165	13155	13270	13070	13230	13180	65	15	1274	16,794.34	5090
	20150217	13230	13180	13200	13230	12965	13005	13055	-175	-125	938	12,248.65	5372
	20150225	13005	13055	12985	13025	12915	12945	12955	-110	-100	408	5,285.68	5446
	20150226	12945	12955	12955	13445	12950	13445	13235	490	280	1274	16,863.22	5160
	20150227	13445	13235	13425	13505	13285	13310	13435	75	200	1508	20,265.33	5328
	20150302	13310	13435	13325	13500	13090	13145	13235	-290	-200	844	11,174.31	5378
	20150303	13145	13235	13160	13190	12760	12845	12920	-390	-315	1336	17,264.73	5510
	20150304	12845	12920	12840	13025	12840	12880	12945	-40	25	548	7,094.14	5508
	20150305	12880	12945	12805	12905	12605	12770	12710	-175	-235	1098	13,956.95	5472
	20150306	12770	12710	12845	12850	12540	12610	12700	-100	-10	1524	19,359.18	5562
	20150309	12610	12700	12600	12770	12455	12700	12680	0	-20	2382	30,208.36	5500
	20150310	12700	12680	12680	12700	12405	12420	12580	-260	-100	1082	13,614.81	5598
	20150311	12420	12580	12395	12660	12370	12560	12555	-20	-25	1444	18,134.87	5852
	20150312	12560	12555	12560	12730	12525	12720	12660	165	105	1206	15,272.62	5664
	20150313	12720	12660	12720	12735	12605	12605	12660	-55	0	564	7,140.41	5688
	20150316	12605	12660	12610	12610	12280	12485	12460	-175	-200	996	12,412.66	5830
	20150317	12485	12460	12500	12585	12410	12435	12485	-25	25	816	10,187.83	5906
	20150318	12435	12485	12415	12470	12300	12405	12400	-80	-85	912	11,311.07	5994
	20150319	12405	12400	12400	12570	12345	12455	12470	55	70	1180	14,718.45	6130
	20150320	12455	12470	12465	12540	12360	12470	12465	0	-5	978	12,190.92	6224
	20150323	12470	12465	12540	12980	12520	12885	12750	420	285	3314	42,253.66	7282
	20150324	12885	12750	12885	13175	12870	13030	13040	280	290	3436	44,816.51	7450
	20150325	13030	13040	13025	13055	12885	12915	12955	-125	-85	1892	24,510.91	7602
	20150326	12915	12955	12935	13155	12910	13020	13030	65	75	2296	29,921.13	7656
	20150327	13020	13030	13015	13035	12585	12760	12775	-270	-255	3060	39,095.69	7648
	20150330	12760	12775	12765	12780	12585	12610	12680	-165	-95	1930	24,481.03	7726
	20150331	12610	12680	12645	12690	12500	12510	12615	-170	-65	1598	20,164.94	7688
	20150401	12510	12615	12510	12675	12495	12580	12590	-35	-25	1338	16,847.33	7730
	20150402	12580	12590	12600	12825	12580	12755	12725	165	135	1666	21,202.66	8068
	20150403	12755	12725	12725	12790	12600	12730	12710	5	-15	994	12,636.57	8098
	20150407	12730	12710	12750	12880	12750	12770	12810	60	100	1032	13,222.06	8152
	20150408	12770	12810	12770	12800	12495	12575	12615	-235	-195	1714	21,629.17	8104
	20150409	12575	12615	12575	12575	12190	12255	12315	-360	-300	2738	33,728.83	8672
	20150410	12255	12315	12285	12300	12175	12270	12240	-45	-75	1260	15,427.54	9030
	20150413	12270	12240	12300	12625	12300	12550	12480	310	240	1844	23,021.22	9140
	20150414	12550	12480	12585	12595	12410	12565	12495	85	15	1154	14,421.46	9228
	20150415	12565	12495	12535	12660	12515	12540	12590	45	95	1190	14,982.57	9294
	20150416	12540	12590	12530	12745	12475	12650	12665	60	75	1174	14,870.25	9236
	20150417	12650	12665	12700	12735	12575	12640	12665	-25	0	1214	15,376.05	9318
	20150420	12640	12665	12605	12745	12530	12645	12675	-20	10	834	10,573.36	9390
	20150421	12645	12675	12600	13100	12560	13100	12935	425	260	2160	27,940.24	9228
	20150422	13100	12935	13090	13175	13030	13110	13105	175	170	1120	14,677.87	9118
	20150423	13110	13105	13125	13440	13125	13215	13260	110	155	2084	27,638.72	8900
	20150424	13215	13260	13260	13350	13215	13350	13280	90	20	1370	18,199.93	8988
	20150427	13350	13280	13380	14075	13290	14075	13770	795	490	2316	31,899.94	8912
	20150428	14075	13770	14110	14400	13955	14075	14180	305	410	4080	57,873.37	8266
	20150429	14075	14180	14145	14145	13685	13850	13965	-330	-215	1922	26,844.42	8166
	20150430	13850	13965	13905	14310	13880	14220	14195	255	230	3022	42,905.50	8822
ru1601	20150116	12250	12250	12915	13390	12905	13090	13090	840	840	428	5,603.10	240
	20150119	13090	13090	13065	13270	13005	13200	13190	110	100	652	8,601.14	646
	20150120	13200	13190	13185	13280	13145	13145	13205	-45	15	206	2,721.20	686
	20150121	13145	13205	13170	13460	13065	13430	13250	225	45	568	7,527.93	880
	20150122	13430	13250	13375	13720	13375	13600	13605	350	355	384	5,224.48	934
	20150123	13600	13605	13560	13595	13435	13590	13535	-15	-70	196	2,652.90	960
	20150126	13590	13535	13565	13690	13355	13515	13505	-20	-30	274	3,701.10	936
	20150127	13515	13505	13585	13810	13585	13760	13705	255	200	260	3,563.72	1022
	20150128	13760	13705	13645	13770	13590	13640	13670	-65	-35	222	3,035.21	1086
	20150129	13640	13670	13670	13670	13490	13550	13565	-120	-105	224	3,038.96	1124
	20150130	13550	13565	13490	13600	13200	13200	13435	-365	-130	384	5,159.79	1252
	20150202	13200	13435	13245	13625	13180	13620	13435	185	0	264	3,547.04	1308
	20150203	13620	13435	13580	13735	13545	13665	13645	230	210	254	3,466.96	1364
	20150204	13665	13645	13675	14125	13650	13850	13920	205	275	618	8,605.43	1656
	20150205	13850	13920	13800	13990	13725	13755	13855	-165	-65	712	9,868.16	1802
	20150206	13755	13855	13765	14095	13765	14090	13985	235	130	790	11,049.71	2154
	20150209	14090	13985	14070	14220	13915	13980	14030	-5	45	892	12,517.78	2378
	20150210	13980	14030	13740	14005	13740	13895	13920	-135	-110	546	7,601.85	2512
	20150211	13895	13920	13850	13990	13745	13960	13900	40	-20	496	6,896.73	2584
	20150212	13960	13900	13980	14015	13810	13900	13905	0	5	350	4,867.58	2652
	20150213	13900	13905	13940	14100	13900	14035	14025	130	120	814	11,417.16	2940
	20150216	14035	14025	14035	14100	13865	14085	14010	60	-15	1304	18,272.11	3266
	20150217	14085	14010	14070	14070	13820	13850	13910	-160	-100	752	10,463.85	3224
	20150225	13850	13910	13850	13855	13705	13770	13765	-140	-145	1214	16,715.78	3232
	20150226	13770	13765	13780	14230	13745	14200	14010	435	245	1460	20,456.00	3846
	20150227	14200	14010	14185	14250	14055	14125	14175	115	165	968	13,721.68	3914
	20150302	14125	14175	14105	14260	13930	14050	14070	-125	-105	2216	31,188.59	4186
	20150303	14050	14070	14005	14070	13655	13760	13795	-310	-275	1820	25,112.45	4206
	20150304	13760	13795	13725	13920	13705	13790	13845	-5	50	2122	29,384.09	4522
	20150305	13790	13845	13700	13845	13560	13670	13690	-175	-155	2846	38,965.32	4452
	20150306	13670	13690	13675	13740	13380	13430	13560	-260	-130	2582	35,017.15	4778
	20150309	13430	13560	13445	13675	13280	13575	13480	15	-80	3610	48,663.76	4900
	20150310	13575	13480	13505	13600	13245	13265	13440	-215	-40	2768	37,211.06	5322
	20150311	13265	13440	13215	13565	13210	13445	13375	5	-65	2944	39,389.11	5798
	20150312	13445	13375	13430	13590	13380	13560	13510	185	135	2462	33,267.86	6004
	20150313	13560	13510	13580	13630	13505	13545	13565	35	55	3144	42,657.72	6496
	20150316	13545	13565	13505	13520	13150	13375	13350	-190	-215	2586	34,524.08	6372
	20150317	13375	13350	13365	13470	13270	13290	13360	-60	10	3226	43,108.94	6670
	20150318	13290	13360	13250	13375	13185	13290	13270	-70	-90	3164	41,995.68	6762
	20150319	13290	13270	13255	13455	13240	13345	13355	75	85	2198	29,362.06	7018
	20150320	13345	13355	13380	13430	13280	13385	13375	30	20	3624	48,484.04	7582
	20150323	13385	13375	13455	14030	13430	13945	13765	570	390	7442	102,448.00	9276
	20150324	13945	13765	13960	14235	13955	14045	14080	280	315	6778	95,452.54	10266
	20150325	14045	14080	14025	14065	13870	13900	13955	-180	-125	5550	77,453.54	10310
	20150326	13900	13955	13920	14020	13815	13905	13920	-50	-35	6974	97,106.18	11626
	20150327	13905	13920	13735	13950	13500	13620	13685	-300	-235	7190	98,427.47	11442
	20150330	13620	13685	13585	13650	13470	13495	13550	-190	-135	4306	58,365.46	11726
	20150331	13495	13550	13505	13615	13425	13465	13535	-85	-15	6226	84,292.91	12684
	20150401	13465	13535	13455	13615	13415	13480	13525	-55	-10	5288	71,534.23	13282
	20150402	13480	13525	13510	13765	13490	13655	13655	130	130	5536	75,602.67	13988
	20150403	13655	13655	13610	13720	13505	13660	13635	5	-20	5908	80,576.55	14850
	20150407	13660	13635	13650	13795	13630	13640	13705	5	70	5930	81,291.93	15822
	20150408	13640	13705	13640	13700	13420	13490	13535	-215	-170	9234	125,023.12	16090
	20150409	13490	13535	13470	13495	13125	13150	13275	-385	-260	11250	149,386.34	15470
	20150410	13150	13275	13210	13220	13080	13180	13145	-95	-130	7650	100,585.69	16918
	20150413	13180	13145	13180	13560	13180	13460	13420	315	275	12382	166,183.36	18222
	20150414	13460	13420	13490	13520	13315	13450	13395	30	-25	9256	123,988.04	18970
	20150415	13450	13395	13420	13585	13420	13425	13500	30	105	10932	147,622.88	19416
	20150416	13425	13500	13415	13665	13355	13585	13565	85	65	17850	242,182.89	19938
	20150417	13585	13565	13585	13680	13475	13525	13585	-40	20	18870	256,423.40	20454
	20150420	13525	13585	13465	13660	13465	13525	13575	-60	-10	16110	218,747.46	20380
	20150421	13525	13575	13505	14030	13450	13995	13875	420	300	36334	504,203.21	23812
	20150422	13995	13875	13960	14040	13895	13955	13965	80	90	23622	329,955.57	26490
	20150423	13955	13965	13970	14270	13935	14060	14105	95	140	33600	473,950.25	28026
	20150424	14060	14105	14060	14275	14060	14265	14170	160	65	23794	337,162.95	29836
	20150427	14265	14170	14300	15020	14195	15015	14755	845	585	65856	972,006.98	40762
	20150428	15015	14755	15030	15250	14900	14980	15080	225	325	62262	939,001.44	42882
	20150429	14980	15080	15010	15060	14605	14805	14880	-275	-200	54794	815,551.71	43202
	20150430	14805	14880	14880	15225	14805	15160	15085	280	205	49894	752,683.68	47422
ru1603	20150317	13350	13350	13370	13475	13350	13360	13400	10	50	22	294.81	14
	20150318	13360	13400				13400	13400	0	0	0	0.00	14
	20150319	13400	13400	13305	13470	13305	13440	13380	40	-20	12	160.60	20
	20150320	13440	13380	13510	13515	13400	13435	13485	55	105	22	296.69	38
	20150323	13435	13485	13605	14020	13605	13980	13905	495	420	22	305.97	40
	20150324	13980	13905	14090	14275	14090	14245	14175	340	270	32	453.61	50
	20150325	14245	14175	14070	14105	14000	14020	14035	-155	-140	12	168.44	56
	20150326	14020	14035	14020	14070	13960	14070	14020	35	-15	20	280.47	54
	20150327	14070	14020	14000	14000	13680	13705	13850	-315	-170	18	249.32	52
	20150330	13705	13850				13850	13850	0	0	0	0.00	52
	20150331	13850	13850	13630	13755	13500	13500	13620	-350	-230	14	190.73	54
	20150401	13500	13620	13565	13600	13565	13600	13575	-20	-45	6	81.47	54
	20150402	13600	13575	13705	13810	13660	13770	13755	195	180	34	467.81	82
	20150403	13770	13755	13700	13820	13700	13810	13755	55	0	12	165.09	88
	20150407	13810	13755	13815	13825	13815	13825	13820	70	65	4	55.28	86
	20150408	13825	13820	13600	13680	13600	13620	13630	-200	-190	6	81.80	90
	20150409	13620	13630	13340	13425	13240	13320	13340	-310	-290	28	373.59	80
	20150410	13320	13340	13280	13300	13280	13300	13290	-40	-50	4	53.16	82
	20150413	13300	13290	13500	13620	13500	13550	13600	260	310	50	680.18	100
	20150414	13550	13600	13500	13540	13500	13540	13520	-60	-80	4	54.08	104
	20150415	13540	13520	13700	13700	13640	13640	13670	120	150	4	54.68	106
	20150416	13640	13670	13660	13780	13660	13780	13720	110	50	4	54.88	108
	20150417	13780	13720	13705	13810	13685	13760	13765	40	45	92	1,266.57	150
	20150420	13760	13765	13695	13815	13630	13660	13690	-105	-75	108	1,478.97	128
	20150421	13660	13690	13700	14120	13575	13980	13790	290	100	58	799.84	106
	20150422	13980	13790	14145	14170	13935	14140	14090	350	300	24	338.22	104
	20150423	14140	14090	14195	14355	14195	14350	14270	260	180	12	171.27	106
	20150424	14350	14270	14185	14350	14185	14310	14265	40	-5	20	285.38	110
	20150427	14310	14265	14380	15120	14380	15120	14985	855	720	58	869.18	126
	20150428	15120	14985	15425	15425	15080	15100	15220	115	235	50	761.21	120
	20150429	15100	15220	15060	15125	14660	14900	15015	-320	-205	74	1,111.28	126
	20150430	14900	15015	15055	15320	15055	15260	15205	245	190	30	456.28	130
ru1604	20150416	13670	13670	13755	13795	13755	13775	13775	105	105	12	165.32	12
	20150417	13775	13775				13820	13820	45	45	0	0.00	12
	20150420	13820	13820	13865	13865	13850	13850	13855	30	35	12	166.28	20
	20150421	13850	13855	13750	13830	13415	13780	13710	-75	-145	12	164.52	22
	20150422	13780	13710	14290	14290	14130	14135	14190	425	480	10	141.94	22
	20150423	14135	14190	14420	14420	14175	14265	14285	75	95	6	85.72	20
	20150424	14265	14285	14215	14385	14215	14385	14290	100	5	18	257.23	26
	20150427	14385	14290	14430	15110	14315	15010	14660	720	370	14	205.30	32
	20150428	15010	14660	15105	15385	15105	15125	15230	465	570	34	517.98	32
	20150429	15125	15230	15040	15040	14775	14775	14840	-455	-390	14	207.77	36
	20150430	14775	14840	15400	15400	15240	15295	15300	455	460	12	183.61	42
sn1507	20150327	120190	120190	120000	120010	115150	119270	119230	-920	-960	1798	21,437.63	608
	20150330	119270	119230	119270	119530	115600	118080	117720	-1150	-1510	2468	29,053.72	830
	20150331	118080	117720	117650	119800	115960	118160	117790	440	70	4522	53,268.60	1176
	20150401	118160	117790	118020	118880	117070	117910	118280	120	490	4374	51,736.10	1272
	20150402	117910	118280	117970	119080	117970	118620	118540	340	260	2716	32,195.97	1038
	20150403	118620	118540	118810	119470	118560	118850	118950	310	410	1390	16,534.58	1000
	20150407	118850	118950	118890	119090	118270	118860	118630	-90	-320	848	10,059.93	904
	20150408	118860	118630	118710	118890	117150	117870	118200	-760	-430	848	10,023.48	750
	20150409	117870	118200	117570	117980	116500	116790	117190	-1410	-1010	816	9,563.43	802
	20150410	116790	117190	116500	116980	115320	115990	115860	-1200	-1330	2418	28,015.06	916
	20150413	115990	115860	115960	116290	115270	115940	115750	80	-110	1628	18,845.23	1008
	20150414	115940	115750	115550	115650	112300	112300	113680	-3450	-2070	5588	63,527.71	1894
	20150415	112300	113680	112400	114140	112320	113850	113530	170	-150	4132	46,911.01	1692
	20150416	113850	113530	113200	113700	111010	112880	112780	-650	-750	3866	43,604.23	1962
	20150417	112880	112780	113010	113010	109300	110000	111110	-2780	-1670	11322	125,802.03	3584
	20150420	110000	111110	112000	112960	111120	111440	111850	330	740	10518	117,652.75	2656
	20150421	111440	111850	111840	111880	111100	111550	111470	-300	-380	3434	38,280.01	2964
	20150422	111550	111470	112190	113430	112190	112940	112870	1470	1400	5870	66,257.90	2738
	20150423	112940	112870	113400	113760	112960	113300	113430	430	560	3310	37,546.33	2468
	20150424	113300	113430	113350	113950	112750	113940	113430	510	0	2088	23,685.19	2526
	20150427	113940	113430	114400	117960	114400	117960	116530	4530	3100	16994	198,046.73	3096
	20150428	117960	116530	117970	118550	116500	117400	117740	870	1210	31980	376,545.28	4452
	20150429	117400	117740	117140	117720	115110	115370	116820	-2370	-920	10628	124,157.17	4638
	20150430	115370	116820	116000	119900	115050	117640	117360	820	540	17782	208,690.50	5578
sn1508	20150327	120190	120190	116580	122780	116580	119260	119240	-930	-950	10	119.24	4
	20150330	119260	119240	118000	118030	116000	117850	117230	-1390	-2010	38	445.47	8
	20150331	117850	117230				117300	117300	70	70	0	0.00	8
	20150401	117300	117300	117770	118000	117770	118000	117840	700	540	12	141.42	14
	20150402	118000	117840				118100	118100	260	260	0	0.00	14
	20150403	118100	118100				118340	118340	240	240	0	0.00	14
	20150407	118340	118340				118340	118340	0	0	0	0.00	14
	20150408	118340	118340				118040	118040	-300	-300	0	0.00	14
	20150409	118040	118040				117040	117040	-1000	-1000	0	0.00	14
	20150410	117040	117040				116280	116280	-760	-760	0	0.00	14
	20150413	116280	116280				116170	116170	-110	-110	0	0.00	14
	20150414	116170	116170	114760	114760	113460	113460	114110	-2710	-2060	4	45.64	16
	20150415	113460	114110				114100	114100	-10	-10	0	0.00	16
	20150416	114100	114100				113190	113190	-910	-910	0	0.00	16
	20150417	113190	113190	112800	112800	110230	110230	111210	-2960	-1980	22	244.68	30
	20150420	110230	111210	111470	113030	111050	111870	111960	660	750	34	380.69	24
	20150421	111870	111960	111710	112230	111440	111850	111800	-110	-160	14	156.52	24
	20150422	111850	111800	113200	113200	112900	112900	113110	1100	1310	8	90.49	24
	20150423	112900	113110	113460	113760	113400	113760	113530	650	420	14	158.95	26
	20150424	113760	113530	113580	113580	113580	113580	113580	50	50	4	45.43	26
	20150427	113580	113580	115140	116720	115140	115940	116130	2360	2550	8	92.90	22
	20150428	115940	116130	118550	120770	117870	118070	118560	1940	2430	40	474.27	36
	20150429	118070	118560	116990	116990	116830	116830	116910	-1730	-1650	4	46.76	34
	20150430	116830	116910	119000	119000	117890	117890	118460	980	1550	16	189.55	40
sn1509	20150327	120190	120190				120190	120190	0	0	0	0.00	0
	20150330	120190	120190	117010	117010	117010	117010	117010	-3180	-3180	2	23.40	2
	20150331	117010	117010				117080	117080	70	70	0	0.00	2
	20150401	117080	117080				117620	117620	540	540	0	0.00	2
	20150402	117620	117620				117880	117880	260	260	0	0.00	2
	20150403	117880	117880				117880	117880	0	0	0	0.00	2
	20150407	117880	117880				117560	117560	-320	-320	0	0.00	2
	20150408	117560	117560	121070	121080	117370	117370	119220	-190	1660	8	95.38	2
	20150409	117370	119220				118210	118210	-1010	-1010	0	0.00	2
	20150410	118210	118210	117310	117310	114990	116480	116000	-1730	-2210	18	208.81	8
	20150413	116480	116000				115890	115890	-110	-110	0	0.00	8
	20150414	115890	115890				113830	113830	-2060	-2060	0	0.00	8
	20150415	113830	113830				113900	113900	70	70	0	0.00	8
	20150416	113900	113900	112930	113750	111860	113750	112840	-150	-1060	6	67.71	8
	20150417	113750	112840	112140	112140	112140	112140	112140	-700	-700	4	44.86	12
	20150420	112140	112140	112640	112640	111700	111700	112170	-440	30	4	44.87	16
	20150421	111700	112170	112060	112060	112010	112010	112030	-160	-140	4	44.81	20
	20150422	112010	112030	112980	113830	112980	113830	113400	1800	1370	8	90.72	20
	20150423	113830	113400	113960	114060	113960	114000	114000	600	600	6	68.40	16
	20150424	114000	114000	114180	114180	114180	114180	114180	180	180	2	22.84	16
	20150427	114180	114180	115440	118250	115400	116300	116580	2120	2400	10	116.59	16
	20150428	116300	116580	119590	119820	118800	119070	119330	2490	2750	36	429.61	28
	20150429	119070	119330				117660	117660	-1670	-1670	0	0.00	28
	20150430	117660	117660	118060	118060	118060	118060	118060	400	400	2	23.61	26
sn1510	20150327	120190	120190	120200	122580	117000	120190	119680	0	-510	14	167.56	6
	20150330	120190	119680	117730	117730	117730	117730	117730	-1950	-1950	2	23.55	6
	20150331	117730	117730				117800	117800	70	70	0	0.00	6
	20150401	117800	117800	118500	118500	118500	118500	118500	700	700	2	23.70	6
	20150402	118500	118500	118700	118700	118480	118480	118650	-20	150	10	118.65	8
	20150403	118480	118650				118650	118650	0	0	0	0.00	8
	20150407	118650	118650				118330	118330	-320	-320	0	0.00	8
	20150408	118330	118330				120000	120000	1670	1670	0	0.00	8
	20150409	120000	120000	117960	117960	117960	117960	117960	-2040	-2040	4	47.18	4
	20150410	117960	117960	117360	117360	117360	117360	117360	-600	-600	2	23.47	6
	20150413	117360	117360				117250	117250	-110	-110	0	0.00	6
	20150414	117250	117250	115240	115240	115240	115240	115240	-2010	-2010	2	23.05	8
	20150415	115240	115240				115080	115080	-160	-160	0	0.00	8
	20150416	115080	115080	115090	115090	115090	115090	115090	10	10	2	23.02	8
	20150417	115090	115090	112850	114130	111330	111550	112260	-3540	-2830	16	179.62	16
	20150420	111550	112260	112340	113460	112310	113460	112780	1200	520	10	112.78	20
	20150421	113460	112780	112220	113300	112220	113300	112760	520	-20	4	45.10	20
	20150422	113300	112760	113870	113870	113470	113470	113670	710	910	4	45.47	20
	20150423	113470	113670	113500	114000	113500	114000	113750	330	80	4	45.50	18
	20150424	114000	113750	114000	114990	114000	114990	114630	1240	880	6	68.78	14
	20150427	114990	114630	118530	119090	115000	119090	117360	4460	2730	14	164.31	16
	20150428	119090	117360	120660	120660	118010	119990	119490	2630	2130	22	262.88	10
	20150429	119990	119490	120160	120160	116010	116010	118080	-3480	-1410	4	47.23	10
	20150430	116010	118080				118080	118080	0	0	0	0.00	10
sn1511	20150327	120190	120190				120190	120190	0	0	0	0.00	0
	20150330	120190	120190				118230	118230	-1960	-1960	0	0.00	0
	20150331	118230	118230				118300	118300	70	70	0	0.00	0
	20150401	118300	118300				119000	119000	700	700	0	0.00	0
	20150402	119000	119000				119150	119150	150	150	0	0.00	0
	20150403	119150	119150				119560	119560	410	410	0	0.00	0
	20150407	119560	119560				119230	119230	-330	-330	0	0.00	0
	20150408	119230	119230				120910	120910	1680	1680	0	0.00	0
	20150409	120910	120910				118850	118850	-2060	-2060	0	0.00	0
	20150410	118850	118850				118240	118240	-610	-610	0	0.00	0
	20150413	118240	118240				118130	118130	-110	-110	0	0.00	0
	20150414	118130	118130				116100	116100	-2030	-2030	0	0.00	0
	20150415	116100	116100				115940	115940	-160	-160	0	0.00	0
	20150416	115940	115940				115950	115950	10	10	0	0.00	0
	20150417	115950	115950				113100	113100	-2850	-2850	0	0.00	0
	20150420	113100	113100				113620	113620	520	520	0	0.00	0
	20150421	113620	113620				113590	113590	-30	-30	0	0.00	0
	20150422	113590	113590				114500	114500	910	910	0	0.00	0
	20150423	114500	114500				114580	114580	80	80	0	0.00	0
	20150424	114580	114580				115460	115460	880	880	0	0.00	0
	20150427	115460	115460				118210	118210	2750	2750	0	0.00	0
	20150428	118210	118210				120350	120350	2140	2140	0	0.00	0
	20150429	120350	120350				120350	120350	0	0	0	0.00	0
	20150430	120350	120350				120750	120750	400	400	0	0.00	0
sn1512	20150327	120190	120190				120190	120190	0	0	0	0.00	0
	20150330	120190	120190				118230	118230	-1960	-1960	0	0.00	0
	20150331	118230	118230				118300	118300	70	70	0	0.00	0
	20150401	118300	118300				119000	119000	700	700	0	0.00	0
	20150402	119000	119000				119150	119150	150	150	0	0.00	0
	20150403	119150	119150	121280	121280	116680	116680	118980	-2470	-170	4	47.59	2
	20150407	116680	118980				118660	118660	-320	-320	0	0.00	2
	20150408	118660	118660				120340	120340	1680	1680	0	0.00	2
	20150409	120340	120340				118290	118290	-2050	-2050	0	0.00	2
	20150410	118290	118290				117680	117680	-610	-610	0	0.00	2
	20150413	117680	117680				117570	117570	-110	-110	0	0.00	2
	20150414	117570	117570				115550	115550	-2020	-2020	0	0.00	2
	20150415	115550	115550				115390	115390	-160	-160	0	0.00	2
	20150416	115390	115390				115400	115400	10	10	0	0.00	2
	20150417	115400	115400				112560	112560	-2840	-2840	0	0.00	2
	20150420	112560	112560				113080	113080	520	520	0	0.00	2
	20150421	113080	113080				113050	113050	-30	-30	0	0.00	2
	20150422	113050	113050				113960	113960	910	910	0	0.00	2
	20150423	113960	113960				114040	114040	80	80	0	0.00	2
	20150424	114040	114040				114920	114920	880	880	0	0.00	2
	20150427	114920	114920				117660	117660	2740	2740	0	0.00	2
	20150428	117660	117660				119790	119790	2130	2130	0	0.00	2
	20150429	119790	119790				118380	118380	-1410	-1410	0	0.00	2
	20150430	118380	118380				118780	118780	400	400	0	0.00	2
sn1601	20150327	120190	120190	120190	123080	119060	119100	120660	-1090	470	10	120.67	2
	20150330	119100	120660	119100	119100	115840	118280	117740	-2380	-2920	6	70.64	4
	20150331	118280	117740				117810	117810	70	70	0	0.00	4
	20150401	117810	117810				118510	118510	700	700	0	0.00	4
	20150402	118510	118510	118790	118790	118790	118790	118790	280	280	2	23.76	2
	20150403	118790	118790				118620	118620	-170	-170	0	0.00	2
	20150407	118620	118620				118300	118300	-320	-320	0	0.00	2
	20150408	118300	118300	118730	118730	118420	118420	118570	120	270	4	47.43	4
	20150409	118420	118570				116550	116550	-2020	-2020	0	0.00	4
	20150410	116550	116550				115950	115950	-600	-600	0	0.00	4
	20150413	115950	115950				115840	115840	-110	-110	0	0.00	4
	20150414	115840	115840				113850	113850	-1990	-1990	0	0.00	4
	20150415	113850	113850				113700	113700	-150	-150	0	0.00	4
	20150416	113700	113700				113700	113700	0	0	0	0.00	4
	20150417	113700	113700				110900	110900	-2800	-2800	0	0.00	4
	20150420	110900	110900	112800	112800	112800	112800	112800	1900	1900	2	22.56	4
	20150421	112800	112800				112770	112770	-30	-30	0	0.00	4
	20150422	112770	112770				113680	113680	910	910	0	0.00	4
	20150423	113680	113680				113760	113760	80	80	0	0.00	4
	20150424	113760	113760				114640	114640	880	880	0	0.00	4
	20150427	114640	114640				117370	117370	2730	2730	0	0.00	4
	20150428	117370	117370				119500	119500	2130	2130	0	0.00	4
	20150429	119500	119500				118090	118090	-1410	-1410	0	0.00	4
	20150430	118090	118090				118490	118490	400	400	0	0.00	4
sn1602	20150327	120190	120190				120660	120660	470	470	0	0.00	0
	20150330	120660	120660	117900	117900	117900	117900	117900	-2760	-2760	2	23.58	2
	20150331	117900	117900				117970	117970	70	70	0	0.00	2
	20150401	117970	117970	118470	118470	118470	118470	118470	500	500	2	23.69	2
	20150402	118470	118470				118740	118740	270	270	0	0.00	2
	20150403	118740	118740				118570	118570	-170	-170	0	0.00	2
	20150407	118570	118570				118250	118250	-320	-320	0	0.00	2
	20150408	118250	118250				118520	118520	270	270	0	0.00	2
	20150409	118520	118520				116500	116500	-2020	-2020	0	0.00	2
	20150410	116500	116500				115900	115900	-600	-600	0	0.00	2
	20150413	115900	115900				115790	115790	-110	-110	0	0.00	2
	20150414	115790	115790				113800	113800	-1990	-1990	0	0.00	2
	20150415	113800	113800				113650	113650	-150	-150	0	0.00	2
	20150416	113650	113650				113650	113650	0	0	0	0.00	2
	20150417	113650	113650				110860	110860	-2790	-2790	0	0.00	2
	20150420	110860	110860				112750	112750	1890	1890	0	0.00	2
	20150421	112750	112750				112730	112730	-20	-20	0	0.00	2
	20150422	112730	112730	113850	113850	113850	113850	113850	1120	1120	2	22.77	4
	20150423	113850	113850				113930	113930	80	80	0	0.00	4
	20150424	113930	113930				114810	114810	880	880	0	0.00	4
	20150427	114810	114810				117550	117550	2740	2740	0	0.00	4
	20150428	117550	117550				119680	119680	2130	2130	0	0.00	4
	20150429	119680	119680	116810	116810	116810	116810	116810	-2870	-2870	2	23.36	2
	20150430	116810	116810				117200	117200	390	390	0	0.00	2
sn1603	20150327	120190	120190				120660	120660	470	470	0	0.00	0
	20150330	120660	120660				117900	117900	-2760	-2760	0	0.00	0
	20150331	117900	117900				117970	117970	70	70	0	0.00	0
	20150401	117970	117970				118470	118470	500	500	0	0.00	0
	20150402	118470	118470				118740	118740	270	270	0	0.00	0
	20150403	118740	118740				118570	118570	-170	-170	0	0.00	0
	20150407	118570	118570				118250	118250	-320	-320	0	0.00	0
	20150408	118250	118250				118520	118520	270	270	0	0.00	0
	20150409	118520	118520				116500	116500	-2020	-2020	0	0.00	0
	20150410	116500	116500				115900	115900	-600	-600	0	0.00	0
	20150413	115900	115900				115790	115790	-110	-110	0	0.00	0
	20150414	115790	115790				113800	113800	-1990	-1990	0	0.00	0
	20150415	113800	113800				113650	113650	-150	-150	0	0.00	0
	20150416	113650	113650				113650	113650	0	0	0	0.00	0
	20150417	113650	113650				110860	110860	-2790	-2790	0	0.00	0
	20150420	110860	110860				112750	112750	1890	1890	0	0.00	0
	20150421	112750	112750				112730	112730	-20	-20	0	0.00	0
	20150422	112730	112730				113850	113850	1120	1120	0	0.00	0
	20150423	113850	113850				113930	113930	80	80	0	0.00	0
	20150424	113930	113930				114810	114810	880	880	0	0.00	0
	20150427	114810	114810				117550	117550	2740	2740	0	0.00	0
	20150428	117550	117550				119680	119680	2130	2130	0	0.00	0
	20150429	119680	119680				116810	116810	-2870	-2870	0	0.00	0
	20150430	116810	116810				117200	117200	390	390	0	0.00	0
sn1604	20150416	113650	113650				113650	113650	0	0	0	0.00	0
	20150417	113650	113650				110860	110860	-2790	-2790	0	0.00	0
	20150420	110860	110860				112750	112750	1890	1890	0	0.00	0
	20150421	112750	112750				112730	112730	-20	-20	0	0.00	0
	20150422	112730	112730				113850	113850	1120	1120	0	0.00	0
	20150423	113850	113850				113930	113930	80	80	0	0.00	0
	20150424	113930	113930				114810	114810	880	880	0	0.00	0
	20150427	114810	114810				117550	117550	2740	2740	0	0.00	0
	20150428	117550	117550				119680	119680	2130	2130	0	0.00	0
	20150429	119680	119680				116810	116810	-2870	-2870	0	0.00	0
	20150430	116810	116810				117200	117200	390	390	0	0.00	0
wr1501	20150105	2853	2853				2853	2853	0	0	0	0.00	0
	20150106	2853	2853				2853	2853	0	0	0	0.00	0
	20150107	2853	2853				2853	2853	0	0	0	0.00	0
	20150108	2853	2853				2853	2853	0	0	0	0.00	0
	20150109	2853	2853				2853	2853	0	0	0	0.00	0
	20150112	2853	2853				2853	2853	0	0	0	0.00	0
	20150113	2853	2853				2853	2853	0	0	0	0.00	0
	20150114	2853	2853				2853	2853	0	0	0	0.00	0
	20150115	2853	2853				2853	2853	0	0	0	0.00	0
wr1502	20150105	2840	2840	2748	2930	2748	2930	2839	90	-1	4	11.36	4
	20150106	2930	2839				2850	2850	11	11	0	0.00	4
	20150107	2850	2850				2850	2850	0	0	0	0.00	4
	20150108	2850	2850				2850	2850	0	0	0	0.00	4
	20150109	2850	2850	2757	2757	2757	2757	2757	-93	-93	2	5.51	4
	20150112	2757	2757				2757	2757	0	0	0	0.00	4
	20150113	2757	2757				2757	2757	0	0	0	0.00	4
	20150114	2757	2757				2757	2757	0	0	0	0.00	4
	20150115	2757	2757				2757	2757	0	0	0	0.00	4
	20150116	2757	2757				2757	2757	0	0	0	0.00	4
	20150119	2757	2757	2881	2881	2881	2881	2881	124	124	2	5.76	4
	20150120	2881	2881	2740	2740	2740	2740	2740	-141	-141	2	5.48	6
	20150121	2740	2740				2740	2740	0	0	0	0.00	6
	20150122	2740	2740				2740	2740	0	0	0	0.00	6
	20150123	2740	2740	2818	2818	2741	2741	2792	1	52	6	16.75	2
	20150126	2741	2792				2792	2792	0	0	0	0.00	2
	20150127	2792	2792				2792	2792	0	0	0	0.00	2
	20150128	2792	2792				2792	2792	0	0	0	0.00	2
	20150129	2792	2792				2792	2792	0	0	0	0.00	2
	20150130	2792	2792				2792	2792	0	0	0	0.00	2
	20150202	2792	2792	2792	2792	2792	2792	2792	0	0	2	5.58	0
	20150203	2792	2792				2792	2792	0	0	0	0.00	0
	20150204	2792	2792				2792	2792	0	0	0	0.00	0
	20150205	2792	2792				2792	2792	0	0	0	0.00	0
	20150206	2792	2792				2792	2792	0	0	0	0.00	0
	20150209	2792	2792				2792	2792	0	0	0	0.00	0
	20150210	2792	2792				2792	2792	0	0	0	0.00	0
wr1503	20150105	2659	2659				2658	2658	-1	-1	0	0.00	0
	20150106	2658	2658				2658	2658	0	0	0	0.00	0
	20150107	2658	2658				2658	2658	0	0	0	0.00	0
	20150108	2658	2658				2658	2658	0	0	0	0.00	0
	20150109	2658	2658				2571	2571	-87	-87	0	0.00	0
	20150112	2571	2571				2571	2571	0	0	0	0.00	0
	20150113	2571	2571				2571	2571	0	0	0	0.00	0
	20150114	2571	2571				2571	2571	0	0	0	0.00	0
	20150115	2571	2571				2571	2571	0	0	0	0.00	0
	20150116	2571	2571				2571	2571	0	0	0	0.00	0
	20150119	2571	2571				2686	2686	115	115	0	0.00	0
	20150120	2686	2686				2554	2554	-132	-132	0	0.00	0
	20150121	2554	2554				2554	2554	0	0	0	0.00	0
	20150122	2554	2554				2554	2554	0	0	0	0.00	0
	20150123	2554	2554				2602	2602	48	48	0	0.00	0
	20150126	2602	2602				2602	2602	0	0	0	0.00	0
	20150127	2602	2602				2602	2602	0	0	0	0.00	0
	20150128	2602	2602				2602	2602	0	0	0	0.00	0
	20150129	2602	2602				2602	2602	0	0	0	0.00	0
	20150130	2602	2602				2602	2602	0	0	0	0.00	0
	20150202	2602	2602				2602	2602	0	0	0	0.00	0
	20150203	2602	2602				2602	2602	0	0	0	0.00	0
	20150204	2602	2602				2602	2602	0	0	0	0.00	0
	20150205	2602	2602				2602	2602	0	0	0	0.00	0
	20150206	2602	2602				2602	2602	0	0	0	0.00	0
	20150209	2602	2602				2602	2602	0	0	0	0.00	0
	20150210	2602	2602				2602	2602	0	0	0	0.00	0
	20150211	2602	2602				2602	2602	0	0	0	0.00	0
	20150212	2602	2602				2602	2602	0	0	0	0.00	0
	20150213	2602	2602				2602	2602	0	0	0	0.00	0
	20150216	2602	2602				2602	2602	0	0	0	0.00	0
	20150217	2602	2602				2602	2602	0	0	0	0.00	0
	20150225	2602	2602				2602	2602	0	0	0	0.00	0
	20150226	2602	2602				2602	2602	0	0	0	0.00	0
	20150227	2602	2602				2602	2602	0	0	0	0.00	0
	20150302	2602	2602				2602	2602	0	0	0	0.00	0
	20150303	2602	2602				2602	2602	0	0	0	0.00	0
	20150304	2602	2602				2602	2602	0	0	0	0.00	0
	20150305	2602	2602				2602	2602	0	0	0	0.00	0
	20150306	2602	2602				2602	2602	0	0	0	0.00	0
	20150309	2602	2602				2602	2602	0	0	0	0.00	0
	20150310	2602	2602				2602	2602	0	0	0	0.00	0
	20150311	2602	2602				2602	2602	0	0	0	0.00	0
	20150312	2602	2602				2602	2602	0	0	0	0.00	0
	20150313	2602	2602				2602	2602	0	0	0	0.00	0
	20150316	2602	2602				2602	2602	0	0	0	0.00	0
wr1504	20150105	2801	2801	2941	2941	2680	2779	2838	-22	37	14	39.74	8
	20150106	2779	2838				2838	2838	0	0	0	0.00	8
	20150107	2838	2838				2838	2838	0	0	0	0.00	8
	20150108	2838	2838				2838	2838	0	0	0	0.00	8
	20150109	2838	2838				2838	2838	0	0	0	0.00	8
	20150112	2838	2838				2838	2838	0	0	0	0.00	8
	20150113	2838	2838				2838	2838	0	0	0	0.00	8
	20150114	2838	2838				2838	2838	0	0	0	0.00	8
	20150115	2838	2838				2838	2838	0	0	0	0.00	8
	20150116	2838	2838				2838	2838	0	0	0	0.00	8
	20150119	2838	2838				2965	2965	127	127	0	0.00	8
	20150120	2965	2965				2819	2819	-146	-146	0	0.00	8
	20150121	2819	2819				2819	2819	0	0	0	0.00	8
	20150122	2819	2819				2819	2819	0	0	0	0.00	8
	20150123	2819	2819				2872	2872	53	53	0	0.00	8
	20150126	2872	2872				2872	2872	0	0	0	0.00	8
	20150127	2872	2872				2872	2872	0	0	0	0.00	8
	20150128	2872	2872				2872	2872	0	0	0	0.00	8
	20150129	2872	2872				2872	2872	0	0	0	0.00	8
	20150130	2872	2872				2872	2872	0	0	0	0.00	8
	20150202	2872	2872				2872	2872	0	0	0	0.00	8
	20150203	2872	2872				2872	2872	0	0	0	0.00	8
	20150204	2872	2872				2872	2872	0	0	0	0.00	8
	20150205	2872	2872	2731	2731	2731	2731	2731	-141	-141	4	10.92	12
	20150206	2731	2731				2731	2731	0	0	0	0.00	12
	20150209	2731	2731				2731	2731	0	0	0	0.00	12
	20150210	2731	2731				2731	2731	0	0	0	0.00	12
	20150211	2731	2731				2731	2731	0	0	0	0.00	12
	20150212	2731	2731				2731	2731	0	0	0	0.00	12
	20150213	2731	2731	2863	2867	2722	2722	2812	-9	81	8	22.50	12
	20150216	2722	2812				2812	2812	0	0	0	0.00	12
	20150217	2812	2812				2812	2812	0	0	0	0.00	12
	20150225	2812	2812				2812	2812	0	0	0	0.00	12
	20150226	2812	2812				2812	2812	0	0	0	0.00	12
	20150227	2812	2812	2675	2675	2675	2675	2675	-137	-137	2	5.35	10
	20150302	2675	2675	2633	2633	2633	2633	2633	-42	-42	2	5.27	8
	20150303	2633	2633				2642	2642	9	9	0	0.00	8
	20150304	2642	2642				2666	2666	24	24	0	0.00	8
	20150305	2666	2666				2666	2666	0	0	0	0.00	8
	20150306	2666	2666				2666	2666	0	0	0	0.00	8
	20150309	2666	2666				2666	2666	0	0	0	0.00	8
	20150310	2666	2666				2666	2666	0	0	0	0.00	8
	20150311	2666	2666				2666	2666	0	0	0	0.00	8
	20150312	2666	2666				2666	2666	0	0	0	0.00	8
	20150313	2666	2666				2666	2666	0	0	0	0.00	8
	20150316	2666	2666				2666	2666	0	0	0	0.00	8
	20150317	2666	2666				2666	2666	0	0	0	0.00	8
	20150318	2666	2666				2666	2666	0	0	0	0.00	8
	20150319	2666	2666				2666	2666	0	0	0	0.00	8
	20150320	2666	2666				2666	2666	0	0	0	0.00	8
	20150323	2666	2666				2666	2666	0	0	0	0.00	8
	20150324	2666	2666				2699	2699	33	33	0	0.00	8
	20150325	2699	2699				2699	2699	0	0	0	0.00	8
	20150326	2699	2699	2809	2809	2593	2790	2714	91	15	8	21.72	8
	20150327	2790	2714	2580	2580	2580	2580	2580	-134	-134	2	5.16	6
	20150330	2580	2580	2600	2600	2455	2455	2503	-125	-77	12	30.04	18
	20150331	2455	2503	2524	2600	2508	2600	2554	97	51	18	45.98	0
	20150401	2600	2554				2554	2554	0	0	0	0.00	0
	20150402	2554	2554				2554	2554	0	0	0	0.00	0
	20150403	2554	2554				2554	2554	0	0	0	0.00	0
	20150407	2554	2554				2554	2554	0	0	0	0.00	0
	20150408	2554	2554				2554	2554	0	0	0	0.00	0
	20150409	2554	2554				2554	2554	0	0	0	0.00	0
	20150410	2554	2554				2554	2554	0	0	0	0.00	0
	20150413	2554	2554				2554	2554	0	0	0	0.00	0
	20150414	2554	2554				2554	2554	0	0	0	0.00	0
	20150415	2554	2554				2554	2554	0	0	0	0.00	0
wr1505	20150105	2759	2759				2795	2795	36	36	0	0.00	0
	20150106	2795	2795				2795	2795	0	0	0	0.00	0
	20150107	2795	2795				2795	2795	0	0	0	0.00	0
	20150108	2795	2795				2795	2795	0	0	0	0.00	0
	20150109	2795	2795				2795	2795	0	0	0	0.00	0
	20150112	2795	2795	2857	2857	2694	2694	2775	-101	-20	4	11.10	0
	20150113	2694	2775				2775	2775	0	0	0	0.00	0
	20150114	2775	2775				2775	2775	0	0	0	0.00	0
	20150115	2775	2775				2775	2775	0	0	0	0.00	0
	20150116	2775	2775	2819	2819	2818	2818	2818	43	43	4	11.27	4
	20150119	2818	2818				2818	2818	0	0	0	0.00	4
	20150120	2818	2818				2680	2680	-138	-138	0	0.00	4
	20150121	2680	2680				2680	2680	0	0	0	0.00	4
	20150122	2680	2680				2680	2680	0	0	0	0.00	4
	20150123	2680	2680				2731	2731	51	51	0	0.00	4
	20150126	2731	2731				2731	2731	0	0	0	0.00	4
	20150127	2731	2731	2611	2611	2611	2611	2611	-120	-120	2	5.22	2
	20150128	2611	2611				2611	2611	0	0	0	0.00	2
	20150129	2611	2611				2611	2611	0	0	0	0.00	2
	20150130	2611	2611				2611	2611	0	0	0	0.00	2
	20150202	2611	2611				2611	2611	0	0	0	0.00	2
	20150203	2611	2611				2611	2611	0	0	0	0.00	2
	20150204	2611	2611				2611	2611	0	0	0	0.00	2
	20150205	2611	2611				2482	2482	-129	-129	0	0.00	2
	20150206	2482	2482				2482	2482	0	0	0	0.00	2
	20150209	2482	2482				2482	2482	0	0	0	0.00	2
	20150210	2482	2482				2606	2606	124	124	0	0.00	2
	20150211	2606	2606				2606	2606	0	0	0	0.00	2
	20150212	2606	2606	2680	2680	2679	2679	2679	73	73	4	10.72	2
	20150213	2679	2679	2805	2805	2805	2805	2805	126	126	2	5.61	2
	20150216	2805	2805				2805	2805	0	0	0	0.00	2
	20150217	2805	2805				2805	2805	0	0	0	0.00	2
	20150225	2805	2805				2805	2805	0	0	0	0.00	2
	20150226	2805	2805				2805	2805	0	0	0	0.00	2
	20150227	2805	2805				2805	2805	0	0	0	0.00	2
	20150302	2805	2805				2760	2760	-45	-45	0	0.00	2
	20150303	2760	2760				2760	2760	0	0	0	0.00	2
	20150304	2760	2760				2760	2760	0	0	0	0.00	2
	20150305	2760	2760				2760	2760	0	0	0	0.00	2
	20150306	2760	2760				2760	2760	0	0	0	0.00	2
	20150309	2760	2760				2760	2760	0	0	0	0.00	2
	20150310	2760	2760				2760	2760	0	0	0	0.00	2
	20150311	2760	2760				2760	2760	0	0	0	0.00	2
	20150312	2760	2760				2760	2760	0	0	0	0.00	2
	20150313	2760	2760				2760	2760	0	0	0	0.00	2
	20150316	2760	2760				2760	2760	0	0	0	0.00	2
	20150317	2760	2760				2760	2760	0	0	0	0.00	2
	20150318	2760	2760				2760	2760	0	0	0	0.00	2
	20150319	2760	2760				2760	2760	0	0	0	0.00	2
	20150320	2760	2760				2760	2760	0	0	0	0.00	2
	20150323	2760	2760				2760	2760	0	0	0	0.00	2
	20150324	2760	2760				2760	2760	0	0	0	0.00	2
	20150325	2760	2760				2760	2760	0	0	0	0.00	2
	20150326	2760	2760				2760	2760	0	0	0	0.00	2
	20150327	2760	2760				2623	2623	-137	-137	0	0.00	2
	20150330	2623	2623				2545	2545	-78	-78	0	0.00	2
	20150331	2545	2545				2597	2597	52	52	0	0.00	2
	20150401	2597	2597				2597	2597	0	0	0	0.00	2
	20150402	2597	2597				2597	2597	0	0	0	0.00	2
	20150403	2597	2597				2597	2597	0	0	0	0.00	2
	20150407	2597	2597				2597	2597	0	0	0	0.00	2
	20150408	2597	2597				2597	2597	0	0	0	0.00	2
	20150409	2597	2597	2476	2476	2476	2476	2476	-121	-121	2	4.95	4
	20150410	2476	2476				2476	2476	0	0	0	0.00	4
	20150413	2476	2476				2476	2476	0	0	0	0.00	4
	20150414	2476	2476				2476	2476	0	0	0	0.00	4
	20150415	2476	2476	2473	2473	2473	2473	2473	-3	-3	2	4.95	4
	20150416	2473	2473				2473	2473	0	0	0	0.00	4
	20150417	2473	2473				2473	2473	0	0	0	0.00	4
	20150420	2473	2473	2596	2596	2596	2596	2596	123	123	2	5.19	2
	20150421	2596	2596	2479	2479	2479	2479	2479	-117	-117	2	4.96	0
	20150422	2479	2479				2479	2479	0	0	0	0.00	0
	20150423	2479	2479				2479	2479	0	0	0	0.00	0
	20150424	2479	2479				2479	2479	0	0	0	0.00	0
	20150427	2479	2479				2479	2479	0	0	0	0.00	0
	20150428	2479	2479				2479	2479	0	0	0	0.00	0
	20150429	2479	2479				2479	2479	0	0	0	0.00	0
	20150430	2479	2479				2479	2479	0	0	0	0.00	0
wr1506	20150105	2797	2797				2834	2834	37	37	0	0.00	0
	20150106	2834	2834				2834	2834	0	0	0	0.00	0
	20150107	2834	2834				2834	2834	0	0	0	0.00	0
	20150108	2834	2834				2834	2834	0	0	0	0.00	0
	20150109	2834	2834				2741	2741	-93	-93	0	0.00	0
	20150112	2741	2741				2721	2721	-20	-20	0	0.00	0
	20150113	2721	2721				2721	2721	0	0	0	0.00	0
	20150114	2721	2721				2721	2721	0	0	0	0.00	0
	20150115	2721	2721				2721	2721	0	0	0	0.00	0
	20150116	2721	2721				2763	2763	42	42	0	0.00	0
	20150119	2763	2763				2887	2887	124	124	0	0.00	0
	20150120	2887	2887				2745	2745	-142	-142	0	0.00	0
	20150121	2745	2745				2745	2745	0	0	0	0.00	0
	20150122	2745	2745				2745	2745	0	0	0	0.00	0
	20150123	2745	2745				2797	2797	52	52	0	0.00	0
	20150126	2797	2797				2797	2797	0	0	0	0.00	0
	20150127	2797	2797				2674	2674	-123	-123	0	0.00	0
	20150128	2674	2674				2674	2674	0	0	0	0.00	0
	20150129	2674	2674				2674	2674	0	0	0	0.00	0
	20150130	2674	2674				2674	2674	0	0	0	0.00	0
	20150202	2674	2674				2674	2674	0	0	0	0.00	0
	20150203	2674	2674				2674	2674	0	0	0	0.00	0
	20150204	2674	2674				2674	2674	0	0	0	0.00	0
	20150205	2674	2674				2542	2542	-132	-132	0	0.00	0
	20150206	2542	2542				2542	2542	0	0	0	0.00	0
	20150209	2542	2542				2542	2542	0	0	0	0.00	0
	20150210	2542	2542				2542	2542	0	0	0	0.00	0
	20150211	2542	2542				2542	2542	0	0	0	0.00	0
	20150212	2542	2542				2613	2613	71	71	0	0.00	0
	20150213	2613	2613				2735	2735	122	122	0	0.00	0
	20150216	2735	2735				2735	2735	0	0	0	0.00	0
	20150217	2735	2735				2735	2735	0	0	0	0.00	0
	20150225	2735	2735				2735	2735	0	0	0	0.00	0
	20150226	2735	2735				2735	2735	0	0	0	0.00	0
	20150227	2735	2735				2601	2601	-134	-134	0	0.00	0
	20150302	2601	2601				2560	2560	-41	-41	0	0.00	0
	20150303	2560	2560				2560	2560	0	0	0	0.00	0
	20150304	2560	2560				2560	2560	0	0	0	0.00	0
	20150305	2560	2560				2560	2560	0	0	0	0.00	0
	20150306	2560	2560				2560	2560	0	0	0	0.00	0
	20150309	2560	2560				2560	2560	0	0	0	0.00	0
	20150310	2560	2560				2560	2560	0	0	0	0.00	0
	20150311	2560	2560				2560	2560	0	0	0	0.00	0
	20150312	2560	2560				2560	2560	0	0	0	0.00	0
	20150313	2560	2560				2560	2560	0	0	0	0.00	0
	20150316	2560	2560				2560	2560	0	0	0	0.00	0
	20150317	2560	2560				2560	2560	0	0	0	0.00	0
	20150318	2560	2560				2560	2560	0	0	0	0.00	0
	20150319	2560	2560				2560	2560	0	0	0	0.00	0
	20150320	2560	2560				2560	2560	0	0	0	0.00	0
	20150323	2560	2560				2560	2560	0	0	0	0.00	0
	20150324	2560	2560				2560	2560	0	0	0	0.00	0
	20150325	2560	2560				2560	2560	0	0	0	0.00	0
	20150326	2560	2560				2574	2574	14	14	0	0.00	0
	20150327	2574	2574				2446	2446	-128	-128	0	0.00	0
	20150330	2446	2446				2373	2373	-73	-73	0	0.00	0
	20150331	2373	2373				2421	2421	48	48	0	0.00	0
	20150401	2421	2421				2421	2421	0	0	0	0.00	0
	20150402	2421	2421				2421	2421	0	0	0	0.00	0
	20150403	2421	2421				2421	2421	0	0	0	0.00	0
	20150407	2421	2421				2421	2421	0	0	0	0.00	0
	20150408	2421	2421				2421	2421	0	0	0	0.00	0
	20150409	2421	2421				2308	2308	-113	-113	0	0.00	0
	20150410	2308	2308				2308	2308	0	0	0	0.00	0
	20150413	2308	2308				2308	2308	0	0	0	0.00	0
	20150414	2308	2308				2308	2308	0	0	0	0.00	0
	20150415	2308	2308				2305	2305	-3	-3	0	0.00	0
	20150416	2305	2305				2305	2305	0	0	0	0.00	0
	20150417	2305	2305				2305	2305	0	0	0	0.00	0
	20150420	2305	2305				2419	2419	114	114	0	0.00	0
	20150421	2419	2419				2309	2309	-110	-110	0	0.00	0
	20150422	2309	2309				2309	2309	0	0	0	0.00	0
	20150423	2309	2309				2309	2309	0	0	0	0.00	0
	20150424	2309	2309				2309	2309	0	0	0	0.00	0
	20150427	2309	2309				2309	2309	0	0	0	0.00	0
	20150428	2309	2309				2309	2309	0	0	0	0.00	0
	20150429	2309	2309				2309	2309	0	0	0	0.00	0
	20150430	2309	2309				2309	2309	0	0	0	0.00	0
wr1507	20150105	2960	2960				2999	2999	39	39	0	0.00	0
	20150106	2999	2999				2999	2999	0	0	0	0.00	0
	20150107	2999	2999				2999	2999	0	0	0	0.00	0
	20150108	2999	2999				2999	2999	0	0	0	0.00	0
	20150109	2999	2999				2901	2901	-98	-98	0	0.00	0
	20150112	2901	2901				2880	2880	-21	-21	0	0.00	0
	20150113	2880	2880				2880	2880	0	0	0	0.00	0
	20150114	2880	2880				2880	2880	0	0	0	0.00	0
	20150115	2880	2880				2880	2880	0	0	0	0.00	0
	20150116	2880	2880				2925	2925	45	45	0	0.00	0
	20150119	2925	2925				3056	3056	131	131	0	0.00	0
	20150120	3056	3056				2906	2906	-150	-150	0	0.00	0
	20150121	2906	2906				2906	2906	0	0	0	0.00	0
	20150122	2906	2906				2906	2906	0	0	0	0.00	0
	20150123	2906	2906				2961	2961	55	55	0	0.00	0
	20150126	2961	2961				2961	2961	0	0	0	0.00	0
	20150127	2961	2961				2830	2830	-131	-131	0	0.00	0
	20150128	2830	2830				2830	2830	0	0	0	0.00	0
	20150129	2830	2830				2830	2830	0	0	0	0.00	0
	20150130	2830	2830				2830	2830	0	0	0	0.00	0
	20150202	2830	2830				2830	2830	0	0	0	0.00	0
	20150203	2830	2830				2830	2830	0	0	0	0.00	0
	20150204	2830	2830				2830	2830	0	0	0	0.00	0
	20150205	2830	2830				2691	2691	-139	-139	0	0.00	0
	20150206	2691	2691				2691	2691	0	0	0	0.00	0
	20150209	2691	2691				2691	2691	0	0	0	0.00	0
	20150210	2691	2691				2691	2691	0	0	0	0.00	0
	20150211	2691	2691				2691	2691	0	0	0	0.00	0
	20150212	2691	2691				2766	2766	75	75	0	0.00	0
	20150213	2766	2766				2896	2896	130	130	0	0.00	0
	20150216	2896	2896				2896	2896	0	0	0	0.00	0
	20150217	2896	2896				2896	2896	0	0	0	0.00	0
	20150225	2896	2896				2896	2896	0	0	0	0.00	0
	20150226	2896	2896				2896	2896	0	0	0	0.00	0
	20150227	2896	2896				2754	2754	-142	-142	0	0.00	0
	20150302	2754	2754				2710	2710	-44	-44	0	0.00	0
	20150303	2710	2710				2710	2710	0	0	0	0.00	0
	20150304	2710	2710				2710	2710	0	0	0	0.00	0
	20150305	2710	2710				2710	2710	0	0	0	0.00	0
	20150306	2710	2710				2710	2710	0	0	0	0.00	0
	20150309	2710	2710				2710	2710	0	0	0	0.00	0
	20150310	2710	2710				2710	2710	0	0	0	0.00	0
	20150311	2710	2710				2710	2710	0	0	0	0.00	0
	20150312	2710	2710				2710	2710	0	0	0	0.00	0
	20150313	2710	2710				2710	2710	0	0	0	0.00	0
	20150316	2710	2710				2710	2710	0	0	0	0.00	0
	20150317	2710	2710				2710	2710	0	0	0	0.00	0
	20150318	2710	2710				2710	2710	0	0	0	0.00	0
	20150319	2710	2710				2710	2710	0	0	0	0.00	0
	20150320	2710	2710				2710	2710	0	0	0	0.00	0
	20150323	2710	2710				2710	2710	0	0	0	0.00	0
	20150324	2710	2710				2710	2710	0	0	0	0.00	0
	20150325	2710	2710				2710	2710	0	0	0	0.00	0
	20150326	2710	2710				2725	2725	15	15	0	0.00	0
	20150327	2725	2725				2590	2590	-135	-135	0	0.00	0
	20150330	2590	2590				2513	2513	-77	-77	0	0.00	0
	20150331	2513	2513				2564	2564	51	51	0	0.00	0
	20150401	2564	2564				2564	2564	0	0	0	0.00	0
	20150402	2564	2564				2564	2564	0	0	0	0.00	0
	20150403	2564	2564				2564	2564	0	0	0	0.00	0
	20150407	2564	2564				2564	2564	0	0	0	0.00	0
	20150408	2564	2564				2564	2564	0	0	0	0.00	0
	20150409	2564	2564				2444	2444	-120	-120	0	0.00	0
	20150410	2444	2444				2444	2444	0	0	0	0.00	0
	20150413	2444	2444				2444	2444	0	0	0	0.00	0
	20150414	2444	2444				2444	2444	0	0	0	0.00	0
	20150415	2444	2444				2441	2441	-3	-3	0	0.00	0
	20150416	2441	2441				2441	2441	0	0	0	0.00	0
	20150417	2441	2441	2196	2196	2196	2196	2196	-245	-245	2	4.39	2
	20150420	2196	2196	2299	2299	2299	2299	2299	103	103	2	4.60	2
	20150421	2299	2299				2195	2195	-104	-104	0	0.00	2
	20150422	2195	2195				2195	2195	0	0	0	0.00	2
	20150423	2195	2195				2195	2195	0	0	0	0.00	2
	20150424	2195	2195				2195	2195	0	0	0	0.00	2
	20150427	2195	2195				2304	2304	109	109	0	0.00	2
	20150428	2304	2304				2419	2419	115	115	0	0.00	2
	20150429	2419	2419	2539	2539	2539	2539	2539	120	120	4	10.16	0
	20150430	2539	2539				2539	2539	0	0	0	0.00	0
wr1508	20150105	3065	3065				3105	3105	40	40	0	0.00	2
	20150106	3105	3105				3105	3105	0	0	0	0.00	2
	20150107	3105	3105				3105	3105	0	0	0	0.00	2
	20150108	3105	3105				3105	3105	0	0	0	0.00	2
	20150109	3105	3105				3003	3003	-102	-102	0	0.00	2
	20150112	3003	3003				2982	2982	-21	-21	0	0.00	2
	20150113	2982	2982				2982	2982	0	0	0	0.00	2
	20150114	2982	2982				2982	2982	0	0	0	0.00	2
	20150115	2982	2982				2982	2982	0	0	0	0.00	2
	20150116	2982	2982				3028	3028	46	46	0	0.00	2
	20150119	3028	3028				3164	3164	136	136	0	0.00	2
	20150120	3164	3164				3009	3009	-155	-155	0	0.00	2
	20150121	3009	3009				3009	3009	0	0	0	0.00	2
	20150122	3009	3009				3009	3009	0	0	0	0.00	2
	20150123	3009	3009				3066	3066	57	57	0	0.00	2
	20150126	3066	3066				3066	3066	0	0	0	0.00	2
	20150127	3066	3066				2931	2931	-135	-135	0	0.00	2
	20150128	2931	2931				2931	2931	0	0	0	0.00	2
	20150129	2931	2931				2931	2931	0	0	0	0.00	2
	20150130	2931	2931				2931	2931	0	0	0	0.00	2
	20150202	2931	2931				2931	2931	0	0	0	0.00	2
	20150203	2931	2931				2931	2931	0	0	0	0.00	2
	20150204	2931	2931				2931	2931	0	0	0	0.00	2
	20150205	2931	2931				2787	2787	-144	-144	0	0.00	2
	20150206	2787	2787				2787	2787	0	0	0	0.00	2
	20150209	2787	2787				2787	2787	0	0	0	0.00	2
	20150210	2787	2787				2787	2787	0	0	0	0.00	2
	20150211	2787	2787				2787	2787	0	0	0	0.00	2
	20150212	2787	2787				2865	2865	78	78	0	0.00	2
	20150213	2865	2865				2999	2999	134	134	0	0.00	2
	20150216	2999	2999				2999	2999	0	0	0	0.00	2
	20150217	2999	2999				2999	2999	0	0	0	0.00	2
	20150225	2999	2999				2999	2999	0	0	0	0.00	2
	20150226	2999	2999				2999	2999	0	0	0	0.00	2
	20150227	2999	2999				2852	2852	-147	-147	0	0.00	2
	20150302	2852	2852				2807	2807	-45	-45	0	0.00	2
	20150303	2807	2807				2807	2807	0	0	0	0.00	2
	20150304	2807	2807				2807	2807	0	0	0	0.00	2
	20150305	2807	2807				2807	2807	0	0	0	0.00	2
	20150306	2807	2807				2807	2807	0	0	0	0.00	2
	20150309	2807	2807				2807	2807	0	0	0	0.00	2
	20150310	2807	2807				2807	2807	0	0	0	0.00	2
	20150311	2807	2807				2807	2807	0	0	0	0.00	2
	20150312	2807	2807				2807	2807	0	0	0	0.00	2
	20150313	2807	2807				2807	2807	0	0	0	0.00	2
	20150316	2807	2807				2807	2807	0	0	0	0.00	2
	20150317	2807	2807				2807	2807	0	0	0	0.00	2
	20150318	2807	2807				2807	2807	0	0	0	0.00	2
	20150319	2807	2807				2807	2807	0	0	0	0.00	2
	20150320	2807	2807				2807	2807	0	0	0	0.00	2
	20150323	2807	2807				2807	2807	0	0	0	0.00	2
	20150324	2807	2807				2807	2807	0	0	0	0.00	2
	20150325	2807	2807				2807	2807	0	0	0	0.00	2
	20150326	2807	2807				2823	2823	16	16	0	0.00	2
	20150327	2823	2823				2683	2683	-140	-140	0	0.00	2
	20150330	2683	2683				2603	2603	-80	-80	0	0.00	2
	20150331	2603	2603				2656	2656	53	53	0	0.00	2
	20150401	2656	2656				2656	2656	0	0	0	0.00	2
	20150402	2656	2656				2656	2656	0	0	0	0.00	2
	20150403	2656	2656				2656	2656	0	0	0	0.00	2
	20150407	2656	2656				2656	2656	0	0	0	0.00	2
	20150408	2656	2656				2656	2656	0	0	0	0.00	2
	20150409	2656	2656				2532	2532	-124	-124	0	0.00	2
	20150410	2532	2532				2532	2532	0	0	0	0.00	2
	20150413	2532	2532				2532	2532	0	0	0	0.00	2
	20150414	2532	2532				2532	2532	0	0	0	0.00	2
	20150415	2532	2532				2528	2528	-4	-4	0	0.00	2
	20150416	2528	2528				2528	2528	0	0	0	0.00	2
	20150417	2528	2528				2401	2401	-127	-127	0	0.00	2
	20150420	2401	2401				2513	2513	112	112	0	0.00	2
	20150421	2513	2513				2399	2399	-114	-114	0	0.00	2
	20150422	2399	2399				2399	2399	0	0	0	0.00	2
	20150423	2399	2399				2399	2399	0	0	0	0.00	2
	20150424	2399	2399				2399	2399	0	0	0	0.00	2
	20150427	2399	2399				2399	2399	0	0	0	0.00	2
	20150428	2399	2399				2399	2399	0	0	0	0.00	2
	20150429	2399	2399				2518	2518	119	119	0	0.00	2
	20150430	2518	2518				2518	2518	0	0	0	0.00	2
wr1509	20150105	3037	3037				3077	3077	40	40	0	0.00	0
	20150106	3077	3077				3077	3077	0	0	0	0.00	0
	20150107	3077	3077				3077	3077	0	0	0	0.00	0
	20150108	3077	3077				3077	3077	0	0	0	0.00	0
	20150109	3077	3077				2976	2976	-101	-101	0	0.00	0
	20150112	2976	2976				2955	2955	-21	-21	0	0.00	0
	20150113	2955	2955				2955	2955	0	0	0	0.00	0
	20150114	2955	2955				2955	2955	0	0	0	0.00	0
	20150115	2955	2955				2955	2955	0	0	0	0.00	0
	20150116	2955	2955				3001	3001	46	46	0	0.00	0
	20150119	3001	3001				3135	3135	134	134	0	0.00	0
	20150120	3135	3135				2981	2981	-154	-154	0	0.00	0
	20150121	2981	2981				2981	2981	0	0	0	0.00	0
	20150122	2981	2981				2981	2981	0	0	0	0.00	0
	20150123	2981	2981				3037	3037	56	56	0	0.00	0
	20150126	3037	3037				3037	3037	0	0	0	0.00	0
	20150127	3037	3037				2903	2903	-134	-134	0	0.00	0
	20150128	2903	2903				2903	2903	0	0	0	0.00	0
	20150129	2903	2903				2903	2903	0	0	0	0.00	0
	20150130	2903	2903				2903	2903	0	0	0	0.00	0
	20150202	2903	2903				2903	2903	0	0	0	0.00	0
	20150203	2903	2903				2903	2903	0	0	0	0.00	0
	20150204	2903	2903				2903	2903	0	0	0	0.00	0
	20150205	2903	2903				2760	2760	-143	-143	0	0.00	0
	20150206	2760	2760				2760	2760	0	0	0	0.00	0
	20150209	2760	2760				2760	2760	0	0	0	0.00	0
	20150210	2760	2760				2760	2760	0	0	0	0.00	0
	20150211	2760	2760				2760	2760	0	0	0	0.00	0
	20150212	2760	2760				2837	2837	77	77	0	0.00	0
	20150213	2837	2837				2970	2970	133	133	0	0.00	0
	20150216	2970	2970				2970	2970	0	0	0	0.00	0
	20150217	2970	2970				2970	2970	0	0	0	0.00	0
	20150225	2970	2970				2970	2970	0	0	0	0.00	0
	20150226	2970	2970				2970	2970	0	0	0	0.00	0
	20150227	2970	2970				2825	2825	-145	-145	0	0.00	0
	20150302	2825	2825				2780	2780	-45	-45	0	0.00	0
	20150303	2780	2780	2510	2913	2510	2608	2643	-172	-137	12	31.72	0
	20150304	2608	2643				2643	2643	0	0	0	0.00	0
	20150305	2643	2643				2643	2643	0	0	0	0.00	0
	20150306	2643	2643	2511	2775	2511	2775	2643	132	0	4	10.57	0
	20150309	2775	2643	2536	2775	2536	2760	2665	117	22	46	122.62	0
	20150310	2760	2665				2665	2665	0	0	0	0.00	0
	20150311	2665	2665				2665	2665	0	0	0	0.00	0
	20150312	2665	2665				2665	2665	0	0	0	0.00	0
	20150313	2665	2665				2665	2665	0	0	0	0.00	0
	20150316	2665	2665				2665	2665	0	0	0	0.00	0
	20150317	2665	2665				2665	2665	0	0	0	0.00	0
	20150318	2665	2665				2665	2665	0	0	0	0.00	0
	20150319	2665	2665				2665	2665	0	0	0	0.00	0
	20150320	2665	2665				2665	2665	0	0	0	0.00	0
	20150323	2665	2665				2665	2665	0	0	0	0.00	0
	20150324	2665	2665				2665	2665	0	0	0	0.00	0
	20150325	2665	2665				2665	2665	0	0	0	0.00	0
	20150326	2665	2665				2680	2680	15	15	0	0.00	0
	20150327	2680	2680				2680	2680	0	0	0	0.00	0
	20150330	2680	2680				2600	2600	-80	-80	0	0.00	0
	20150331	2600	2600				2653	2653	53	53	0	0.00	0
	20150401	2653	2653				2653	2653	0	0	0	0.00	0
	20150402	2653	2653				2653	2653	0	0	0	0.00	0
	20150403	2653	2653				2653	2653	0	0	0	0.00	0
	20150407	2653	2653				2653	2653	0	0	0	0.00	0
	20150408	2653	2653				2653	2653	0	0	0	0.00	0
	20150409	2653	2653				2529	2529	-124	-124	0	0.00	0
	20150410	2529	2529				2529	2529	0	0	0	0.00	0
	20150413	2529	2529				2529	2529	0	0	0	0.00	0
	20150414	2529	2529				2529	2529	0	0	0	0.00	0
	20150415	2529	2529				2525	2525	-4	-4	0	0.00	0
	20150416	2525	2525				2525	2525	0	0	0	0.00	0
	20150417	2525	2525				2398	2398	-127	-127	0	0.00	0
	20150420	2398	2398				2510	2510	112	112	0	0.00	0
	20150421	2510	2510				2396	2396	-114	-114	0	0.00	0
	20150422	2396	2396				2396	2396	0	0	0	0.00	0
	20150423	2396	2396				2396	2396	0	0	0	0.00	0
	20150424	2396	2396				2396	2396	0	0	0	0.00	0
	20150427	2396	2396				2396	2396	0	0	0	0.00	0
	20150428	2396	2396				2396	2396	0	0	0	0.00	0
	20150429	2396	2396				2514	2514	118	118	0	0.00	0
	20150430	2514	2514				2514	2514	0	0	0	0.00	0
wr1510	20150105	3167	3167				3209	3209	42	42	0	0.00	0
	20150106	3209	3209				3209	3209	0	0	0	0.00	0
	20150107	3209	3209				3209	3209	0	0	0	0.00	0
	20150108	3209	3209				3209	3209	0	0	0	0.00	0
	20150109	3209	3209				3104	3104	-105	-105	0	0.00	0
	20150112	3104	3104				3082	3082	-22	-22	0	0.00	0
	20150113	3082	3082				3082	3082	0	0	0	0.00	0
	20150114	3082	3082				3082	3082	0	0	0	0.00	0
	20150115	3082	3082				3082	3082	0	0	0	0.00	0
	20150116	3082	3082				3130	3130	48	48	0	0.00	0
	20150119	3130	3130				3270	3270	140	140	0	0.00	0
	20150120	3270	3270				3109	3109	-161	-161	0	0.00	0
	20150121	3109	3109				3109	3109	0	0	0	0.00	0
	20150122	3109	3109				3109	3109	0	0	0	0.00	0
	20150123	3109	3109				3168	3168	59	59	0	0.00	0
	20150126	3168	3168				3168	3168	0	0	0	0.00	0
	20150127	3168	3168				3028	3028	-140	-140	0	0.00	0
	20150128	3028	3028				3028	3028	0	0	0	0.00	0
	20150129	3028	3028				3028	3028	0	0	0	0.00	0
	20150130	3028	3028				3028	3028	0	0	0	0.00	0
	20150202	3028	3028				3028	3028	0	0	0	0.00	0
	20150203	3028	3028				3028	3028	0	0	0	0.00	0
	20150204	3028	3028				3028	3028	0	0	0	0.00	0
	20150205	3028	3028				2879	2879	-149	-149	0	0.00	0
	20150206	2879	2879				2879	2879	0	0	0	0.00	0
	20150209	2879	2879				2879	2879	0	0	0	0.00	0
	20150210	2879	2879				2879	2879	0	0	0	0.00	0
	20150211	2879	2879				2879	2879	0	0	0	0.00	0
	20150212	2879	2879				2960	2960	81	81	0	0.00	0
	20150213	2960	2960				3099	3099	139	139	0	0.00	0
	20150216	3099	3099				3099	3099	0	0	0	0.00	0
	20150217	3099	3099				3099	3099	0	0	0	0.00	0
	20150225	3099	3099				3099	3099	0	0	0	0.00	0
	20150226	3099	3099				3099	3099	0	0	0	0.00	0
	20150227	3099	3099				2948	2948	-151	-151	0	0.00	0
	20150302	2948	2948	2956	2956	2956	2956	2956	8	8	6	17.74	6
	20150303	2956	2956				2810	2810	-146	-146	0	0.00	6
	20150304	2810	2810				2810	2810	0	0	0	0.00	6
	20150305	2810	2810				2810	2810	0	0	0	0.00	6
	20150306	2810	2810				2810	2810	0	0	0	0.00	6
	20150309	2810	2810				2834	2834	24	24	0	0.00	6
	20150310	2834	2834				2834	2834	0	0	0	0.00	6
	20150311	2834	2834				2834	2834	0	0	0	0.00	6
	20150312	2834	2834				2834	2834	0	0	0	0.00	6
	20150313	2834	2834				2834	2834	0	0	0	0.00	6
	20150316	2834	2834				2834	2834	0	0	0	0.00	6
	20150317	2834	2834				2834	2834	0	0	0	0.00	6
	20150318	2834	2834				2834	2834	0	0	0	0.00	6
	20150319	2834	2834				2834	2834	0	0	0	0.00	6
	20150320	2834	2834				2834	2834	0	0	0	0.00	6
	20150323	2834	2834				2834	2834	0	0	0	0.00	6
	20150324	2834	2834				2834	2834	0	0	0	0.00	6
	20150325	2834	2834				2834	2834	0	0	0	0.00	6
	20150326	2834	2834				2850	2850	16	16	0	0.00	6
	20150327	2850	2850				2709	2709	-141	-141	0	0.00	6
	20150330	2709	2709				2628	2628	-81	-81	0	0.00	6
	20150331	2628	2628				2681	2681	53	53	0	0.00	6
	20150401	2681	2681				2681	2681	0	0	0	0.00	6
	20150402	2681	2681	2745	2745	2745	2745	2745	64	64	2	5.49	8
	20150403	2745	2745	2745	2745	2745	2745	2745	0	0	2	5.49	10
	20150407	2745	2745				2745	2745	0	0	0	0.00	10
	20150408	2745	2745				2745	2745	0	0	0	0.00	10
	20150409	2745	2745				2617	2617	-128	-128	0	0.00	10
	20150410	2617	2617				2617	2617	0	0	0	0.00	10
	20150413	2617	2617				2617	2617	0	0	0	0.00	10
	20150414	2617	2617				2617	2617	0	0	0	0.00	10
	20150415	2617	2617				2613	2613	-4	-4	0	0.00	10
	20150416	2613	2613				2613	2613	0	0	0	0.00	10
	20150417	2613	2613				2482	2482	-131	-131	0	0.00	10
	20150420	2482	2482	2482	2606	2477	2606	2521	124	39	6	15.13	8
	20150421	2606	2521	2499	2499	2487	2487	2493	-34	-28	4	9.97	8
	20150422	2487	2493				2493	2493	0	0	0	0.00	8
	20150423	2493	2493				2493	2493	0	0	0	0.00	8
	20150424	2493	2493	2610	2610	2610	2610	2610	117	117	2	5.22	6
	20150427	2610	2610	2740	2740	2740	2740	2740	130	130	6	16.44	10
	20150428	2740	2740	2549	2795	2549	2790	2658	50	-82	12	31.90	10
	20150429	2790	2658				2658	2658	0	0	0	0.00	10
	20150430	2658	2658	2540	2750	2540	2746	2684	88	26	8	21.47	8
wr1511	20150105	2795	2795				2795	2795	0	0	0	0.00	4
	20150106	2795	2795				2795	2795	0	0	0	0.00	4
	20150107	2795	2795				2795	2795	0	0	0	0.00	4
	20150108	2795	2795				2799	2799	4	4	0	0.00	4
	20150109	2799	2799				2799	2799	0	0	0	0.00	4
	20150112	2799	2799				2779	2779	-20	-20	0	0.00	4
	20150113	2779	2779				2779	2779	0	0	0	0.00	4
	20150114	2779	2779				2779	2779	0	0	0	0.00	4
	20150115	2779	2779				2779	2779	0	0	0	0.00	4
	20150116	2779	2779				2822	2822	43	43	0	0.00	4
	20150119	2822	2822				2948	2948	126	126	0	0.00	4
	20150120	2948	2948				2803	2803	-145	-145	0	0.00	4
	20150121	2803	2803				2803	2803	0	0	0	0.00	4
	20150122	2803	2803				2803	2803	0	0	0	0.00	4
	20150123	2803	2803				2803	2803	0	0	0	0.00	4
	20150126	2803	2803				2803	2803	0	0	0	0.00	4
	20150127	2803	2803				2803	2803	0	0	0	0.00	4
	20150128	2803	2803				2803	2803	0	0	0	0.00	4
	20150129	2803	2803				2803	2803	0	0	0	0.00	4
	20150130	2803	2803				2803	2803	0	0	0	0.00	4
	20150202	2803	2803				2803	2803	0	0	0	0.00	4
	20150203	2803	2803				2803	2803	0	0	0	0.00	4
	20150204	2803	2803				2803	2803	0	0	0	0.00	4
	20150205	2803	2803				2803	2803	0	0	0	0.00	4
	20150206	2803	2803				2803	2803	0	0	0	0.00	4
	20150209	2803	2803				2803	2803	0	0	0	0.00	4
	20150210	2803	2803				2803	2803	0	0	0	0.00	4
	20150211	2803	2803				2803	2803	0	0	0	0.00	4
	20150212	2803	2803				2803	2803	0	0	0	0.00	4
	20150213	2803	2803	2862	2862	2862	2862	2862	59	59	2	5.72	6
	20150216	2862	2862				2862	2862	0	0	0	0.00	6
	20150217	2862	2862				2862	2862	0	0	0	0.00	6
	20150225	2862	2862				2862	2862	0	0	0	0.00	6
	20150226	2862	2862				2862	2862	0	0	0	0.00	6
	20150227	2862	2862				2862	2862	0	0	0	0.00	6
	20150302	2862	2862				2869	2869	7	7	0	0.00	6
	20150303	2869	2869				2869	2869	0	0	0	0.00	6
	20150304	2869	2869				2869	2869	0	0	0	0.00	6
	20150305	2869	2869				2869	2869	0	0	0	0.00	6
	20150306	2869	2869				2869	2869	0	0	0	0.00	6
	20150309	2869	2869				2893	2893	24	24	0	0.00	6
	20150310	2893	2893				2893	2893	0	0	0	0.00	6
	20150311	2893	2893				2893	2893	0	0	0	0.00	6
	20150312	2893	2893				2810	2810	-83	-83	0	0.00	6
	20150313	2810	2810				2810	2810	0	0	0	0.00	6
	20150316	2810	2810	2810	2810	2810	2810	2810	0	0	2	5.62	6
	20150317	2810	2810				2804	2804	-6	-6	0	0.00	6
	20150318	2804	2804	2804	2804	2804	2804	2804	0	0	2	5.61	6
	20150319	2804	2804	2804	2804	2780	2780	2798	-24	-6	8	22.38	6
	20150320	2780	2798	2658	2658	2658	2658	2658	-140	-140	2	5.32	4
	20150323	2658	2658				2658	2658	0	0	0	0.00	4
	20150324	2658	2658				2658	2658	0	0	0	0.00	4
	20150325	2658	2658				2658	2658	0	0	0	0.00	4
	20150326	2658	2658				2673	2673	15	15	0	0.00	4
	20150327	2673	2673				2541	2541	-132	-132	0	0.00	4
	20150330	2541	2541				2668	2668	127	127	0	0.00	4
	20150331	2668	2668				2668	2668	0	0	0	0.00	4
	20150401	2668	2668				2668	2668	0	0	0	0.00	4
	20150402	2668	2668				2731	2731	63	63	0	0.00	4
	20150403	2731	2731				2731	2731	0	0	0	0.00	4
	20150407	2731	2731				2731	2731	0	0	0	0.00	4
	20150408	2731	2731				2731	2731	0	0	0	0.00	4
	20150409	2731	2731				2603	2603	-128	-128	0	0.00	4
	20150410	2603	2603				2603	2603	0	0	0	0.00	4
	20150413	2603	2603				2603	2603	0	0	0	0.00	4
	20150414	2603	2603				2603	2603	0	0	0	0.00	4
	20150415	2603	2603				2599	2599	-4	-4	0	0.00	4
	20150416	2599	2599				2599	2599	0	0	0	0.00	4
	20150417	2599	2599				2599	2599	0	0	0	0.00	4
	20150420	2599	2599				2599	2599	0	0	0	0.00	4
	20150421	2599	2599				2599	2599	0	0	0	0.00	4
	20150422	2599	2599				2599	2599	0	0	0	0.00	4
	20150423	2599	2599				2599	2599	0	0	0	0.00	4
	20150424	2599	2599				2720	2720	121	121	0	0.00	4
	20150427	2720	2720				2720	2720	0	0	0	0.00	4
	20150428	2720	2720				2638	2638	-82	-82	0	0.00	4
	20150429	2638	2638				2768	2768	130	130	0	0.00	4
	20150430	2768	2768				2768	2768	0	0	0	0.00	4
wr1512	20150105	2851	2851				2888	2888	37	37	0	0.00	0
	20150106	2888	2888				2888	2888	0	0	0	0.00	0
	20150107	2888	2888				2888	2888	0	0	0	0.00	0
	20150108	2888	2888				2888	2888	0	0	0	0.00	0
	20150109	2888	2888				2793	2793	-95	-95	0	0.00	0
	20150112	2793	2793				2773	2773	-20	-20	0	0.00	0
	20150113	2773	2773				2773	2773	0	0	0	0.00	0
	20150114	2773	2773				2773	2773	0	0	0	0.00	0
	20150115	2773	2773				2773	2773	0	0	0	0.00	0
	20150116	2773	2773				2816	2816	43	43	0	0.00	0
	20150119	2816	2816				2942	2942	126	126	0	0.00	0
	20150120	2942	2942				2798	2798	-144	-144	0	0.00	0
	20150121	2798	2798				2798	2798	0	0	0	0.00	0
	20150122	2798	2798				2798	2798	0	0	0	0.00	0
	20150123	2798	2798				2851	2851	53	53	0	0.00	0
	20150126	2851	2851				2851	2851	0	0	0	0.00	0
	20150127	2851	2851				2725	2725	-126	-126	0	0.00	0
	20150128	2725	2725				2725	2725	0	0	0	0.00	0
	20150129	2725	2725				2725	2725	0	0	0	0.00	0
	20150130	2725	2725				2725	2725	0	0	0	0.00	0
	20150202	2725	2725				2725	2725	0	0	0	0.00	0
	20150203	2725	2725				2725	2725	0	0	0	0.00	0
	20150204	2725	2725				2725	2725	0	0	0	0.00	0
	20150205	2725	2725				2591	2591	-134	-134	0	0.00	0
	20150206	2591	2591				2591	2591	0	0	0	0.00	0
	20150209	2591	2591				2591	2591	0	0	0	0.00	0
	20150210	2591	2591				2591	2591	0	0	0	0.00	0
	20150211	2591	2591				2591	2591	0	0	0	0.00	0
	20150212	2591	2591				2664	2664	73	73	0	0.00	0
	20150213	2664	2664				2720	2720	56	56	0	0.00	0
	20150216	2720	2720				2720	2720	0	0	0	0.00	0
	20150217	2720	2720				2720	2720	0	0	0	0.00	0
	20150225	2720	2720				2720	2720	0	0	0	0.00	0
	20150226	2720	2720				2720	2720	0	0	0	0.00	0
	20150227	2720	2720				2587	2587	-133	-133	0	0.00	0
	20150302	2587	2587				2594	2594	7	7	0	0.00	0
	20150303	2594	2594				2466	2466	-128	-128	0	0.00	0
	20150304	2466	2466				2589	2589	123	123	0	0.00	0
	20150305	2589	2589				2589	2589	0	0	0	0.00	0
	20150306	2589	2589				2589	2589	0	0	0	0.00	0
	20150309	2589	2589				2611	2611	22	22	0	0.00	0
	20150310	2611	2611				2611	2611	0	0	0	0.00	0
	20150311	2611	2611				2611	2611	0	0	0	0.00	0
	20150312	2611	2611				2611	2611	0	0	0	0.00	0
	20150313	2611	2611				2611	2611	0	0	0	0.00	0
	20150316	2611	2611				2611	2611	0	0	0	0.00	0
	20150317	2611	2611				2611	2611	0	0	0	0.00	0
	20150318	2611	2611				2611	2611	0	0	0	0.00	0
	20150319	2611	2611				2605	2605	-6	-6	0	0.00	0
	20150320	2605	2605				2474	2474	-131	-131	0	0.00	0
	20150323	2474	2474				2474	2474	0	0	0	0.00	0
	20150324	2474	2474				2474	2474	0	0	0	0.00	0
	20150325	2474	2474				2474	2474	0	0	0	0.00	0
	20150326	2474	2474				2488	2488	14	14	0	0.00	0
	20150327	2488	2488				2365	2365	-123	-123	0	0.00	0
	20150330	2365	2365				2294	2294	-71	-71	0	0.00	0
	20150331	2294	2294				2340	2340	46	46	0	0.00	0
	20150401	2340	2340				2340	2340	0	0	0	0.00	0
	20150402	2340	2340				2395	2395	55	55	0	0.00	0
	20150403	2395	2395				2395	2395	0	0	0	0.00	0
	20150407	2395	2395				2395	2395	0	0	0	0.00	0
	20150408	2395	2395				2395	2395	0	0	0	0.00	0
	20150409	2395	2395				2283	2283	-112	-112	0	0.00	0
	20150410	2283	2283				2283	2283	0	0	0	0.00	0
	20150413	2283	2283				2283	2283	0	0	0	0.00	0
	20150414	2283	2283				2283	2283	0	0	0	0.00	0
	20150415	2283	2283				2280	2280	-3	-3	0	0.00	0
	20150416	2280	2280				2280	2280	0	0	0	0.00	0
	20150417	2280	2280				2166	2166	-114	-114	0	0.00	0
	20150420	2166	2166				2200	2200	34	34	0	0.00	0
	20150421	2200	2200				2175	2175	-25	-25	0	0.00	0
	20150422	2175	2175				2175	2175	0	0	0	0.00	0
	20150423	2175	2175				2283	2283	108	108	0	0.00	0
	20150424	2283	2283				2390	2390	107	107	0	0.00	0
	20150427	2390	2390				2509	2509	119	119	0	0.00	0
	20150428	2509	2509				2433	2433	-76	-76	0	0.00	0
	20150429	2433	2433				2553	2553	120	120	0	0.00	0
	20150430	2553	2553				2577	2577	24	24	0	0.00	0
wr1601	20150116	2773	2773				2816	2816	43	43	0	0.00	0
	20150119	2816	2816				2942	2942	126	126	0	0.00	0
	20150120	2942	2942				2942	2942	0	0	0	0.00	0
	20150121	2942	2942				2942	2942	0	0	0	0.00	0
	20150122	2942	2942				2930	2930	-12	-12	0	0.00	0
	20150123	2930	2930				2900	2900	-30	-30	0	0.00	0
	20150126	2900	2900				2900	2900	0	0	0	0.00	0
	20150127	2900	2900				2772	2772	-128	-128	0	0.00	0
	20150128	2772	2772				2772	2772	0	0	0	0.00	0
	20150129	2772	2772				2772	2772	0	0	0	0.00	0
	20150130	2772	2772				2772	2772	0	0	0	0.00	0
	20150202	2772	2772				2772	2772	0	0	0	0.00	0
	20150203	2772	2772				2772	2772	0	0	0	0.00	0
	20150204	2772	2772				2772	2772	0	0	0	0.00	0
	20150205	2772	2772				2635	2635	-137	-137	0	0.00	0
	20150206	2635	2635				2635	2635	0	0	0	0.00	0
	20150209	2635	2635				2635	2635	0	0	0	0.00	0
	20150210	2635	2635				2635	2635	0	0	0	0.00	0
	20150211	2635	2635				2635	2635	0	0	0	0.00	0
	20150212	2635	2635				2709	2709	74	74	0	0.00	0
	20150213	2709	2709				2766	2766	57	57	0	0.00	0
	20150216	2766	2766				2766	2766	0	0	0	0.00	0
	20150217	2766	2766				2766	2766	0	0	0	0.00	0
	20150225	2766	2766				2766	2766	0	0	0	0.00	0
	20150226	2766	2766				2766	2766	0	0	0	0.00	0
	20150227	2766	2766				2631	2631	-135	-135	0	0.00	0
	20150302	2631	2631				2638	2638	7	7	0	0.00	0
	20150303	2638	2638	2380	2901	2380	2870	2730	232	92	22	60.07	0
	20150304	2870	2730				2730	2730	0	0	0	0.00	0
	20150305	2730	2730				2730	2730	0	0	0	0.00	0
	20150306	2730	2730				2730	2730	0	0	0	0.00	0
	20150309	2730	2730				2753	2753	23	23	0	0.00	0
	20150310	2753	2753				2753	2753	0	0	0	0.00	0
	20150311	2753	2753				2753	2753	0	0	0	0.00	0
	20150312	2753	2753				2753	2753	0	0	0	0.00	0
	20150313	2753	2753				2753	2753	0	0	0	0.00	0
	20150316	2753	2753				2753	2753	0	0	0	0.00	0
	20150317	2753	2753				2753	2753	0	0	0	0.00	0
	20150318	2753	2753				2753	2753	0	0	0	0.00	0
	20150319	2753	2753				2747	2747	-6	-6	0	0.00	0
	20150320	2747	2747				2609	2609	-138	-138	0	0.00	0
	20150323	2609	2609				2609	2609	0	0	0	0.00	0
	20150324	2609	2609				2609	2609	0	0	0	0.00	0
	20150325	2609	2609				2609	2609	0	0	0	0.00	0
	20150326	2609	2609				2623	2623	14	14	0	0.00	0
	20150327	2623	2623				2493	2493	-130	-130	0	0.00	0
	20150330	2493	2493				2418	2418	-75	-75	0	0.00	0
	20150331	2418	2418				2467	2467	49	49	0	0.00	0
	20150401	2467	2467				2467	2467	0	0	0	0.00	0
	20150402	2467	2467				2525	2525	58	58	0	0.00	0
	20150403	2525	2525				2525	2525	0	0	0	0.00	0
	20150407	2525	2525				2525	2525	0	0	0	0.00	0
	20150408	2525	2525				2525	2525	0	0	0	0.00	0
	20150409	2525	2525				2407	2407	-118	-118	0	0.00	0
	20150410	2407	2407				2407	2407	0	0	0	0.00	0
	20150413	2407	2407				2407	2407	0	0	0	0.00	0
	20150414	2407	2407				2407	2407	0	0	0	0.00	0
	20150415	2407	2407				2404	2404	-3	-3	0	0.00	0
	20150416	2404	2404				2404	2404	0	0	0	0.00	0
	20150417	2404	2404				2283	2283	-121	-121	0	0.00	0
	20150420	2283	2283				2319	2319	36	36	0	0.00	0
	20150421	2319	2319				2293	2293	-26	-26	0	0.00	0
	20150422	2293	2293				2293	2293	0	0	0	0.00	0
	20150423	2293	2293				2293	2293	0	0	0	0.00	0
	20150424	2293	2293				2400	2400	107	107	0	0.00	0
	20150427	2400	2400				2519	2519	119	119	0	0.00	0
	20150428	2519	2519				2443	2443	-76	-76	0	0.00	0
	20150429	2443	2443				2564	2564	121	121	0	0.00	0
	20150430	2564	2564				2589	2589	25	25	0	0.00	0
wr1602	20150216	2766	2766				2766	2766	0	0	0	0.00	0
	20150217	2766	2766				2766	2766	0	0	0	0.00	0
	20150225	2766	2766				2766	2766	0	0	0	0.00	0
	20150226	2766	2766				2766	2766	0	0	0	0.00	0
	20150227	2766	2766				2631	2631	-135	-135	0	0.00	0
	20150302	2631	2631				2638	2638	7	7	0	0.00	0
	20150303	2638	2638				2730	2730	92	92	0	0.00	0
	20150304	2730	2730				2730	2730	0	0	0	0.00	0
	20150305	2730	2730				2730	2730	0	0	0	0.00	0
	20150306	2730	2730				2730	2730	0	0	0	0.00	0
	20150309	2730	2730				2730	2730	0	0	0	0.00	0
	20150310	2730	2730				2730	2730	0	0	0	0.00	0
	20150311	2730	2730				2730	2730	0	0	0	0.00	0
	20150312	2730	2730				2730	2730	0	0	0	0.00	0
	20150313	2730	2730				2730	2730	0	0	0	0.00	0
	20150316	2730	2730				2730	2730	0	0	0	0.00	0
	20150317	2730	2730				2730	2730	0	0	0	0.00	0
	20150318	2730	2730				2730	2730	0	0	0	0.00	0
	20150319	2730	2730				2724	2724	-6	-6	0	0.00	0
	20150320	2724	2724				2587	2587	-137	-137	0	0.00	0
	20150323	2587	2587				2587	2587	0	0	0	0.00	0
	20150324	2587	2587				2587	2587	0	0	0	0.00	0
	20150325	2587	2587				2587	2587	0	0	0	0.00	0
	20150326	2587	2587				2601	2601	14	14	0	0.00	0
	20150327	2601	2601				2472	2472	-129	-129	0	0.00	0
	20150330	2472	2472				2398	2398	-74	-74	0	0.00	0
	20150331	2398	2398				2447	2447	49	49	0	0.00	0
	20150401	2447	2447				2447	2447	0	0	0	0.00	0
	20150402	2447	2447				2505	2505	58	58	0	0.00	0
	20150403	2505	2505				2505	2505	0	0	0	0.00	0
	20150407	2505	2505				2505	2505	0	0	0	0.00	0
	20150408	2505	2505				2505	2505	0	0	0	0.00	0
	20150409	2505	2505				2388	2388	-117	-117	0	0.00	0
	20150410	2388	2388				2388	2388	0	0	0	0.00	0
	20150413	2388	2388				2388	2388	0	0	0	0.00	0
	20150414	2388	2388				2388	2388	0	0	0	0.00	0
	20150415	2388	2388				2385	2385	-3	-3	0	0.00	0
	20150416	2385	2385				2385	2385	0	0	0	0.00	0
	20150417	2385	2385				2146	2146	-239	-239	0	0.00	0
	20150420	2146	2146				2180	2180	34	34	0	0.00	0
	20150421	2180	2180				2155	2155	-25	-25	0	0.00	0
	20150422	2155	2155				2155	2155	0	0	0	0.00	0
	20150423	2155	2155				2155	2155	0	0	0	0.00	0
	20150424	2155	2155				2256	2256	101	101	0	0.00	0
	20150427	2256	2256				2368	2368	112	112	0	0.00	0
	20150428	2368	2368				2297	2297	-71	-71	0	0.00	0
	20150429	2297	2297				2410	2410	113	113	0	0.00	0
	20150430	2410	2410				2433	2433	23	23	0	0.00	0
wr1603	20150317	2730	2730				2730	2730	0	0	0	0.00	0
	20150318	2730	2730				2730	2730	0	0	0	0.00	0
	20150319	2730	2730				2724	2724	-6	-6	0	0.00	0
	20150320	2724	2724				2587	2587	-137	-137	0	0.00	0
	20150323	2587	2587				2587	2587	0	0	0	0.00	0
	20150324	2587	2587				2587	2587	0	0	0	0.00	0
	20150325	2587	2587				2587	2587	0	0	0	0.00	0
	20150326	2587	2587				2601	2601	14	14	0	0.00	0
	20150327	2601	2601				2601	2601	0	0	0	0.00	0
	20150330	2601	2601				2523	2523	-78	-78	0	0.00	0
	20150331	2523	2523				2574	2574	51	51	0	0.00	0
	20150401	2574	2574				2574	2574	0	0	0	0.00	0
	20150402	2574	2574				2635	2635	61	61	0	0.00	0
	20150403	2635	2635				2635	2635	0	0	0	0.00	0
	20150407	2635	2635				2635	2635	0	0	0	0.00	0
	20150408	2635	2635				2635	2635	0	0	0	0.00	0
	20150409	2635	2635				2512	2512	-123	-123	0	0.00	0
	20150410	2512	2512				2512	2512	0	0	0	0.00	0
	20150413	2512	2512				2512	2512	0	0	0	0.00	0
	20150414	2512	2512				2512	2512	0	0	0	0.00	0
	20150415	2512	2512				2512	2512	0	0	0	0.00	0
	20150416	2512	2512				2512	2512	0	0	0	0.00	0
	20150417	2512	2512				2260	2260	-252	-252	0	0.00	0
	20150420	2260	2260				2296	2296	36	36	0	0.00	0
	20150421	2296	2296				2270	2270	-26	-26	0	0.00	0
	20150422	2270	2270				2270	2270	0	0	0	0.00	0
	20150423	2270	2270				2270	2270	0	0	0	0.00	0
	20150424	2270	2270				2376	2376	106	106	0	0.00	0
	20150427	2376	2376				2494	2494	118	118	0	0.00	0
	20150428	2494	2494				2419	2419	-75	-75	0	0.00	0
	20150429	2419	2419				2539	2539	120	120	0	0.00	0
	20150430	2539	2539				2563	2563	24	24	0	0.00	0
wr1604	20150416	2512	2512				2512	2512	0	0	0	0.00	0
	20150417	2512	2512				2260	2260	-252	-252	0	0.00	0
	20150420	2260	2260				2296	2296	36	36	0	0.00	0
	20150421	2296	2296				2270	2270	-26	-26	0	0.00	0
	20150422	2270	2270				2270	2270	0	0	0	0.00	0
	20150423	2270	2270				2270	2270	0	0	0	0.00	0
	20150424	2270	2270				2376	2376	106	106	0	0.00	0
	20150427	2376	2376				2494	2494	118	118	0	0.00	0
	20150428	2494	2494				2419	2419	-75	-75	0	0.00	0
	20150429	2419	2419				2539	2539	120	120	0	0.00	0
	20150430	2539	2539				2563	2563	24	24	0	0.00	0
zn1501	20150105	16500	16760	16825	16940	16725	16805	16830	45	70	2092	17,604.91	12050
	20150106	16805	16830	16640	16850	16640	16835	16805	5	-25	920	7,730.45	11490
	20150107	16835	16805	16800	16820	16745	16775	16765	-30	-40	2460	20,626.00	10020
	20150108	16775	16765	16725	16730	16575	16595	16625	-170	-140	5270	43,819.35	6380
	20150109	16595	16625	16725	16725	16565	16600	16600	-25	-25	2180	18,099.28	5270
	20150112	16600	16600	16620	16635	16535	16550	16585	-50	-15	1510	12,525.30	4150
	20150113	16550	16585	16720	16720	16410	16410	16480	-175	-105	630	5,191.88	3560
	20150114	16410	16480	16155	16450	15900	16015	15935	-465	-545	2500	19,924.63	1860
	20150115	16015	15935	15850	16100	15850	16050	15985	115	50	290	2,318.50	1910
zn1502	20150105	16795	16680	16795	16885	16650	16740	16775	60	95	40060	336,014.64	56452
	20150106	16740	16775	16610	16815	16525	16770	16715	-5	-60	35134	293,654.29	54290
	20150107	16770	16715	16795	16795	16645	16690	16695	-25	-20	27122	226,448.99	51070
	20150108	16690	16695	16640	16670	16500	16520	16555	-175	-140	25578	211,783.48	47092
	20150109	16520	16555	16560	16655	16470	16515	16550	-40	-5	14490	119,940.74	44372
	20150112	16515	16550	16530	16645	16435	16475	16530	-75	-20	11528	95,303.27	41180
	20150113	16475	16530	16380	16460	16320	16320	16395	-210	-135	8996	73,750.81	38760
	20150114	16320	16395	16195	16235	15660	15725	15880	-670	-515	38806	308,180.92	29810
	20150115	15725	15880	15770	16060	15770	15955	15945	75	65	21586	172,124.11	24582
	20150116	15955	15945	15985	16065	15825	15905	15915	-40	-30	7546	60,055.04	23460
	20150119	15905	15915	15910	16155	15880	16125	16015	210	100	7720	61,826.00	22346
	20150120	16125	16015	16035	16180	16015	16145	16100	130	85	3968	31,943.96	20964
	20150121	16145	16100	16210	16300	16160	16250	16235	150	135	12440	101,002.26	14450
	20150122	16250	16235	16225	16505	16200	16425	16395	190	160	3912	32,072.20	13822
	20150123	16425	16395	16475	16540	16290	16325	16390	-70	-5	4172	34,199.88	12836
	20150126	16325	16390	16280	16335	16015	16190	16170	-200	-220	4280	34,612.99	11824
	20150127	16190	16170	16215	16540	16215	16390	16425	220	255	3810	31,297.93	10118
	20150128	16390	16425	16435	16475	16330	16430	16405	5	-20	3314	27,191.20	9132
	20150129	16430	16405	16415	16415	16220	16250	16295	-155	-110	3554	28,963.58	7808
	20150130	16250	16295	16190	16360	16130	16220	16190	-75	-105	2110	17,085.61	6836
	20150202	16220	16190	16280	16370	16280	16280	16320	90	130	1726	14,085.93	5910
	20150203	16280	16320	16305	16400	16200	16285	16285	-35	-35	5980	48,704.35	3110
	20150204	16285	16285	16325	16470	16320	16325	16375	40	90	3190	26,118.23	3550
	20150205	16325	16375	16310	16310	16260	16260	16275	-115	-100	1330	10,824.28	2950
	20150206	16260	16275	16280	16375	16280	16375	16305	100	30	520	4,240.45	3020
	20150209	16375	16305	16375	16375	16310	16355	16340	50	35	1220	9,968.63	2020
	20150210	16355	16340	16360	16360	16325	16345	16335	5	-5	640	5,228.43	2240
zn1503	20150105	16780	16655	16710	16870	16625	16720	16745	65	90	189904	1,590,226.09	160518
	20150106	16720	16745	16525	16800	16500	16740	16680	-5	-65	239488	1,997,883.26	163974
	20150107	16740	16680	16790	16790	16590	16630	16665	-50	-15	174974	1,458,324.66	161740
	20150108	16630	16665	16560	16610	16420	16465	16515	-200	-150	180220	1,488,221.14	160806
	20150109	16465	16515	16595	16600	16410	16455	16495	-60	-20	203098	1,675,430.69	158354
	20150112	16455	16495	16455	16590	16375	16410	16485	-85	-10	182332	1,503,289.67	158684
	20150113	16410	16485	16310	16395	16250	16255	16325	-230	-160	153358	1,251,874.15	160330
	20150114	16255	16325	16080	16165	15550	15630	15820	-695	-505	573954	4,541,372.67	186858
	20150115	15630	15820	15760	15960	15680	15870	15835	50	15	501186	3,969,127.70	177374
	20150116	15870	15835	15915	15990	15740	15810	15840	-25	5	260234	2,061,408.39	168820
	20150119	15810	15840	15830	16085	15800	16065	15945	225	105	256384	2,044,298.40	158856
	20150120	16065	15945	15980	16100	15920	16035	16000	90	55	166498	1,332,296.40	162064
	20150121	16035	16000	16140	16210	16055	16155	16125	155	125	181386	1,462,794.13	156518
	20150122	16155	16125	16120	16440	16110	16360	16300	235	175	285218	2,324,853.18	151594
	20150123	16360	16300	16385	16460	16200	16235	16315	-65	15	249752	2,037,918.43	127734
	20150126	16235	16315	16170	16245	15915	16115	16095	-200	-220	285936	2,301,544.50	113610
	20150127	16115	16095	16185	16445	16140	16315	16320	220	225	218744	1,784,971.39	103626
	20150128	16315	16320	16350	16390	16245	16380	16325	60	5	167550	1,367,876.30	95934
	20150129	16380	16325	16325	16360	16135	16135	16230	-190	-95	141824	1,150,972.38	83600
	20150130	16135	16230	16070	16185	16055	16095	16110	-135	-120	75288	606,519.24	75548
	20150202	16095	16110	16185	16315	16155	16250	16225	140	115	57442	466,072.30	63186
	20150203	16250	16225	16295	16370	16205	16295	16280	70	55	39792	323,999.28	54784
	20150204	16295	16280	16400	16490	16315	16335	16400	55	120	37748	309,570.62	47186
	20150205	16335	16400	16285	16400	16255	16280	16290	-120	-110	20890	170,186.77	44136
	20150206	16280	16290	16260	16410	16205	16405	16315	115	25	16304	133,035.49	39908
	20150209	16405	16315	16440	16450	16300	16350	16345	35	30	16232	132,669.60	37898
	20150210	16350	16345	16370	16410	16320	16350	16345	5	0	7794	63,706.83	36216
	20150211	16350	16345	16305	16305	16175	16195	16220	-150	-125	9700	78,669.64	33088
	20150212	16195	16220	16200	16250	16135	16250	16180	30	-40	6282	50,833.10	31476
	20150213	16250	16180	16295	16370	16255	16370	16320	190	140	8796	71,790.19	28790
	20150216	16370	16320	16370	16430	16335	16410	16380	90	60	7156	58,621.07	26808
	20150217	16410	16380	16405	16445	16310	16340	16375	-40	-5	4320	35,370.85	25660
	20150225	16340	16375	16190	16190	15955	16100	16110	-275	-265	8222	66,244.37	21348
	20150226	16100	16110	16100	16160	16060	16125	16095	15	-15	6996	56,308.13	18474
	20150227	16125	16095	16280	16280	16050	16095	16100	0	5	7254	58,406.27	14464
	20150302	16095	16100	16095	16250	16060	16185	16175	85	75	3444	27,856.91	14900
	20150303	16185	16175	16130	16140	16050	16050	16085	-125	-90	3770	30,324.15	12840
	20150304	16050	16085	16050	16050	15910	15915	15965	-170	-120	6050	48,297.75	9530
	20150305	15915	15965	15920	15935	15850	15855	15900	-110	-65	1800	14,310.80	9120
	20150306	15855	15900	15850	15865	15750	15780	15800	-120	-100	5230	41,326.95	6440
	20150309	15780	15800	15750	15850	15715	15785	15755	-15	-45	3200	25,211.45	5950
	20150310	15785	15755	15740	15825	15740	15750	15785	-5	30	1500	11,840.53	5220
	20150311	15750	15785	15665	15750	15665	15720	15710	-65	-75	2490	19,559.88	4740
	20150312	15720	15710	15650	15700	15600	15700	15610	-10	-100	1080	8,430.80	4510
	20150313	15700	15610	15660	15700	15650	15700	15660	90	50	1370	10,729.65	3780
	20150316	15700	15660	15790	15800	15745	15760	15755	100	95	550	4,333.25	3460
zn1504	20150105	16765	16625	16740	16850	16605	16695	16745	70	120	20460	171,312.56	22846
	20150106	16695	16745	16500	16775	16480	16710	16670	-35	-75	26452	220,494.39	26310
	20150107	16710	16670	16735	16755	16570	16610	16640	-60	-30	22602	188,064.43	27586
	20150108	16610	16640	16560	16580	16375	16430	16485	-210	-155	27480	226,512.50	32468
	20150109	16430	16485	16575	16575	16385	16410	16465	-75	-20	29212	240,509.54	34366
	20150112	16410	16465	16410	16550	16350	16380	16445	-85	-20	35058	288,281.97	39012
	20150113	16380	16445	16305	16360	16200	16210	16290	-235	-155	35642	290,364.63	41772
	20150114	16210	16290	16020	16125	15500	15605	15785	-685	-505	140272	1,107,139.63	60944
	20150115	15605	15785	15710	15905	15650	15835	15795	50	10	111790	882,883.08	63404
	20150116	15835	15795	15865	15980	15705	15775	15805	-20	10	70686	558,674.15	67824
	20150119	15775	15805	15805	16050	15770	16045	15920	240	115	90406	719,844.14	72258
	20150120	16045	15920	15915	16055	15885	15990	15965	70	45	55132	440,172.51	76834
	20150121	15990	15965	16095	16150	16005	16100	16075	135	110	58254	468,259.24	78014
	20150122	16100	16075	16050	16400	16050	16330	16265	255	190	110432	898,197.72	100230
	20150123	16330	16265	16355	16420	16170	16205	16270	-60	5	108538	883,096.11	101282
	20150126	16205	16270	16130	16200	15875	16065	16045	-205	-225	178778	1,434,528.70	131698
	20150127	16065	16045	16150	16395	16110	16275	16285	230	240	170488	1,388,372.69	144984
	20150128	16275	16285	16315	16345	16195	16335	16280	50	-5	139784	1,138,135.15	152692
	20150129	16335	16280	16310	16320	16070	16090	16175	-190	-105	151370	1,224,538.39	146800
	20150130	16090	16175	16020	16135	16000	16020	16050	-155	-125	141942	1,139,355.38	151148
	20150202	16020	16050	16145	16260	16095	16200	16170	150	120	152516	1,233,304.13	153802
	20150203	16200	16170	16200	16325	16145	16280	16245	110	75	133202	1,081,954.38	147530
	20150204	16280	16245	16370	16465	16290	16330	16380	85	135	173136	1,418,025.50	136934
	20150205	16330	16380	16340	16380	16235	16270	16290	-110	-90	120522	981,664.82	134898
	20150206	16270	16290	16225	16405	16195	16390	16305	100	15	117942	961,621.51	136548
	20150209	16390	16305	16450	16455	16310	16355	16360	50	55	107594	880,307.01	125150
	20150210	16355	16360	16380	16430	16325	16355	16370	-5	10	70872	580,155.82	120250
	20150211	16355	16370	16300	16310	16160	16200	16220	-170	-150	107614	872,834.87	117132
	20150212	16200	16220	16220	16240	16115	16235	16170	15	-50	71702	579,843.98	112322
	20150213	16235	16170	16275	16375	16265	16350	16310	180	140	100602	820,617.78	105116
	20150216	16350	16310	16375	16440	16330	16405	16380	95	70	54172	443,741.37	98594
	20150217	16405	16380	16410	16450	16310	16320	16365	-60	-15	41978	343,568.27	90732
	20150225	16320	16365	16050	16145	15995	16080	16070	-285	-295	55162	443,332.06	86460
	20150226	16080	16070	16040	16110	15980	16060	16045	-10	-25	53620	430,293.96	80070
	20150227	16060	16045	16135	16140	16005	16070	16065	25	20	57366	460,837.96	69872
	20150302	16070	16065	16070	16220	16035	16180	16130	115	65	43412	350,177.82	61230
	20150303	16180	16130	16105	16130	15980	15985	16055	-145	-75	28944	232,379.11	58708
	20150304	15985	16055	15955	16005	15890	15910	15935	-145	-120	18624	148,416.04	56584
	20150305	15910	15935	15930	15965	15805	15825	15870	-110	-65	15846	125,760.50	54682
	20150306	15825	15870	15830	15905	15730	15745	15790	-125	-80	13780	108,816.40	50752
	20150309	15745	15790	15700	15855	15690	15770	15775	-20	-15	12434	98,089.22	48196
	20150310	15770	15775	15755	15830	15730	15755	15780	-20	5	13656	107,759.76	44256
	20150311	15755	15780	15725	15780	15655	15690	15725	-90	-55	9494	74,648.56	42900
	20150312	15690	15725	15715	15755	15595	15720	15660	-5	-65	8736	68,413.42	42272
	20150313	15720	15660	15720	15740	15635	15730	15695	70	35	7480	58,701.01	39264
	20150316	15730	15695	15695	15850	15650	15850	15765	155	70	5874	46,306.24	38102
	20150317	15850	15765	15805	15810	15645	15680	15690	-85	-75	10540	82,695.82	32886
	20150318	15680	15690	15600	15695	15590	15605	15660	-85	-30	7296	57,144.37	29010
	20150319	15605	15660	15595	15665	15515	15600	15615	-60	-45	6016	46,980.12	26424
	20150320	15600	15615	15600	15695	15600	15625	15645	10	30	4920	38,493.25	24716
	20150323	15625	15645	15660	15935	15660	15795	15800	150	155	7498	59,248.12	22456
	20150324	15795	15800	15885	16000	15800	15880	15870	80	70	11410	90,560.28	17698
	20150325	15880	15870	15800	15930	15800	15870	15875	0	5	9728	77,226.32	15286
	20150326	15870	15875	15895	15950	15880	15925	15915	50	40	4978	39,621.11	16258
	20150327	15925	15915	16000	16010	15840	15890	15915	-25	0	3328	26,486.43	15540
	20150330	15890	15915	15930	15955	15890	15905	15925	-10	10	1998	15,909.10	14598
	20150331	15905	15925	15955	16015	15895	15905	15970	-20	45	5584	44,599.40	11160
	20150401	15905	15970	15830	15925	15830	15895	15870	-75	-100	3490	27,695.98	11440
	20150402	15895	15870	15920	15940	15895	15915	15915	45	45	1860	14,804.35	11030
	20150403	15915	15915	15980	16080	15960	16060	16025	145	110	2760	22,115.13	10930
	20150407	16060	16025	16110	16150	16035	16115	16105	90	80	2020	16,269.33	10140
	20150408	16115	16105	16160	16180	16085	16090	16105	-15	0	1960	15,786.93	9970
	20150409	16090	16105	16125	16125	16055	16115	16080	10	-25	1580	12,704.43	9640
	20150410	16115	16080	16130	16255	16120	16255	16165	175	85	2510	20,290.65	8280
	20150413	16255	16165	16300	16400	16300	16360	16320	195	155	1000	8,160.58	7660
	20150414	16360	16320	16300	16300	16200	16250	16255	-70	-65	490	3,982.53	7320
	20150415	16250	16255	16260	16360	16250	16360	16285	105	30	410	3,338.95	7420
zn1505	20150105	16755	16635	16660	16835	16595	16690	16730	55	95	5528	46,249.11	9542
	20150106	16690	16730	16535	16755	16480	16690	16640	-40	-90	4508	37,514.25	10020
	20150107	16690	16640	16715	16815	16550	16570	16615	-70	-25	3506	29,126.21	10430
	20150108	16570	16615	16535	16550	16330	16405	16435	-210	-180	4926	40,484.14	11142
	20150109	16405	16435	16560	16560	16365	16380	16430	-55	-5	3732	30,666.80	11404
	20150112	16380	16430	16350	16515	16330	16375	16415	-55	-15	4350	35,703.27	12004
	20150113	16375	16415	16250	16340	16180	16190	16270	-225	-145	5486	44,634.32	13918
	20150114	16190	16270	16020	16105	15490	15575	15760	-695	-510	20784	163,779.13	19302
	20150115	15575	15760	15640	15910	15625	15825	15765	65	5	16656	131,330.40	21534
	20150116	15825	15765	15795	15915	15695	15760	15785	-5	20	12004	94,744.07	24656
	20150119	15760	15785	15765	16030	15755	16020	15910	235	125	14902	118,559.90	24920
	20150120	16020	15910	15920	16040	15870	15960	15950	50	40	12650	100,889.49	25906
	20150121	15960	15950	16055	16125	15985	16050	16045	100	95	15192	121,902.19	26498
	20150122	16050	16045	16050	16360	16005	16300	16210	255	165	20146	163,301.58	27428
	20150123	16300	16210	16350	16375	16145	16190	16230	-20	20	18266	148,236.88	28346
	20150126	16190	16230	16130	16165	15850	16045	16000	-185	-230	35556	284,491.60	33530
	20150127	16045	16000	16120	16340	16070	16250	16235	250	235	23528	191,047.28	34648
	20150128	16250	16235	16250	16310	16155	16300	16235	65	0	23400	189,989.64	37328
	20150129	16300	16235	16280	16285	16040	16060	16145	-175	-90	41518	335,171.49	38568
	20150130	16060	16145	15995	16090	15965	15995	16015	-150	-130	29816	238,789.29	39204
	20150202	15995	16015	16105	16225	15950	16170	16130	155	115	27940	225,395.16	39166
	20150203	16170	16130	16170	16290	16115	16280	16215	150	85	27802	225,407.80	42966
	20150204	16280	16215	16375	16435	16285	16300	16360	85	145	27294	223,299.37	42914
	20150205	16300	16360	16300	16360	16225	16275	16270	-85	-90	29144	237,103.03	49172
	20150206	16275	16270	16250	16410	16205	16405	16310	135	40	33858	276,181.36	55730
	20150209	16405	16310	16420	16460	16310	16370	16360	60	50	41862	342,495.09	66654
	20150210	16370	16360	16400	16445	16335	16370	16380	10	20	30236	247,682.64	70054
	20150211	16370	16380	16300	16315	16170	16185	16220	-195	-160	47670	386,624.88	77902
	20150212	16185	16220	16210	16240	16115	16230	16175	10	-45	42982	347,621.49	81900
	20150213	16230	16175	16285	16375	16260	16340	16310	165	135	43510	354,898.50	82496
	20150216	16340	16310	16375	16430	16335	16425	16380	115	70	32574	266,810.25	83730
	20150217	16425	16380	16420	16450	16305	16315	16370	-65	-10	42100	344,645.23	85644
	20150225	16315	16370	16055	16120	15980	16060	16055	-310	-315	68062	546,424.19	98764
	20150226	16060	16055	16010	16075	15950	16025	16020	-30	-35	124446	996,882.15	128128
	20150227	16025	16020	16080	16120	15980	16050	16050	30	30	158808	1,274,696.57	141680
	20150302	16050	16050	16075	16210	16000	16145	16100	95	50	159870	1,287,141.43	147826
	20150303	16145	16100	16100	16110	15955	15960	16035	-140	-65	129158	1,035,551.06	162108
	20150304	15960	16035	15920	15985	15860	15875	15915	-160	-120	115424	918,545.61	174168
	20150305	15875	15915	15915	15945	15780	15815	15855	-100	-60	102366	811,540.48	177074
	20150306	15815	15855	15810	15890	15700	15725	15780	-130	-75	104098	821,409.13	184642
	20150309	15725	15780	15735	15845	15670	15740	15745	-40	-35	128336	1,010,552.38	181084
	20150310	15740	15745	15725	15830	15710	15750	15780	5	35	94936	749,109.40	177824
	20150311	15750	15780	15700	15780	15640	15695	15715	-85	-65	88516	695,605.65	174432
	20150312	15695	15715	15725	15750	15585	15720	15655	5	-60	132136	1,034,438.11	173778
	20150313	15720	15655	15700	15750	15635	15730	15695	75	40	107798	846,150.96	169552
	20150316	15730	15695	15695	15840	15650	15815	15755	120	60	124646	981,913.49	164278
	20150317	15815	15755	15765	15810	15655	15690	15730	-65	-25	96242	756,985.87	163160
	20150318	15690	15730	15650	15710	15600	15615	15660	-115	-70	69740	546,100.15	158680
	20150319	15615	15660	15620	15680	15520	15625	15615	-35	-45	102596	801,242.14	152210
	20150320	15625	15615	15650	15705	15620	15650	15660	35	45	77164	604,248.56	142590
	20150323	15650	15660	15700	15950	15675	15855	15830	195	170	138224	1,094,177.62	121904
	20150324	15855	15830	15910	16040	15845	15910	15930	80	100	112754	898,204.12	103466
	20150325	15910	15930	15940	15975	15875	15910	15920	-20	-10	66928	532,753.08	95218
	20150326	15910	15920	15915	15995	15915	15955	15960	35	40	47256	377,123.35	86442
	20150327	15955	15960	16025	16060	15880	15930	15950	-30	-10	51652	411,988.05	70096
	20150330	15930	15950	15935	16000	15920	15965	15955	15	5	28302	225,826.27	64004
	20150331	15965	15955	16000	16060	15950	15965	16015	10	60	38424	307,750.37	53760
	20150401	15965	16015	15930	15995	15880	15935	15920	-80	-95	20484	163,079.42	49314
	20150402	15935	15920	15895	16020	15890	15975	15950	55	30	22478	179,312.44	44532
	20150403	15975	15950	16000	16150	15990	16140	16085	190	135	31006	249,418.83	37558
	20150407	16140	16085	16125	16200	16080	16180	16145	95	60	16362	132,089.15	32050
	20150408	16180	16145	16195	16245	16105	16140	16180	-5	35	18896	152,869.13	28684
	20150409	16140	16180	16165	16190	16070	16120	16130	-60	-50	9928	80,069.37	26878
	20150410	16120	16130	16190	16325	16155	16320	16220	190	90	22586	183,192.69	21532
	20150413	16320	16220	16320	16410	16275	16400	16350	180	130	12290	100,471.36	22080
	20150414	16400	16350	16425	16425	16210	16295	16310	-55	-40	8826	71,995.70	19856
	20150415	16295	16310	16295	16415	16265	16370	16335	60	25	6764	55,254.60	19650
	20150416	16370	16335	16340	16540	16335	16515	16500	180	165	10264	84,680.28	16092
	20150417	16515	16500	16570	16700	16485	16575	16590	75	90	5456	45,265.86	15492
	20150420	16575	16590	16515	16650	16420	16455	16525	-135	-65	3518	29,076.04	14534
	20150421	16455	16525	16400	16505	16330	16395	16385	-130	-140	2618	21,450.31	14548
	20150422	16395	16385	16410	16570	16410	16545	16505	160	120	3638	30,027.82	13574
	20150423	16545	16505	16580	16630	16405	16540	16515	35	10	2324	19,192.06	12830
	20150424	16540	16515	16475	16550	16445	16515	16470	0	-45	1718	14,150.73	12272
	20150427	16515	16470	16580	16810	16550	16730	16690	260	220	3296	27,506.08	11960
	20150428	16730	16690	16840	17045	16825	16915	16895	225	205	2972	25,107.91	11170
	20150429	16915	16895	16945	16955	16740	16805	16875	-90	-20	1556	13,130.71	10888
	20150430	16805	16875	16805	17015	16805	16985	16890	110	15	5800	48,995.11	11540
zn1506	20150105	16750	16660	16745	16830	16585	16690	16660	30	0	464	3,866.17	526
	20150106	16690	16660	16510	16730	16510	16690	16610	30	-50	372	3,090.21	524
	20150107	16690	16610	16680	16700	16560	16580	16625	-30	15	160	1,330.14	494
	20150108	16580	16625	16545	16555	16360	16390	16435	-235	-190	128	1,052.12	524
	20150109	16390	16435	16590	16590	16360	16410	16450	-25	15	170	1,398.56	610
	20150112	16410	16450	16500	16500	16320	16355	16390	-95	-60	208	1,704.77	620
	20150113	16355	16390	16310	16310	16165	16165	16255	-225	-135	220	1,788.55	704
	20150114	16165	16255	16065	16085	15475	15580	15735	-675	-520	850	6,689.21	1194
	20150115	15580	15735	16470	16470	15625	15835	15795	100	60	1150	9,083.91	1734
	20150116	15835	15795	15865	15890	15690	15780	15770	-15	-25	2066	16,293.17	2558
	20150119	15780	15770	15815	16025	15810	16025	15920	255	150	3032	24,136.94	3788
	20150120	16025	15920	15915	16035	15850	15960	15955	40	35	780	6,223.22	3822
	20150121	15960	15955	16015	16120	15985	16050	16045	95	90	2044	16,401.45	4696
	20150122	16050	16045	15995	16355	15995	16275	16185	230	140	2474	20,025.21	4888
	20150123	16275	16185	16315	16350	16125	16155	16235	-30	50	1488	12,080.92	5004
	20150126	16155	16235	16120	16150	15840	16000	15945	-235	-290	4234	33,764.95	6236
	20150127	16000	15945	16040	16300	16040	16225	16205	280	260	2202	17,843.90	6528
	20150128	16225	16205	16235	16280	16130	16280	16205	75	0	766	6,207.60	6534
	20150129	16280	16205	16255	16280	16030	16040	16115	-165	-90	3268	26,340.07	8006
	20150130	16040	16115	15980	16050	15950	15965	15995	-150	-120	2526	20,205.80	8916
	20150202	15965	15995	16095	16185	16035	16125	16100	130	105	4554	36,663.19	8254
	20150203	16125	16100	16140	16255	16090	16245	16185	145	85	2334	18,888.86	7930
	20150204	16245	16185	16305	16430	16265	16305	16345	120	160	3576	29,228.12	7986
	20150205	16305	16345	16305	16335	16200	16255	16245	-90	-100	2508	20,374.93	8604
	20150206	16255	16245	16210	16390	16190	16385	16285	140	40	2756	22,444.05	8486
	20150209	16385	16285	16405	16435	16295	16365	16355	80	70	3398	27,787.58	9412
	20150210	16365	16355	16370	16455	16335	16375	16385	20	30	2666	21,841.71	10048
	20150211	16375	16385	16300	16315	16170	16215	16210	-170	-175	4314	34,973.32	11356
	20150212	16215	16210	16230	16230	16115	16215	16160	5	-50	4612	37,273.23	13058
	20150213	16215	16160	16285	16345	16245	16310	16295	150	135	3592	29,265.87	13600
	20150216	16310	16295	16360	16405	16320	16400	16350	105	55	3132	25,609.11	14414
	20150217	16400	16350	16415	16420	16275	16300	16320	-50	-30	2808	22,919.06	15040
	20150225	16300	16320	16090	16090	15970	16040	16035	-280	-285	8034	64,421.10	16920
	20150226	16040	16035	16000	16050	15935	16000	15995	-35	-40	16424	131,381.61	23542
	20150227	16000	15995	16065	16100	15970	16035	16035	40	40	27900	223,742.67	36994
	20150302	16035	16035	16050	16195	15985	16130	16095	95	60	26858	216,170.93	43972
	20150303	16130	16095	16095	16095	15915	15930	16025	-165	-70	28094	225,134.12	52266
	20150304	15930	16025	15900	15970	15835	15865	15900	-160	-125	20066	159,534.04	58450
	20150305	15865	15900	15920	15930	15775	15800	15840	-100	-60	21138	167,433.21	61598
	20150306	15800	15840	15800	15875	15680	15710	15755	-130	-85	29484	232,297.77	67100
	20150309	15710	15755	15710	15835	15660	15730	15735	-25	-20	46260	364,053.09	70248
	20150310	15730	15735	15730	15820	15695	15745	15775	10	40	34226	269,977.36	72204
	20150311	15745	15775	15710	15780	15635	15690	15705	-85	-70	38536	302,689.20	75662
	20150312	15690	15705	15710	15740	15575	15720	15645	15	-60	53354	417,482.65	83066
	20150313	15720	15645	15700	15750	15630	15740	15695	95	50	54298	426,186.38	92338
	20150316	15740	15695	15705	15830	15635	15815	15745	120	50	61624	485,236.43	100928
	20150317	15815	15745	15745	15790	15650	15685	15715	-60	-30	59530	467,783.32	107464
	20150318	15685	15715	15630	15700	15565	15610	15650	-105	-65	47410	371,024.70	114048
	20150319	15610	15650	15610	15675	15520	15625	15615	-25	-35	75076	586,217.20	123040
	20150320	15625	15615	15655	15705	15620	15655	15660	40	45	73938	579,035.12	126662
	20150323	15655	15660	15705	15945	15680	15840	15830	180	170	111528	882,756.37	123710
	20150324	15840	15830	15920	16050	15855	15910	15940	80	110	109732	874,666.30	120758
	20150325	15910	15940	15930	15995	15875	15910	15930	-30	-10	85430	680,467.68	122382
	20150326	15910	15930	15935	16015	15915	15965	15970	35	40	96702	772,309.13	125250
	20150327	15965	15970	16030	16075	15910	15945	15975	-25	5	111646	892,001.40	121658
	20150330	15945	15975	15965	16020	15935	15965	15975	-10	0	77676	620,456.00	121958
	20150331	15965	15975	16030	16090	15980	15985	16040	10	65	115234	924,447.09	124552
	20150401	15985	16040	15975	16025	15910	15975	15955	-65	-85	85624	683,109.90	126500
	20150402	15975	15955	15925	16055	15925	16000	15990	45	35	102918	823,013.16	124770
	20150403	16000	15990	16050	16195	16030	16160	16125	170	135	149792	1,207,899.86	133142
	20150407	16160	16125	16160	16245	16135	16215	16195	90	70	69500	562,787.11	136226
	20150408	16215	16195	16230	16300	16140	16190	16225	-5	30	118158	958,644.61	128234
	20150409	16190	16225	16190	16240	16105	16165	16170	-60	-55	83652	676,359.93	124388
	20150410	16165	16170	16215	16375	16200	16360	16270	190	100	176474	1,435,917.31	129970
	20150413	16360	16270	16375	16470	16330	16450	16395	180	125	147650	1,210,655.83	127450
	20150414	16450	16395	16475	16480	16255	16330	16365	-65	-30	134046	1,097,127.15	118176
	20150415	16330	16365	16350	16470	16300	16425	16375	60	10	108834	891,149.91	120994
	20150416	16425	16375	16400	16590	16380	16560	16535	185	160	149780	1,238,672.33	118312
	20150417	16560	16535	16605	16745	16525	16620	16635	85	100	115488	960,743.78	114506
	20150420	16620	16635	16590	16710	16450	16475	16565	-160	-70	100654	833,839.47	104956
	20150421	16475	16565	16420	16530	16350	16420	16425	-145	-140	92344	758,594.29	93174
	20150422	16420	16425	16440	16590	16420	16555	16525	130	100	68304	564,369.01	91032
	20150423	16555	16525	16590	16650	16430	16560	16560	35	35	90140	746,508.32	88068
	20150424	16560	16560	16545	16580	16470	16555	16515	-5	-45	65198	538,476.88	84090
	20150427	16555	16515	16630	16855	16565	16760	16715	245	200	114048	953,226.51	80298
	20150428	16760	16715	16805	17100	16805	16970	16950	255	235	70012	593,363.42	69974
	20150429	16970	16950	16870	17025	16730	16835	16895	-115	-55	41286	348,851.57	63702
	20150430	16835	16895	16825	17055	16775	16965	16935	70	40	39914	338,057.92	60068
zn1507	20150105	16750	16715	16760	16950	16630	16640	16780	-75	65	106	889.37	162
	20150106	16640	16780	16615	16675	16615	16675	16640	-105	-140	16	133.13	168
	20150107	16675	16640	16615	16635	16570	16570	16610	-70	-30	26	215.95	160
	20150108	16570	16610	16550	16550	16350	16435	16465	-175	-145	16	131.74	162
	20150109	16435	16465	16535	16535	16380	16380	16420	-85	-45	32	262.76	154
	20150112	16380	16420	16425	16425	16330	16345	16355	-75	-65	34	278.11	130
	20150113	16345	16355	16245	16305	16160	16165	16205	-190	-150	90	729.43	122
	20150114	16165	16205	16060	16060	15440	15440	15735	-765	-470	104	818.31	172
	20150115	15440	15735	15660	15850	15660	15835	15825	100	90	522	4,130.42	640
	20150116	15835	15825	15835	15835	15705	15785	15765	-40	-60	34	268.02	632
	20150119	15785	15765	15880	16000	15880	16000	15940	235	175	6	47.83	626
	20150120	16000	15940	15935	15980	15935	15960	15960	20	20	16	127.68	626
	20150121	15960	15960	16020	16095	16005	16030	16055	70	95	146	1,172.19	676
	20150122	16030	16055	16090	16320	16070	16295	16135	240	80	318	2,565.73	932
	20150123	16295	16135	16215	16260	16120	16140	16180	5	45	46	372.24	938
	20150126	16140	16180	16110	16110	15815	15960	15920	-220	-260	324	2,579.39	1140
	20150127	15960	15920	16200	16300	16150	16180	16220	260	300	294	2,384.76	1274
	20150128	16180	16220	16265	16265	16170	16230	16210	10	-10	364	2,951.02	1532
	20150129	16230	16210	16140	16140	16070	16070	16105	-140	-105	44	354.37	1534
	20150130	16070	16105	16020	16030	15945	15960	15990	-145	-115	160	1,279.27	1544
	20150202	15960	15990	16045	16150	16045	16140	16105	150	115	426	3,431.05	1884
	20150203	16140	16105	16100	16225	16100	16220	16145	115	40	202	1,630.89	1858
	20150204	16220	16145	16295	16395	16280	16345	16330	200	185	152	1,241.32	1786
	20150205	16345	16330	16260	16305	16215	16245	16235	-85	-95	390	3,166.59	1682
	20150206	16245	16235	16235	16345	16230	16345	16270	110	35	70	569.54	1662
	20150209	16345	16270	16310	16365	16310	16365	16335	95	65	334	2,728.55	1644
	20150210	16365	16335	16400	16440	16365	16380	16375	45	40	92	753.40	1644
	20150211	16380	16375	15555	16290	15555	16200	16205	-175	-170	406	3,290.22	1628
	20150212	16200	16205	16220	16225	16115	16220	16170	15	-35	234	1,892.37	1580
	20150213	16220	16170	16260	16340	16240	16315	16290	145	120	194	1,580.48	1622
	20150216	16315	16290	16390	16390	16305	16355	16350	65	60	386	3,155.61	1812
	20150217	16355	16350	16345	16400	16290	16290	16355	-60	5	132	1,079.64	1810
	20150225	16290	16355	16055	16095	15975	16040	16030	-315	-325	592	4,745.42	2206
	20150226	16040	16030	16000	16045	15935	15990	15985	-40	-45	2038	16,291.72	2576
	20150227	15990	15985	16030	16085	15965	16020	16015	35	30	1696	13,583.36	2750
	20150302	16020	16015	16020	16190	15970	16145	16145	130	130	9372	75,655.95	9566
	20150303	16145	16145	16090	16090	15950	15950	16025	-195	-120	4332	34,716.29	11482
	20150304	15950	16025	15950	15965	15840	15850	15895	-175	-130	5290	42,054.70	13434
	20150305	15850	15895	15895	15915	15770	15795	15845	-100	-50	3884	30,778.51	13562
	20150306	15795	15845	15790	15875	15680	15715	15765	-130	-80	5134	40,473.13	16172
	20150309	15715	15765	15710	15825	15660	15730	15755	-35	-10	6928	54,584.16	19084
	20150310	15730	15755	15725	15815	15710	15750	15780	-5	25	3662	28,893.59	20172
	20150311	15750	15780	15710	15770	15640	15680	15705	-100	-75	10062	79,017.41	18232
	20150312	15680	15705	15715	15730	15565	15715	15635	10	-70	10886	85,109.51	23190
	20150313	15715	15635	15715	15740	15620	15710	15680	75	45	10046	78,784.30	26300
	20150316	15710	15680	15690	15815	15630	15800	15730	120	50	13342	104,963.31	27504
	20150317	15800	15730	15730	15775	15650	15675	15715	-55	-15	13294	104,459.83	32558
	20150318	15675	15715	15650	15700	15580	15605	15650	-110	-65	7208	56,405.77	33640
	20150319	15605	15650	15610	15670	15510	15625	15600	-25	-50	12044	93,946.97	36658
	20150320	15625	15600	15655	15690	15615	15640	15650	40	50	13294	104,035.99	40654
	20150323	15640	15650	15695	15930	15675	15835	15825	185	175	20110	159,167.31	42960
	20150324	15835	15825	15915	16040	15870	15915	15935	90	110	20054	159,806.36	43544
	20150325	15915	15935	15930	16000	15880	15945	15935	10	0	18074	144,032.56	44732
	20150326	15945	15935	15945	16025	15925	15980	15985	45	50	18786	150,153.75	44350
	20150327	15980	15985	16030	16095	15935	15950	15990	-35	5	27270	218,067.54	41686
	20150330	15950	15990	15950	16040	15950	15990	15990	0	0	14950	119,528.83	42218
	20150331	15990	15990	16025	16100	16005	16015	16060	25	70	21100	169,475.41	44496
	20150401	16015	16060	15995	16040	15930	15985	15960	-75	-100	12806	102,223.55	44038
	20150402	15985	15960	15940	16065	15930	16030	16005	70	45	16842	134,813.43	44694
	20150403	16030	16005	16080	16210	16055	16180	16150	175	145	27208	219,729.77	51224
	20150407	16180	16150	16180	16270	16160	16250	16225	100	75	13996	113,554.29	54192
	20150408	16250	16225	16270	16325	16165	16210	16240	-15	15	23032	187,043.31	55580
	20150409	16210	16240	16225	16255	16130	16190	16190	-50	-50	16124	130,529.40	55820
	20150410	16190	16190	16230	16405	16225	16395	16300	205	110	41172	335,634.78	61510
	20150413	16395	16300	16385	16500	16365	16490	16430	190	130	41098	337,718.82	66550
	20150414	16490	16430	16500	16515	16280	16355	16380	-75	-50	43682	357,862.90	64994
	20150415	16355	16380	16375	16505	16325	16455	16405	75	25	58754	482,075.61	80792
	20150416	16455	16405	16435	16625	16415	16595	16570	190	165	70404	583,412.95	86440
	20150417	16595	16570	16675	16775	16575	16660	16675	90	105	70174	585,198.78	94028
	20150420	16660	16675	16620	16745	16480	16500	16590	-175	-85	65654	544,659.42	87012
	20150421	16500	16590	16470	16545	16370	16450	16450	-140	-140	62118	510,949.23	89642
	20150422	16450	16450	16450	16625	16445	16590	16555	140	105	58326	482,806.74	100088
	20150423	16590	16555	16655	16680	16455	16590	16585	35	30	74896	621,095.09	104306
	20150424	16590	16585	16570	16615	16505	16595	16550	10	-35	55146	456,451.53	106192
	20150427	16595	16550	16670	16905	16610	16810	16765	260	215	155364	1,302,560.12	133190
	20150428	16810	16765	16860	17150	16855	17015	16995	250	230	175154	1,488,442.96	144450
	20150429	17015	16995	17000	17070	16760	16860	16955	-135	-40	140410	1,190,636.45	141094
	20150430	16860	16955	16870	17110	16820	17000	16990	45	35	196162	1,666,792.40	154842
zn1508	20150105	16725	16640	16720	16830	16620	16730	16730	90	90	34	284.45	294
	20150106	16730	16730	16555	16695	16555	16685	16640	-45	-90	24	199.69	294
	20150107	16685	16640	16685	16685	16570	16570	16610	-70	-30	38	315.65	290
	20150108	16570	16610	16530	16530	16300	16415	16455	-195	-155	86	707.69	316
	20150109	16415	16455	16495	16500	16365	16445	16420	-10	-35	68	558.44	312
	20150112	16445	16420	16445	16445	16355	16360	16395	-60	-25	18	147.56	316
	20150113	16360	16395	16195	16300	16180	16180	16225	-215	-170	132	1,071.04	304
	20150114	16180	16225	16105	16105	15510	15580	15780	-645	-445	228	1,799.47	390
	20150115	15580	15780	15645	15845	15645	15840	15755	60	-25	88	693.36	390
	20150116	15840	15755	15820	15845	15670	15730	15745	-25	-10	16	125.99	390
	20150119	15730	15745	15845	15995	15845	15995	15955	250	210	108	861.71	398
	20150120	15995	15955	15930	16025	15900	15955	15940	0	-15	24	191.32	390
	20150121	15955	15940	15970	16060	15970	16030	15995	90	55	68	543.98	428
	20150122	16030	15995	16010	16300	16010	16245	16130	250	135	94	758.13	446
	20150123	16245	16130	16305	16330	16210	16235	16280	105	150	54	439.58	436
	20150126	16235	16280	16100	16100	15900	15975	16000	-305	-280	50	400.09	466
	20150127	15975	16000	16230	16285	16145	16190	16210	190	210	40	324.20	462
	20150128	16190	16210	16220	16240	16190	16235	16220	25	10	34	275.82	488
	20150129	16235	16220	16200	16200	16095	16095	16110	-125	-110	32	257.76	498
	20150130	16095	16110	16040	16045	15955	15980	16015	-130	-95	352	2,819.40	670
	20150202	15980	16015	16055	16110	16055	16110	16075	95	60	22	176.86	664
	20150203	16110	16075	16090	16230	16090	16220	16190	145	115	16	129.54	666
	20150204	16220	16190	16315	16350	16255	16305	16315	115	125	210	1,713.22	758
	20150205	16305	16315	16250	16310	16210	16235	16245	-80	-70	66	536.20	740
	20150206	16235	16245	16210	16330	16210	16330	16295	85	50	32	260.75	756
	20150209	16330	16295	16395	16395	16300	16320	16325	25	30	60	489.81	754
	20150210	16320	16325	16430	16430	16360	16390	16380	65	55	50	409.58	744
	20150211	16390	16380	16295	16295	16160	16160	16250	-220	-130	134	1,088.77	714
	20150212	16160	16250	16185	16185	16120	16160	16145	-90	-105	8	64.59	710
	20150213	16160	16145	16235	16330	16235	16295	16300	150	155	58	472.79	668
	20150216	16295	16300	16360	16385	16310	16350	16350	50	50	32	261.63	666
	20150217	16350	16350	16355	16400	16300	16300	16355	-50	5	8	65.44	664
	20150225	16300	16355	16000	16050	15990	16025	16040	-330	-315	108	866.31	752
	20150226	16025	16040	16010	16055	15940	15990	15995	-50	-45	330	2,639.84	948
	20150227	15990	15995	16030	16085	15960	16010	16005	15	10	432	3,457.30	1110
	20150302	16010	16005	16030	16170	15980	16130	16095	125	90	266	2,141.19	1224
	20150303	16130	16095	16070	16080	15950	15955	16025	-140	-70	200	1,602.95	1310
	20150304	15955	16025	15900	15950	15850	15850	15900	-175	-125	414	3,291.75	1520
	20150305	15850	15900	15905	15905	15790	15800	15815	-100	-85	140	1,107.13	1548
	20150306	15800	15815	15780	15870	15680	15715	15755	-100	-60	228	1,796.18	1622
	20150309	15715	15755	15680	15820	15665	15730	15705	-25	-50	190	1,492.41	1712
	20150310	15730	15705	15735	15810	15705	15750	15760	45	55	104	819.75	1706
	20150311	15750	15760	15690	15740	15655	15685	15695	-75	-65	290	2,275.97	1788
	20150312	15685	15695	15735	15735	15575	15710	15645	15	-50	598	4,679.22	1946
	20150313	15710	15645	15720	15735	15625	15730	15685	85	40	1062	8,329.14	2386
	20150316	15730	15685	15685	15805	15635	15800	15755	115	70	1998	15,742.22	3162
	20150317	15800	15755	15730	15780	15645	15685	15715	-70	-40	554	4,353.28	3384
	20150318	15685	15715	15620	15695	15600	15610	15650	-105	-65	650	5,087.07	3528
	20150319	15610	15650	15635	15670	15520	15640	15615	-10	-35	590	4,606.48	3596
	20150320	15640	15615	15660	15685	15615	15655	15645	40	30	1568	12,267.86	4520
	20150323	15655	15645	15700	15920	15690	15850	15810	205	165	1096	8,664.96	4648
	20150324	15850	15810	15930	16025	15885	15930	15945	120	135	3360	26,795.07	5678
	20150325	15930	15945	15945	16010	15890	15930	15950	-15	5	952	7,594.56	5714
	20150326	15930	15950	15945	16035	15945	15995	15995	45	45	828	6,623.11	5778
	20150327	15995	15995	16085	16115	15945	15965	15985	-30	-10	2662	21,282.58	6546
	20150330	15965	15985	15990	16050	15975	15985	16000	0	15	1954	15,635.92	7302
	20150331	15985	16000	16025	16115	16020	16020	16075	20	75	1936	15,560.90	8140
	20150401	16020	16075	15955	16040	15940	15990	15970	-85	-105	1728	13,798.11	8540
	20150402	15990	15970	15970	16080	15965	16055	16020	85	50	2252	18,041.83	9074
	20150403	16055	16020	16150	16235	16080	16185	16165	165	145	2060	16,650.74	9396
	20150407	16185	16165	16225	16285	16205	16265	16250	100	85	1330	10,807.23	9854
	20150408	16265	16250	16295	16340	16190	16240	16260	-10	10	2070	16,831.60	10002
	20150409	16240	16260	16260	16275	16155	16195	16195	-65	-65	1726	13,979.72	10472
	20150410	16195	16195	16260	16420	16245	16420	16315	225	120	6580	53,684.32	13854
	20150413	16420	16315	16420	16515	16380	16510	16450	195	135	5866	48,262.14	15876
	20150414	16510	16450	16510	16540	16305	16380	16420	-70	-30	3902	32,043.88	16848
	20150415	16380	16420	16370	16520	16350	16475	16430	55	10	6178	50,765.43	19692
	20150416	16475	16430	16450	16650	16440	16615	16615	185	185	13130	109,088.01	23596
	20150417	16615	16615	16690	16800	16610	16685	16700	70	85	11584	96,732.33	28730
	20150420	16685	16700	16635	16770	16500	16510	16605	-190	-95	9012	74,840.24	29384
	20150421	16510	16605	16475	16550	16385	16450	16460	-155	-145	12170	100,160.00	30946
	20150422	16450	16460	16400	16635	16400	16590	16565	130	105	11398	94,425.34	34534
	20150423	16590	16565	16715	16715	16470	16605	16610	40	45	12528	104,065.63	36230
	20150424	16605	16610	16585	16630	16530	16610	16570	0	-40	8454	70,048.61	37034
	20150427	16610	16570	16695	16925	16640	16830	16800	260	230	27178	228,323.36	43702
	20150428	16830	16800	16895	17170	16890	17025	17010	225	210	28420	241,741.86	50280
	20150429	17025	17010	17005	17085	16630	16885	16975	-125	-35	21664	183,902.92	53024
	20150430	16885	16975	16900	17125	16845	17040	17015	65	40	26584	226,196.91	59168
zn1509	20150105	16710	16705	16710	16885	16710	16810	16815	105	110	46	386.82	94
	20150106	16810	16815	16720	16720	16720	16720	16720	-95	-95	6	50.16	96
	20150107	16720	16720	16715	16715	16595	16595	16655	-125	-65	6	49.97	92
	20150108	16595	16655	16530	16530	16445	16450	16485	-205	-170	28	230.82	100
	20150109	16450	16485	16485	16485	16385	16440	16415	-45	-70	62	508.97	120
	20150112	16440	16415	16595	16595	16330	16345	16420	-70	5	18	147.78	118
	20150113	16345	16420	16185	16315	16170	16175	16230	-245	-190	46	373.34	124
	20150114	16175	16230	16000	16000	15500	15590	15710	-640	-520	148	1,162.70	164
	20150115	15590	15710	15640	15815	15640	15815	15730	105	20	26	204.55	162
	20150116	15815	15730	15770	15770	15770	15770	15770	40	40	4	31.54	164
	20150119	15770	15770	15865	15970	15865	15970	15920	200	150	18	143.30	176
	20150120	15970	15920	15960	16025	15925	15985	15965	65	45	10	79.83	174
	20150121	15985	15965	16000	16105	16000	16050	16060	85	95	32	257.03	172
	20150122	16050	16060	16035	16375	16035	16310	16175	250	115	20	161.76	170
	20150123	16310	16175	16280	16280	16280	16280	16280	105	105	2	16.28	168
	20150126	16280	16280	16135	16135	15900	15900	16005	-380	-275	30	240.09	172
	20150127	15900	16005	16140	16305	16140	16305	16215	300	210	8	64.87	170
	20150128	16305	16215	16230	16315	16215	16270	16245	55	30	28	227.45	180
	20150129	16270	16245	16230	16230	16100	16125	16155	-120	-90	10	80.79	180
	20150130	16125	16155	16065	16080	16000	16000	16050	-155	-105	22	176.59	194
	20150202	16000	16050	16150	16150	16080	16140	16105	90	55	16	128.88	198
	20150203	16140	16105	16140	16250	16140	16210	16205	105	100	26	210.71	182
	20150204	16210	16205	16295	16385	16270	16340	16325	135	120	36	293.90	182
	20150205	16340	16325	16220	16335	16220	16220	16250	-105	-75	42	341.31	198
	20150206	16220	16250	16215	16345	16215	16345	16275	95	25	12	97.67	190
	20150209	16345	16275	16375	16375	16355	16355	16365	80	90	4	32.73	188
	20150210	16355	16365				16420	16420	55	55	0	0.00	188
	20150211	16420	16420	16280	16280	16190	16190	16235	-230	-185	4	32.47	188
	20150212	16190	16235	16180	16180	16180	16180	16180	-55	-55	4	32.36	186
	20150213	16180	16180				16335	16335	155	155	0	0.00	186
	20150216	16335	16335	16385	16385	16365	16365	16375	30	40	22	180.17	182
	20150217	16365	16375				16380	16380	5	5	0	0.00	182
	20150225	16380	16380	16050	16050	16050	16050	16050	-330	-330	4	32.10	182
	20150226	16050	16050	15980	16045	15980	16045	16010	-5	-40	4	32.03	182
	20150227	16045	16010	16075	16100	15995	16080	16025	70	15	52	416.75	212
	20150302	16080	16025	16135	16175	16135	16175	16160	150	135	20	161.60	210
	20150303	16175	16160	16050	16050	15990	15990	16025	-170	-135	20	160.25	220
	20150304	15990	16025	15880	15925	15875	15915	15900	-110	-125	18	143.14	220
	20150305	15915	15900	15900	15900	15800	15800	15840	-100	-60	12	95.05	230
	20150306	15800	15840	15815	15845	15710	15710	15775	-130	-65	16	126.22	236
	20150309	15710	15775	15725	15725	15725	15725	15725	-50	-50	2	15.73	236
	20150310	15725	15725	15810	15815	15760	15765	15785	40	60	32	252.63	238
	20150311	15765	15785				15785	15785	0	0	0	0.00	238
	20150312	15785	15785	15750	15760	15630	15745	15710	-40	-75	254	1,995.68	364
	20150313	15745	15710	15740	15745	15660	15720	15700	10	-10	384	3,015.18	620
	20150316	15720	15700	15710	15845	15660	15845	15780	145	80	112	883.72	678
	20150317	15845	15780	15780	15795	15670	15675	15695	-105	-85	286	2,244.55	744
	20150318	15675	15695	15610	15710	15610	15655	15670	-40	-25	348	2,726.83	844
	20150319	15655	15670	15645	15695	15525	15625	15620	-45	-50	574	4,483.49	1224
	20150320	15625	15620	15650	15710	15640	15660	15670	40	50	74	579.82	1258
	20150323	15660	15670	15730	15930	15730	15860	15865	190	195	546	4,331.98	1576
	20150324	15860	15865	15950	16050	15900	15930	15965	65	100	640	5,109.42	1942
	20150325	15930	15965	15920	16000	15920	15945	15970	-20	5	276	2,203.89	2040
	20150326	15945	15970	16000	16095	15990	16015	16010	45	40	162	1,297.19	2070
	20150327	16015	16010	16105	16130	15965	15980	16015	-30	5	610	4,884.65	2320
	20150330	15980	16015	16010	16070	15990	16000	16020	-15	5	538	4,310.52	2590
	20150331	16000	16020	16080	16120	16050	16050	16095	30	75	182	1,464.83	2654
	20150401	16050	16095	15975	16020	15950	15995	15990	-100	-105	384	3,070.69	2816
	20150402	15995	15990	16040	16095	15995	16050	16045	60	55	294	2,358.65	2958
	20150403	16050	16045	16075	16245	16075	16205	16195	160	150	242	1,959.99	2994
	20150407	16205	16195	16230	16290	16230	16280	16270	85	75	182	1,480.63	3086
	20150408	16280	16270	16320	16365	16220	16250	16280	-20	10	264	2,149.32	3124
	20150409	16250	16280	16290	16290	16175	16175	16215	-105	-65	268	2,172.89	3310
	20150410	16175	16215	16270	16430	16270	16415	16335	200	120	218	1,780.75	3392
	20150413	16415	16335	16460	16545	16405	16530	16470	195	135	254	2,091.98	3440
	20150414	16530	16470	16550	16565	16330	16385	16420	-85	-50	400	3,284.95	3524
	20150415	16385	16420	16430	16550	16390	16505	16475	85	55	464	3,822.71	3728
	20150416	16505	16475	16520	16675	16470	16640	16630	165	155	918	7,633.81	3844
	20150417	16640	16630	16800	16825	16640	16720	16715	90	85	2536	21,199.77	4520
	20150420	16720	16715	16670	16785	16530	16540	16640	-175	-75	1154	9,603.24	4810
	20150421	16540	16640	16505	16570	16405	16500	16470	-140	-170	2374	19,554.55	5858
	20150422	16500	16470	16490	16650	16490	16620	16585	150	115	1430	11,859.05	6164
	20150423	16620	16585	16680	16715	16500	16645	16665	60	80	4154	34,613.59	7118
	20150424	16645	16665	16645	16655	16565	16640	16595	-25	-70	2240	18,588.46	8272
	20150427	16640	16595	16675	16945	16675	16855	16810	260	215	7752	65,165.42	9196
	20150428	16855	16810	16940	17185	16930	17030	17020	220	210	10452	88,947.14	13570
	20150429	17030	17020	17050	17125	16810	16895	17010	-125	-10	4950	42,101.59	14388
	20150430	16895	17010	16890	17145	16870	17055	17040	45	30	6616	56,381.63	16924
zn1510	20150105	16710	16630	16890	16890	16640	16755	16730	125	100	22	184.08	112
	20150106	16755	16730				16730	16730	0	0	0	0.00	112
	20150107	16730	16730	16695	16695	16630	16630	16660	-100	-70	4	33.33	114
	20150108	16630	16660	16505	16520	16415	16430	16455	-230	-205	28	230.39	120
	20150109	16430	16455	16535	16535	16400	16440	16440	-15	-15	34	279.48	128
	20150112	16440	16440	16410	16410	16400	16400	16405	-40	-35	6	49.22	122
	20150113	16400	16405	16230	16365	16200	16200	16235	-205	-170	74	600.87	168
	20150114	16200	16235	16055	16085	15500	15600	15785	-635	-450	496	3,915.77	434
	20150115	15600	15785	15675	15865	15635	15855	15770	70	-15	92	725.48	430
	20150116	15855	15770	15855	15895	15735	15785	15795	15	25	30	236.94	418
	20150119	15785	15795	15860	16015	15860	15995	15925	200	130	34	270.78	414
	20150120	15995	15925	16040	16040	15995	16000	16005	75	80	10	80.03	406
	20150121	16000	16005	16060	16105	16050	16090	16065	85	60	22	176.76	400
	20150122	16090	16065	16045	16370	16045	16370	16300	305	235	26	211.92	376
	20150123	16370	16300	16375	16375	16115	16115	16240	-185	-60	18	146.16	376
	20150126	16115	16240	16080	16095	15900	16030	16020	-210	-220	62	496.62	390
	20150127	16030	16020	16105	16310	16105	16220	16240	200	220	26	211.16	376
	20150128	16220	16240	16255	16295	16230	16295	16260	55	20	6	48.78	374
	20150129	16295	16260	16150	16190	16130	16135	16160	-125	-100	26	210.10	378
	20150130	16135	16160	16070	16085	15985	15985	16050	-175	-110	24	192.61	382
	20150202	15985	16050	16200	16200	16200	16200	16200	150	150	24	194.40	368
	20150203	16200	16200	16165	16215	16165	16215	16195	15	-5	8	64.79	366
	20150204	16215	16195	16350	16400	16290	16295	16320	100	125	154	1,256.78	358
	20150205	16295	16320	16300	16300	16255	16255	16265	-65	-55	8	65.07	360
	20150206	16255	16265	16230	16350	16230	16350	16295	85	30	32	260.73	338
	20150209	16350	16295	16350	16355	16350	16355	16350	60	55	12	98.13	346
	20150210	16355	16350	16350	16370	16350	16370	16360	20	10	20	163.60	344
	20150211	16370	16360	16270	16270	16260	16260	16265	-100	-95	6	48.80	344
	20150212	16260	16265	16180	16180	16175	16175	16175	-90	-90	22	177.98	344
	20150213	16175	16175	16255	16350	16255	16325	16315	150	140	72	587.43	348
	20150216	16325	16315	16375	16430	16375	16430	16400	115	85	62	508.52	368
	20150217	16430	16400	16400	16425	16400	16400	16410	0	10	10	82.06	360
	20150225	16400	16410	16035	16160	16035	16060	16075	-350	-335	22	176.83	348
	20150226	16060	16075	16055	16055	16000	16050	16040	-25	-35	26	208.57	368
	20150227	16050	16040	16025	16025	16025	16025	16025	-15	-15	4	32.05	366
	20150302	16025	16025	16075	16205	16055	16175	16110	150	85	22	177.24	362
	20150303	16175	16110	16055	16055	16055	16055	16055	-55	-55	10	80.28	368
	20150304	16055	16055	15915	16020	15890	15940	15935	-115	-120	26	207.17	372
	20150305	15940	15935	15900	15900	15830	15855	15870	-80	-65	52	412.63	406
	20150306	15855	15870	15845	15870	15770	15770	15805	-100	-65	48	379.42	426
	20150309	15770	15805	15765	15765	15730	15730	15740	-75	-65	16	125.93	434
	20150310	15730	15740	15855	15875	15790	15790	15845	50	105	22	174.32	428
	20150311	15790	15845	15725	15820	15720	15770	15780	-75	-65	458	3,614.27	702
	20150312	15770	15780	15760	15770	15655	15770	15700	-10	-80	82	643.70	708
	20150313	15770	15700	15770	15770	15685	15760	15735	60	35	58	456.32	720
	20150316	15760	15735	15695	15850	15680	15820	15795	85	60	52	410.78	758
	20150317	15820	15795	15755	15755	15700	15740	15720	-55	-75	118	927.76	830
	20150318	15740	15720	15685	15760	15670	15670	15685	-50	-35	518	4,063.36	1242
	20150319	15670	15685	15705	15740	15580	15675	15670	-10	-15	210	1,645.49	1390
	20150320	15675	15670	15690	15750	15690	15715	15720	45	50	66	518.89	1400
	20150323	15715	15720	15875	16005	15830	15940	15910	220	190	520	4,137.07	1420
	20150324	15940	15910	16005	16120	15950	16000	16025	90	115	1022	8,191.21	1948
	20150325	16000	16025	16010	16035	15985	16010	16010	-15	-15	82	656.61	1982
	20150326	16010	16010	16055	16100	16035	16100	16075	90	65	36	289.43	1992
	20150327	16100	16075	16115	16180	16000	16035	16045	-40	-30	166	1,331.81	2108
	20150330	16035	16045	16075	16100	16065	16075	16075	30	30	60	482.29	2130
	20150331	16075	16075	16150	16150	16120	16125	16130	50	55	58	467.83	2142
	20150401	16125	16130	16010	16060	16010	16035	16030	-95	-100	248	1,988.30	2166
	20150402	16035	16030	16115	16120	16080	16080	16095	50	65	30	241.49	2162
	20150403	16080	16095	16140	16280	16140	16250	16225	155	130	120	973.75	2162
	20150407	16250	16225	16320	16330	16290	16320	16310	95	85	100	815.62	2142
	20150408	16320	16310	16350	16385	16285	16285	16340	-25	30	70	572.06	2120
	20150409	16285	16340	16300	16320	16230	16230	16260	-110	-80	158	1,284.72	2226
	20150410	16230	16260	16360	16460	16320	16460	16375	200	115	106	867.92	2258
	20150413	16460	16375	16515	16570	16480	16570	16515	195	140	48	396.45	2246
	20150414	16570	16515	16550	16550	16395	16445	16430	-70	-85	88	723.01	2256
	20150415	16445	16430	16430	16575	16430	16550	16505	120	75	90	742.80	2282
	20150416	16550	16505	16655	16710	16655	16690	16675	185	170	228	1,901.35	2276
	20150417	16690	16675	16840	16840	16680	16745	16795	70	120	382	3,208.51	2226
	20150420	16745	16795	16695	16795	16580	16590	16665	-205	-130	146	1,216.80	2250
	20150421	16590	16665	16570	16600	16450	16530	16515	-135	-150	504	4,162.42	2300
	20150422	16530	16515	16530	16670	16525	16670	16620	155	105	354	2,941.98	2326
	20150423	16670	16620	16700	16730	16550	16670	16645	50	25	390	3,246.28	2400
	20150424	16670	16645	16640	16690	16600	16690	16630	45	-15	582	4,839.78	2712
	20150427	16690	16630	16700	16960	16700	16895	16865	265	235	1152	9,714.58	2876
	20150428	16895	16865	16955	17200	16955	17050	17025	185	160	2104	17,913.23	3612
	20150429	17050	17025	17055	17100	16905	16940	17040	-85	15	616	5,249.09	3782
	20150430	16940	17040	16970	17160	16970	17060	17065	20	25	652	5,564.54	4012
zn1511	20150105	16795	16650	16840	16930	16695	16695	16820	45	170	38	319.67	388
	20150106	16695	16820	16605	16760	16605	16715	16670	-105	-150	110	916.91	424
	20150107	16715	16670	16700	16715	16620	16645	16670	-25	0	26	216.73	432
	20150108	16645	16670	16540	16595	16450	16475	16495	-195	-175	42	346.40	432
	20150109	16475	16495	16525	16525	16430	16465	16455	-30	-40	42	345.63	424
	20150112	16465	16455	16505	16505	16405	16405	16430	-50	-25	36	295.83	406
	20150113	16405	16430	16290	16355	16170	16170	16265	-260	-165	106	862.27	426
	20150114	16170	16265	16080	16085	15525	15620	15870	-645	-395	220	1,746.02	426
	20150115	15620	15870	15700	15910	15650	15845	15810	-25	-60	26	205.56	434
	20150116	15845	15810	15885	15885	15730	15820	15805	10	-5	38	300.35	434
	20150119	15820	15805	15855	16105	15855	16030	15970	225	165	60	479.11	422
	20150120	16030	15970	16030	16030	15980	15995	16000	25	30	22	176.02	426
	20150121	15995	16000	16065	16090	16055	16090	16060	90	60	10	80.32	430
	20150122	16090	16060	16065	16385	16065	16385	16230	325	170	22	178.53	428
	20150123	16385	16230	16400	16400	16220	16235	16285	5	55	6	48.86	428
	20150126	16235	16285	16235	16235	15925	16050	16105	-235	-180	28	225.52	422
	20150127	16050	16105	16170	16335	16170	16275	16275	170	170	30	244.16	424
	20150128	16275	16275	16280	16370	16240	16305	16285	30	10	38	309.42	430
	20150129	16305	16285	16170	16170	16115	16115	16145	-170	-140	12	96.89	430
	20150130	16115	16145	16050	16070	16020	16020	16055	-125	-90	34	273.00	444
	20150202	16020	16055	16135	16220	16115	16170	16150	115	95	16	129.22	448
	20150203	16170	16150	16160	16260	16155	16260	16180	110	30	8	64.74	446
	20150204	16260	16180	16275	16450	16275	16315	16350	135	170	26	212.61	454
	20150205	16315	16350	16235	16280	16235	16265	16250	-85	-100	20	162.51	444
	20150206	16265	16250	16190	16355	16190	16355	16265	105	15	12	97.60	442
	20150209	16355	16265	16345	16345	16330	16330	16335	65	70	6	49.01	442
	20150210	16330	16335				16335	16335	0	0	0	0.00	442
	20150211	16335	16335	16295	16330	16220	16240	16280	-95	-55	16	130.24	450
	20150212	16240	16280	16210	16230	16145	16145	16195	-135	-85	8	64.79	450
	20150213	16145	16195	16330	16430	16330	16385	16375	190	180	8	65.52	446
	20150216	16385	16375	16395	16405	16390	16390	16395	15	20	8	65.59	444
	20150217	16390	16395	16340	16350	16340	16350	16345	-45	-50	4	32.69	442
	20150225	16350	16345	16075	16130	16055	16080	16065	-265	-280	22	176.76	450
	20150226	16080	16065	16010	16075	16000	16075	16045	10	-20	32	256.74	468
	20150227	16075	16045	16060	16060	16000	16005	16010	-40	-35	12	96.08	470
	20150302	16005	16010	16065	16190	16015	16130	16105	120	95	20	161.06	466
	20150303	16130	16105	16125	16125	16055	16055	16105	-50	0	14	112.75	474
	20150304	16055	16105	15935	15975	15890	15925	15945	-180	-160	46	366.79	504
	20150305	15925	15945	15895	15920	15775	15775	15865	-170	-80	26	206.31	492
	20150306	15775	15865	15810	15895	15750	15750	15785	-115	-80	52	410.54	526
	20150309	15750	15785	15765	15850	15730	15850	15780	65	-5	18	142.04	526
	20150310	15850	15780	15835	15835	15835	15835	15835	55	55	2	15.84	528
	20150311	15835	15835	15740	15815	15730	15760	15780	-75	-55	106	836.37	566
	20150312	15760	15780	15740	15740	15595	15695	15670	-85	-110	88	689.63	612
	20150313	15695	15670	15750	15850	15715	15785	15760	115	90	52	409.80	630
	20150316	15785	15760	15725	15935	15720	15860	15830	100	70	62	490.83	636
	20150317	15860	15830	15805	15830	15710	15770	15765	-60	-65	52	410.02	676
	20150318	15770	15765	15670	15780	15670	15745	15720	-20	-45	108	848.90	730
	20150319	15745	15720	15590	15750	15590	15735	15675	15	-45	350	2,743.80	990
	20150320	15735	15675	15725	15770	15725	15755	15745	80	70	18	141.72	1002
	20150323	15755	15745	15850	15990	15850	15915	15945	170	200	178	1,419.47	1006
	20150324	15915	15945	16045	16155	15995	15995	16050	50	105	248	1,990.37	1006
	20150325	15995	16050	16060	16100	16025	16045	16055	-5	5	308	2,472.77	1148
	20150326	16045	16055	16095	16125	16070	16125	16100	70	45	22	177.12	1156
	20150327	16125	16100	16185	16200	16045	16055	16130	-45	30	64	516.30	1156
	20150330	16055	16130	16105	16105	16105	16105	16105	-25	-25	2	16.11	1156
	20150331	16105	16105	16170	16170	16155	16155	16165	50	60	6	48.50	1152
	20150401	16155	16165	16070	16085	16070	16085	16075	-80	-90	44	353.74	1188
	20150402	16085	16075				16115	16115	40	40	0	0.00	1188
	20150403	16115	16115	16275	16305	16240	16240	16275	125	160	40	325.53	1186
	20150407	16240	16275	16340	16360	16300	16345	16340	70	65	24	196.13	1190
	20150408	16345	16340	16400	16440	16335	16335	16395	-5	55	34	278.77	1190
	20150409	16335	16395	16340	16345	16255	16255	16295	-140	-100	76	619.22	1236
	20150410	16255	16295	16365	16450	16360	16450	16395	155	100	68	557.55	1258
	20150413	16450	16395	16500	16590	16485	16565	16515	170	120	68	561.61	1294
	20150414	16565	16515	16630	16630	16420	16460	16495	-55	-20	76	626.92	1340
	20150415	16460	16495	16490	16520	16465	16520	16480	25	-15	76	626.39	1372
	20150416	16520	16480	16600	16725	16585	16685	16635	205	155	214	1,780.45	1466
	20150417	16685	16635	16830	16830	16710	16770	16795	135	160	516	4,334.19	1832
	20150420	16770	16795	16705	16785	16590	16590	16630	-205	-165	412	3,426.61	1616
	20150421	16590	16630	16585	16595	16475	16570	16555	-60	-75	220	1,821.16	1558
	20150422	16570	16555	16615	16700	16615	16700	16635	145	80	22	183.03	1554
	20150423	16700	16635	16745	16780	16580	16705	16710	70	75	98	818.81	1584
	20150424	16705	16710	16645	16685	16640	16640	16660	-70	-50	86	716.56	1638
	20150427	16640	16660	16795	17000	16780	16995	16870	335	210	208	1,754.74	1720
	20150428	16995	16870	17080	17200	17000	17015	17060	145	190	358	3,054.54	1892
	20150429	17015	17060	17075	17090	16925	16925	17045	-135	-15	36	306.82	1888
	20150430	16925	17045	17035	17145	17015	17100	17090	55	45	266	2,273.32	2034
zn1512	20150105	16865	16800	16870	17020	16760	16835	16895	35	95	42	354.84	62
	20150106	16835	16895	16760	16775	16705	16755	16745	-140	-150	24	200.94	80
	20150107	16755	16745	16740	16740	16660	16665	16695	-80	-50	24	200.38	82
	20150108	16665	16695	16580	16580	16480	16505	16505	-190	-190	44	363.22	92
	20150109	16505	16505	16535	16535	16440	16450	16455	-55	-50	24	197.50	102
	20150112	16450	16455	16530	16530	16530	16530	16530	75	75	2	16.53	100
	20150113	16530	16530	16335	16370	16235	16235	16305	-295	-225	10	81.55	100
	20150114	16235	16305	16070	16100	15530	15625	15835	-680	-470	186	1,472.90	168
	20150115	15625	15835	15670	15845	15555	15845	15735	10	-100	26	204.59	160
	20150116	15845	15735	15890	15890	15760	15760	15790	25	55	16	126.34	146
	20150119	15760	15790	15880	16080	15870	16010	15915	220	125	76	604.95	136
	20150120	16010	15915	16000	16035	15965	16010	15990	95	75	14	111.96	148
	20150121	16010	15990	16125	16255	16110	16185	16160	195	170	16	129.30	142
	20150122	16185	16160	16100	16445	16100	16435	16250	275	90	38	308.82	132
	20150123	16435	16250	16280	16335	16280	16335	16310	85	60	6	48.93	130
	20150126	16335	16310	16160	16160	16040	16040	16090	-270	-220	8	64.36	128
	20150127	16040	16090	16180	16290	16180	16290	16240	200	150	6	48.73	128
	20150128	16290	16240				16240	16240	0	0	0	0.00	128
	20150129	16240	16240				16240	16240	0	0	0	0.00	128
	20150130	16240	16240	16050	16070	16050	16070	16055	-170	-185	14	112.39	138
	20150202	16070	16055	16175	16175	16175	16175	16175	120	120	4	32.35	138
	20150203	16175	16175	16235	16290	16235	16290	16250	115	75	8	65.02	132
	20150204	16290	16250	16345	16390	16345	16345	16365	95	115	22	180.07	144
	20150205	16345	16365	16305	16305	16265	16265	16285	-100	-80	4	32.57	144
	20150206	16265	16285	16265	16325	16265	16325	16295	40	10	6	48.89	146
	20150209	16325	16295	16425	16425	16370	16370	16395	75	100	4	32.80	144
	20150210	16370	16395	16385	16390	16385	16390	16385	-5	-10	4	32.78	146
	20150211	16390	16385	16300	16300	16240	16240	16275	-145	-110	6	48.83	146
	20150212	16240	16275	16205	16205	16205	16205	16205	-70	-70	2	16.21	146
	20150213	16205	16205	16340	16340	16340	16340	16340	135	135	2	16.34	144
	20150216	16340	16340	16390	16405	16365	16405	16390	65	50	14	114.75	146
	20150217	16405	16390	16425	16425	16350	16350	16390	-40	0	10	81.96	142
	20150225	16350	16390	16080	16175	16000	16095	16080	-295	-310	36	289.46	148
	20150226	16095	16080	16055	16055	16055	16055	16055	-25	-25	4	32.11	148
	20150227	16055	16055	16045	16045	16045	16045	16045	-10	-10	2	16.05	150
	20150302	16045	16045	16075	16080	16075	16080	16075	35	30	4	32.16	146
	20150303	16080	16075				16075	16075	0	0	0	0.00	146
	20150304	16075	16075	15965	16015	15930	15930	15970	-145	-105	6	47.91	150
	20150305	15930	15970	15910	15915	15780	15820	15860	-150	-110	40	317.22	144
	20150306	15820	15860	15890	15895	15790	15790	15850	-70	-10	16	126.82	152
	20150309	15790	15850	15755	15755	15755	15755	15755	-95	-95	2	15.76	152
	20150310	15755	15755				15755	15755	0	0	0	0.00	152
	20150311	15755	15755	15750	15840	15740	15830	15775	75	20	24	189.31	152
	20150312	15830	15775	15740	15795	15670	15795	15720	20	-55	22	172.95	156
	20150313	15795	15720	15775	15810	15775	15795	15785	75	65	32	252.59	160
	20150316	15795	15785	15875	15890	15860	15860	15870	75	85	16	126.97	154
	20150317	15860	15870	15760	15790	15760	15790	15780	-80	-90	6	47.34	158
	20150318	15790	15780	15700	15735	15700	15725	15730	-55	-50	26	204.49	176
	20150319	15725	15730	15760	15800	15690	15755	15730	25	0	82	644.95	234
	20150320	15755	15730	15770	15800	15765	15765	15785	35	55	24	189.46	240
	20150323	15765	15785	15795	16000	15790	16000	15910	215	125	68	541.08	244
	20150324	16000	15910	16060	16180	16040	16040	16100	130	190	56	450.84	278
	20150325	16040	16100	16105	16140	16040	16040	16095	-60	-5	80	643.84	306
	20150326	16040	16095	16110	16150	16110	16150	16130	55	35	20	161.30	326
	20150327	16150	16130	16200	16200	16055	16060	16105	-70	-25	34	273.86	338
	20150330	16060	16105	16130	16130	16130	16130	16130	25	25	6	48.39	338
	20150331	16130	16130	16145	16245	16125	16125	16210	-5	80	106	859.15	326
	20150401	16125	16210	16095	16100	16085	16100	16095	-110	-115	24	193.14	326
	20150402	16100	16095	16215	16215	16165	16165	16180	70	85	28	226.58	322
	20150403	16165	16180	16210	16375	16210	16350	16310	170	130	34	277.32	332
	20150407	16350	16310				16310	16310	0	0	0	0.00	332
	20150408	16310	16310	16430	16430	16320	16320	16355	10	45	12	98.13	324
	20150409	16320	16355	16320	16320	16320	16320	16320	-35	-35	10	81.60	330
	20150410	16320	16320	16430	16485	16405	16485	16450	165	130	26	213.89	340
	20150413	16485	16450	16540	16600	16540	16600	16555	150	105	24	198.70	342
	20150414	16600	16555	16500	16500	16420	16475	16450	-80	-105	38	312.63	342
	20150415	16475	16450	16535	16625	16490	16625	16565	175	115	62	513.52	372
	20150416	16625	16565	16710	16745	16710	16715	16725	150	160	16	133.84	386
	20150417	16715	16725	16860	16860	16810	16830	16830	105	105	18	151.50	380
	20150420	16830	16830	16730	16770	16650	16650	16730	-180	-100	46	384.83	386
	20150421	16650	16730	16540	16620	16510	16570	16565	-160	-165	104	861.61	368
	20150422	16570	16565	16640	16710	16640	16705	16660	140	95	12	99.98	362
	20150423	16705	16660	16695	16780	16520	16740	16700	80	40	36	300.69	374
	20150424	16740	16700	16665	16665	16605	16605	16655	-95	-45	12	99.93	376
	20150427	16605	16655	16785	17010	16785	17010	16945	355	290	56	474.55	424
	20150428	17010	16945	17060	17190	17015	17050	17065	105	120	398	3,396.57	680
	20150429	17050	17065	17110	17115	16910	16955	17045	-110	-20	170	1,449.24	698
	20150430	16955	17045	17085	17200	17035	17125	17120	80	75	154	1,318.57	702
zn1601	20150116	15735	15735	15770	16105	15705	15710	15880	-25	145	30	238.23	4
	20150119	15710	15880	15930	16035	15915	16035	15980	155	100	12	95.89	12
	20150120	16035	15980	15995	16045	15995	16045	16020	65	40	4	32.04	12
	20150121	16045	16020	16090	16135	16090	16135	16120	115	100	14	112.85	16
	20150122	16135	16120	16365	16365	16365	16365	16365	245	245	2	16.37	18
	20150123	16365	16365				16425	16425	60	60	0	0.00	18
	20150126	16425	16425	16155	16155	16155	16155	16155	-270	-270	2	16.16	20
	20150127	16155	16155				16155	16155	0	0	0	0.00	20
	20150128	16155	16155				16155	16155	0	0	0	0.00	20
	20150129	16155	16155	16190	16190	16190	16190	16190	35	35	2	16.19	22
	20150130	16190	16190	16105	16105	16105	16105	16105	-85	-85	2	16.11	22
	20150202	16105	16105	16190	16190	16190	16190	16190	85	85	2	16.19	22
	20150203	16190	16190	16220	16300	16220	16300	16270	110	80	6	48.82	20
	20150204	16300	16270	16365	16555	16365	16415	16435	145	165	14	115.06	22
	20150205	16415	16435	16330	16340	16330	16340	16330	-95	-105	6	49.00	24
	20150206	16340	16330	16295	16335	16295	16335	16315	5	-15	4	32.63	26
	20150209	16335	16315				16315	16315	0	0	0	0.00	26
	20150210	16315	16315	16400	16450	16400	16400	16415	85	100	6	49.25	32
	20150211	16400	16415	16265	16265	16250	16250	16255	-165	-160	4	32.52	34
	20150212	16250	16255				16255	16255	0	0	0	0.00	34
	20150213	16255	16255				16390	16390	135	135	0	0.00	34
	20150216	16390	16390	16415	16425	16415	16425	16420	35	30	4	32.84	34
	20150217	16425	16420	16430	16455	16430	16450	16445	30	25	18	148.05	44
	20150225	16450	16445	16175	16175	16100	16110	16125	-335	-320	44	354.77	56
	20150226	16110	16125	16055	16110	16050	16080	16075	-45	-50	58	466.23	80
	20150227	16080	16075	16110	16110	16055	16090	16070	15	-5	48	385.75	112
	20150302	16090	16070	16105	16220	16105	16220	16145	150	75	22	177.60	116
	20150303	16220	16145	16160	16160	16110	16110	16130	-35	-15	14	112.93	122
	20150304	16110	16130	15970	16000	15920	15960	15960	-170	-170	16	127.71	124
	20150305	15960	15960	15950	15950	15845	15845	15880	-115	-80	16	127.06	122
	20150306	15845	15880	15820	15820	15790	15795	15795	-85	-85	14	110.60	124
	20150309	15795	15795	15800	15800	15770	15785	15780	-10	-15	12	94.70	132
	20150310	15785	15780				15805	15805	25	25	0	0.00	132
	20150311	15805	15805	15745	15745	15745	15745	15745	-60	-60	2	15.75	134
	20150312	15745	15745	15790	15795	15720	15745	15750	0	5	14	110.28	146
	20150313	15745	15750	15835	15835	15835	15835	15835	85	85	6	47.51	146
	20150316	15835	15835	15785	15885	15785	15885	15860	50	25	16	126.91	148
	20150317	15885	15860	15855	15865	15800	15865	15840	5	-20	10	79.22	150
	20150318	15865	15840	15790	15855	15780	15795	15810	-45	-30	22	173.93	166
	20150319	15795	15810	15785	15860	15750	15860	15775	50	-35	18	142.01	184
	20150320	15860	15775	15870	15870	15870	15870	15870	95	95	2	15.87	186
	20150323	15870	15870	15905	16020	15905	16005	15940	135	70	26	207.22	174
	20150324	16005	15940	16050	16175	16050	16050	16095	110	155	70	563.47	162
	20150325	16050	16095	16100	16115	16040	16100	16080	5	-15	30	241.20	178
	20150326	16100	16080	16170	16210	16165	16165	16190	85	110	12	97.14	176
	20150327	16165	16190	16210	16210	15990	16155	16120	-35	-70	16	128.96	168
	20150330	16155	16120	16145	16145	16135	16135	16140	15	20	4	32.28	166
	20150331	16135	16140				16140	16140	0	0	0	0.00	166
	20150401	16140	16140	16120	16120	16120	16120	16120	-20	-20	2	16.12	168
	20150402	16120	16120				16130	16130	10	10	0	0.00	168
	20150403	16130	16130				16235	16235	105	105	0	0.00	168
	20150407	16235	16235	16395	16395	16395	16395	16395	160	160	2	16.40	166
	20150408	16395	16395				16395	16395	0	0	0	0.00	166
	20150409	16395	16395	16265	16265	16265	16265	16265	-130	-130	2	16.27	166
	20150410	16265	16265	16430	16520	16425	16520	16455	255	190	6	49.38	164
	20150413	16520	16455	16610	16610	16585	16610	16595	155	140	8	66.40	164
	20150414	16610	16595	16480	16480	16465	16465	16475	-130	-120	6	49.43	166
	20150415	16465	16475	16560	16685	16485	16685	16555	210	80	36	298.06	190
	20150416	16685	16555	16735	16755	16720	16720	16740	165	185	10	83.70	192
	20150417	16720	16740	16805	16860	16805	16845	16840	105	100	12	101.04	186
	20150420	16845	16840	16770	16965	16660	16660	16800	-180	-40	16	134.42	186
	20150421	16660	16800	16620	16620	16605	16605	16610	-195	-190	18	149.53	182
	20150422	16605	16610	16745	16775	16660	16775	16720	165	110	34	284.27	190
	20150423	16775	16720	16780	16840	16700	16795	16780	75	60	16	134.26	198
	20150424	16795	16780	16750	16750	16695	16695	16730	-85	-50	18	150.57	210
	20150427	16695	16730	16795	17095	16795	16995	16970	265	240	104	882.46	236
	20150428	16995	16970	17090	17235	17010	17060	17120	90	150	196	1,677.93	254
	20150429	17060	17120	17075	17175	16905	16990	17055	-130	-65	54	460.59	256
	20150430	16990	17055	17135	17135	17085	17130	17110	75	55	14	119.79	262
zn1602	20150216	16390	16390				16420	16420	30	30	0	0.00	0
	20150217	16420	16420				16445	16445	25	25	0	0.00	0
	20150225	16445	16445				16125	16125	-320	-320	0	0.00	0
	20150226	16125	16125	16090	16170	16085	16160	16110	35	-15	18	145.00	18
	20150227	16160	16110	16115	16170	16090	16170	16110	60	0	54	434.99	62
	20150302	16170	16110	16095	16130	16095	16130	16110	20	0	4	32.23	58
	20150303	16130	16110				16110	16110	0	0	0	0.00	58
	20150304	16110	16110	15970	15975	15930	15965	15955	-145	-155	12	95.74	62
	20150305	15965	15955	15890	15890	15850	15850	15850	-105	-105	20	158.54	52
	20150306	15850	15850	15890	15890	15865	15865	15870	15	20	6	47.62	58
	20150309	15865	15870	15810	15835	15810	15835	15820	-35	-50	4	31.65	60
	20150310	15835	15820	15880	15880	15880	15880	15880	60	60	2	15.88	60
	20150311	15880	15880	15750	15825	15750	15825	15800	-55	-80	10	79.02	70
	20150312	15825	15800	15795	15800	15720	15800	15765	0	-35	22	173.44	84
	20150313	15800	15765	15860	15860	15860	15860	15860	95	95	2	15.86	84
	20150316	15860	15860	15910	15910	15905	15905	15905	45	45	4	31.82	82
	20150317	15905	15905	15875	15875	15870	15870	15870	-35	-35	4	31.75	82
	20150318	15870	15870	15790	15790	15790	15790	15790	-80	-80	6	47.37	86
	20150319	15790	15790	15820	15820	15770	15775	15795	-15	5	40	315.96	90
	20150320	15775	15795	15825	15885	15825	15885	15845	90	50	10	79.24	88
	20150323	15885	15845	16020	16020	16020	16020	16020	175	175	2	16.02	88
	20150324	16020	16020	16115	16115	16110	16110	16110	90	90	4	32.23	84
	20150325	16110	16110	16165	16165	16110	16110	16150	0	40	14	113.06	94
	20150326	16110	16150	16200	16200	16200	16200	16200	50	50	2	16.20	92
	20150327	16200	16200				16200	16200	0	0	0	0.00	92
	20150330	16200	16200	16195	16200	16190	16200	16190	0	-10	8	64.78	92
	20150331	16200	16190				16190	16190	0	0	0	0.00	92
	20150401	16190	16190	16150	16190	16150	16190	16165	0	-25	8	64.67	92
	20150402	16190	16165	16235	16235	16235	16235	16235	70	70	4	32.47	92
	20150403	16235	16235	16350	16420	16335	16350	16370	115	135	36	294.71	94
	20150407	16350	16370				16370	16370	0	0	0	0.00	94
	20150408	16370	16370				16370	16370	0	0	0	0.00	94
	20150409	16370	16370	16375	16375	16375	16375	16375	5	5	2	16.38	94
	20150410	16375	16375				16375	16375	0	0	0	0.00	94
	20150413	16375	16375	16690	16690	16690	16690	16690	315	315	4	33.38	98
	20150414	16690	16690	16695	16695	16525	16525	16615	-165	-75	16	132.92	90
	20150415	16525	16615	16610	16720	16610	16720	16640	105	25	14	116.49	96
	20150416	16720	16640	16660	16790	16660	16790	16705	150	65	10	83.54	94
	20150417	16790	16705	16890	16900	16875	16900	16885	195	180	6	50.67	96
	20150420	16900	16885	16700	16700	16700	16700	16700	-185	-185	4	33.40	100
	20150421	16700	16700	16655	16655	16625	16625	16635	-75	-65	6	49.92	100
	20150422	16625	16635				16635	16635	0	0	0	0.00	100
	20150423	16635	16635	16770	16795	16645	16795	16740	160	105	24	200.90	110
	20150424	16795	16740	16770	16770	16740	16760	16760	20	20	10	83.81	108
	20150427	16760	16760	16915	17080	16875	17060	16965	300	205	48	407.21	122
	20150428	17060	16965	17100	17295	17100	17100	17180	135	215	22	189.02	128
	20150429	17100	17180	17095	17165	17005	17005	17080	-175	-100	44	375.86	138
	20150430	17005	17080	17170	17265	17155	17155	17175	75	95	20	171.77	152
zn1603	20150317	15905	15905	15900	15920	15900	15920	15910	15	5	4	31.82	4
	20150318	15920	15910	15855	15855	15795	15795	15815	-115	-95	6	47.45	8
	20150319	15795	15815	15850	15895	15850	15895	15870	80	55	4	31.75	8
	20150320	15895	15870				15870	15870	0	0	0	0.00	8
	20150323	15870	15870				15870	15870	0	0	0	0.00	8
	20150324	15870	15870	16150	16150	16150	16150	16150	280	280	2	16.15	10
	20150325	16150	16150				16150	16150	0	0	0	0.00	10
	20150326	16150	16150				16150	16150	0	0	0	0.00	10
	20150327	16150	16150				16150	16150	0	0	0	0.00	10
	20150330	16150	16150				16140	16140	-10	-10	0	0.00	10
	20150331	16140	16140	16275	16275	16275	16275	16275	135	135	6	48.83	16
	20150401	16275	16275	16155	16280	16155	16175	16190	-100	-85	36	291.44	40
	20150402	16175	16190	16205	16250	16205	16250	16235	60	45	6	48.71	38
	20150403	16250	16235	16420	16420	16400	16400	16410	165	175	14	114.90	38
	20150407	16400	16410	16480	16480	16480	16480	16480	70	70	2	16.48	38
	20150408	16480	16480	16525	16640	16480	16480	16525	0	45	18	148.75	44
	20150409	16480	16525	16515	16515	16335	16415	16415	-110	-110	8	65.67	48
	20150410	16415	16415				16415	16415	0	0	0	0.00	48
	20150413	16415	16415	16810	16810	16585	16700	16760	285	345	24	201.15	66
	20150414	16700	16760	16730	16740	16555	16555	16650	-205	-110	36	299.75	76
	20150415	16555	16650	16560	16735	16560	16735	16610	85	-40	22	182.74	74
	20150416	16735	16610	16800	16875	16800	16800	16830	190	220	34	286.19	86
	20150417	16800	16830	16845	16940	16845	16940	16890	110	60	4	33.79	84
	20150420	16940	16890	16815	16830	16735	16735	16795	-155	-95	8	67.20	82
	20150421	16735	16795	16680	16700	16670	16670	16680	-125	-115	14	116.79	74
	20150422	16670	16680				16680	16680	0	0	0	0.00	74
	20150423	16680	16680	16890	16935	16735	16815	16825	135	145	132	1,110.76	96
	20150424	16815	16825	16850	16850	16740	16750	16760	-75	-65	16	134.09	96
	20150427	16750	16760	16880	17085	16875	17080	16955	320	195	26	220.42	96
	20150428	17080	16955	17100	17100	17100	17100	17100	145	145	10	85.50	106
	20150429	17100	17100	17230	17230	17135	17195	17195	95	95	38	326.73	106
	20150430	17195	17195	17115	17200	17115	17200	17150	5	-45	6	51.46	106
zn1604	20150416	16610	16610				16610	16610	0	0	0	0.00	0
	20150417	16610	16610	17060	17060	17060	17060	17060	450	450	2	17.06	2
	20150420	17060	17060				17060	17060	0	0	0	0.00	2
	20150421	17060	17060				17060	17060	0	0	0	0.00	2
	20150422	17060	17060				17060	17060	0	0	0	0.00	2
	20150423	17060	17060				17060	17060	0	0	0	0.00	2
	20150424	17060	17060				17060	17060	0	0	0	0.00	2
	20150427	17060	17060	17010	17145	17010	17145	17050	85	-10	14	119.38	8
	20150428	17145	17050				17050	17050	0	0	0	0.00	8
	20150429	17050	17050	17175	17175	17150	17150	17165	100	115	8	68.66	12
	20150430	17150	17165	17195	17195	17195	17195	17195	30	30	2	17.20	12
